Chromosome	BED_Start	BED_End	Smoove_Start	Smoove_End	PE_Smoove	SR_Smoove	Smoove_Coverage	SVTYPE
chr1        	934052      	934881      	934053         	934881         	14        	0         	14             	DEL       
chr1        	1350167     	1351367     	1350028        	1351414        	9         	0         	9              	DEL       
chr1        	1656925     	1722458     	1657092        	1722526        	20        	0         	20             	DUP       
chr1        	1656925     	1722458     	1657055        	1722363        	4         	0         	4              	DEL       
chr1        	1656925     	1722458     	1696867        	1749481        	7         	0         	7              	DUP       
chr1        	1696867     	1749483     	1657092        	1722526        	20        	0         	20             	DUP       
chr1        	1696867     	1749483     	1657055        	1722363        	4         	0         	4              	DEL       
chr1        	1696867     	1749483     	1696867        	1749481        	7         	0         	7              	DUP       
chr1        	1934934     	1935555     	1934935        	1935555        	10        	0         	10             	DEL       
chr1        	3181102     	3181923     	3181104        	3181921        	7         	0         	7              	DUP       
chr1        	3299744     	3300521     	3299745        	3300521        	9         	0         	9              	DEL       
chr1        	3643667     	3644309     	3643668        	3644309        	16        	0         	16             	DEL       
chr1        	4125487     	5523307     	4144598        	4144666        	0         	4         	4              	DEL       
chr1        	4125487     	5523307     	5290853        	5291216        	2         	7         	9              	DEL       
chr1        	4125487     	5523307     	4125477        	5523324        	8         	0         	8              	DUP       
chr1        	4144575     	4144629     	4144598        	4144666        	0         	4         	4              	DEL       
chr1        	5290849     	5291216     	5290853        	5291216        	2         	7         	9              	DEL       
chr1        	11622835    	11623132    	11622836       	11623132       	1         	13        	14             	DEL       
chr1        	13235346    	13240700    	13235374       	13240678       	7         	0         	7              	DEL       
chr1        	13981088    	108374853   	14109813       	14112070       	12        	1         	13             	DUP       
chr1        	13981088    	108374853   	14109812       	14111748       	14        	0         	14             	DEL       
chr1        	13981088    	108374853   	14110579       	14112444       	1         	9         	10             	DEL       
chr1        	13981088    	108374853   	14331216       	14331990       	20        	5         	25             	DEL       
chr1        	13981088    	108374853   	16050023       	16059839       	2         	4         	6              	DUP       
chr1        	13981088    	108374853   	16036838       	16060011       	4         	0         	4              	DUP       
chr1        	13981088    	108374853   	16037287       	16060565       	4         	0         	4              	DEL       
chr1        	13981088    	108374853   	16040419       	16062851       	4         	0         	4              	DUP       
chr1        	13981088    	108374853   	17358285       	17358591       	0         	4         	4              	DEL       
chr1        	13981088    	108374853   	20587115       	20587170       	0         	4         	4              	DEL       
chr1        	13981088    	108374853   	21459927       	21460197       	1         	5         	6              	DEL       
chr1        	13981088    	108374853   	21461252       	21461316       	0         	4         	4              	DEL       
chr1        	13981088    	108374853   	21427967       	21480090       	8         	0         	8              	INV       
chr1        	13981088    	108374853   	21981093       	22005825       	5         	0         	5              	DEL       
chr1        	13981088    	108374853   	21981402       	22006040       	8         	0         	8              	DUP       
chr1        	13981088    	108374853   	21986299       	22008929       	5         	0         	5              	DUP       
chr1        	13981088    	108374853   	24015698       	24015763       	0         	13        	13             	DEL       
chr1        	13981088    	108374853   	24076521       	24076812       	2         	3         	5              	DEL       
chr1        	13981088    	108374853   	24478088       	24480949       	22        	0         	22             	DEL       
chr1        	13981088    	108374853   	24832212       	24835018       	50        	27        	77             	DEL       
chr1        	13981088    	108374853   	25354831       	25355245       	0         	4         	4              	DEL       
chr1        	13981088    	108374853   	25287183       	25405499       	6         	0         	6              	DUP       
chr1        	13981088    	108374853   	26163332       	26163647       	1         	12        	13             	DEL       
chr1        	13981088    	108374853   	27477617       	27477930       	0         	9         	9              	DEL       
chr1        	13981088    	108374853   	27921296       	27921597       	0         	28        	28             	DEL       
chr1        	13981088    	108374853   	28639110       	28639377       	0         	4         	4              	DEL       
chr1        	13981088    	108374853   	28908261       	28908560       	1         	4         	5              	DEL       
chr1        	13981088    	108374853   	30567813       	30568814       	29        	20        	49             	DEL       
chr1        	13981088    	108374853   	40007359       	40009776       	6         	0         	6              	INV       
chr1        	13981088    	108374853   	32500564       	32539744       	20        	0         	20             	DUP       
chr1        	13981088    	108374853   	32500723       	32539755       	6         	0         	6              	DEL       
chr1        	13981088    	108374853   	36958629       	36960159       	17        	0         	17             	DEL       
chr1        	13981088    	108374853   	37350872       	37351121       	0         	9         	9              	DEL       
chr1        	13981088    	108374853   	37742576       	37742736       	0         	8         	8              	DEL       
chr1        	13981088    	108374853   	38618599       	38620153       	11        	0         	11             	DEL       
chr1        	13981088    	108374853   	41526555       	41527180       	4         	0         	4              	DUP       
chr1        	13981088    	108374853   	42277516       	42277821       	2         	2         	4              	DEL       
chr1        	13981088    	108374853   	43106315       	43107075       	4         	1         	5              	DEL       
chr1        	13981088    	108374853   	43594217       	43594360       	10        	0         	10             	INV       
chr1        	13981088    	108374853   	43640372       	43641308       	2         	2         	4              	DEL       
chr1        	13981088    	108374853   	45900453       	45900764       	2         	10        	12             	DEL       
chr1        	13981088    	108374853   	53128427       	53129276       	23        	14        	37             	DEL       
chr1        	13981088    	108374853   	53129456       	53129931       	2         	13        	15             	DEL       
chr1        	13981088    	108374853   	55002895       	55003057       	0         	6         	6              	DUP       
chr1        	13981088    	108374853   	55935620       	55935930       	0         	17        	17             	DEL       
chr1        	13981088    	108374853   	56365452       	56369289       	21        	5         	26             	DEL       
chr1        	13981088    	108374853   	56422039       	56422347       	1         	9         	10             	DEL       
chr1        	13981088    	108374853   	57877551       	57877863       	2         	8         	10             	DEL       
chr1        	13981088    	108374853   	58278241       	58279150       	48        	22        	70             	DEL       
chr1        	13981088    	108374853   	58593962       	58594269       	1         	10        	11             	DEL       
chr1        	13981088    	108374853   	60822423       	60822666       	0         	6         	6              	DUP       
chr1        	13981088    	108374853   	61617191       	61618029       	54        	21        	75             	DEL       
chr1        	13981088    	108374853   	61647742       	61653848       	18        	4         	22             	DEL       
chr1        	13981088    	108374853   	62686164       	62686487       	1         	22        	23             	DEL       
chr1        	13981088    	108374853   	79756097       	79757343       	11        	6         	17             	DEL       
chr1        	13981088    	108374853   	91668636       	91669278       	8         	0         	8              	DEL       
chr1        	13981088    	108374853   	65443955       	65444209       	1         	18        	19             	DEL       
chr1        	13981088    	108374853   	64353266       	65645330       	7         	0         	7              	DEL       
chr1        	13981088    	108374853   	65670032       	65670364       	1         	12        	13             	DEL       
chr1        	13981088    	108374853   	66228896       	66228957       	0         	6         	6              	DEL       
chr1        	13981088    	108374853   	67542311       	67543133       	39        	1         	40             	DEL       
chr1        	13981088    	108374853   	69341321       	69341628       	1         	4         	5              	DEL       
chr1        	13981088    	108374853   	69478042       	69478338       	1         	16        	17             	DEL       
chr1        	13981088    	108374853   	69561642       	69561999       	1         	7         	8              	DEL       
chr1        	13981088    	108374853   	70480522       	70480837       	0         	19        	19             	DEL       
chr1        	13981088    	108374853   	70683118       	70683364       	0         	7         	7              	DEL       
chr1        	13981088    	108374853   	71275649       	71275946       	1         	20        	21             	DEL       
chr1        	13981088    	108374853   	71362779       	71363193       	0         	12        	12             	DEL       
chr1        	13981088    	108374853   	72144438       	72144506       	0         	22        	22             	DEL       
chr1        	13981088    	108374853   	72300641       	72346156       	23        	5         	28             	DEL       
chr1        	13981088    	108374853   	73287924       	73288232       	3         	15        	18             	DEL       
chr1        	13981088    	108374853   	73303114       	73303451       	1         	11        	12             	DEL       
chr1        	13981088    	108374853   	73846749       	73846999       	0         	11        	11             	DEL       
chr1        	13981088    	108374853   	74289486       	74289605       	2         	26        	28             	DEL       
chr1        	13981088    	108374853   	74682553       	74682608       	1         	6         	7              	DEL       
chr1        	13981088    	108374853   	75546196       	75546510       	3         	22        	25             	DEL       
chr1        	13981088    	108374853   	76634690       	76634964       	0         	9         	9              	DEL       
chr1        	13981088    	108374853   	77010710       	77011042       	0         	5         	5              	DUP       
chr1        	13981088    	108374853   	78935841       	78936145       	3         	25        	28             	DEL       
chr1        	13981088    	108374853   	80728668       	80728983       	1         	15        	16             	DEL       
chr1        	13981088    	108374853   	80939087       	80945263       	19        	7         	26             	DEL       
chr1        	13981088    	108374853   	81222111       	81222428       	3         	28        	31             	DEL       
chr1        	13981088    	108374853   	82497621       	82497932       	0         	6         	6              	DEL       
chr1        	13981088    	108374853   	82576971       	82577281       	0         	8         	8              	DEL       
chr1        	13981088    	108374853   	82660293       	82661886       	50        	8         	58             	DEL       
chr1        	13981088    	108374853   	82684167       	82684232       	0         	12        	12             	DEL       
chr1        	13981088    	108374853   	84052256       	84058946       	52        	18        	70             	DEL       
chr1        	13981088    	108374853   	85282951       	85283267       	0         	9         	9              	DEL       
chr1        	13981088    	108374853   	86275303       	86276014       	35        	18        	53             	DEL       
chr1        	13981088    	108374853   	89010264       	89012941       	16        	0         	16             	DEL       
chr1        	13981088    	108374853   	91159230       	91159497       	0         	14        	14             	DEL       
chr1        	13981088    	108374853   	91766506       	91767776       	17        	3         	20             	DEL       
chr1        	13981088    	108374853   	92017649       	92018595       	16        	8         	24             	DEL       
chr1        	13981088    	108374853   	94477677       	94477767       	0         	7         	7              	DEL       
chr1        	13981088    	108374853   	95162508       	95214671       	5         	0         	5              	DUP       
chr1        	13981088    	108374853   	95224968       	95225273       	0         	24        	24             	DEL       
chr1        	13981088    	108374853   	95674421       	95676835       	24        	8         	32             	DEL       
chr1        	13981088    	108374853   	100923007      	100923315      	0         	10        	10             	DEL       
chr1        	13981088    	108374853   	101157216      	101157578      	3         	8         	11             	DEL       
chr1        	13981088    	108374853   	101258598      	101258651      	0         	16        	16             	DEL       
chr1        	13981088    	108374853   	102582136      	102582452      	0         	13        	13             	DEL       
chr1        	13981088    	108374853   	102630524      	102630828      	2         	29        	31             	DEL       
chr1        	13981088    	108374853   	103900577      	103901103      	6         	9         	15             	DEL       
chr1        	13981088    	108374853   	103908882      	103909030      	0         	9         	9              	DEL       
chr1        	13981088    	108374853   	104177242      	104177542      	0         	10        	10             	DEL       
chr1        	13981088    	108374853   	104676022      	104676840      	20        	9         	29             	DEL       
chr1        	13981088    	108374853   	104885698      	104886017      	4         	23        	27             	DEL       
chr1        	13981088    	108374853   	105124927      	105125839      	5         	9         	14             	DEL       
chr1        	13981088    	108374853   	105324161      	105324422      	0         	9         	9              	DEL       
chr1        	13981088    	108374853   	106427001      	106427148      	0         	12        	12             	DEL       
chr1        	13981088    	108374853   	108190703      	108194629      	50        	14        	64             	DEL       
chr1        	13981088    	108374853   	13981118       	108374853      	1         	6         	7              	DEL       
chr1        	14110318    	14111792    	14109812       	14111748       	14        	0         	14             	DEL       
chr1        	14110318    	14111792    	14110579       	14112444       	1         	9         	10             	DEL       
chr1        	14110160    	14112071    	14109813       	14112070       	12        	1         	13             	DUP       
chr1        	14110160    	14112071    	14109812       	14111748       	14        	0         	14             	DEL       
chr1        	14110160    	14112071    	14110579       	14112444       	1         	9         	10             	DEL       
chr1        	14331213    	14331990    	14331216       	14331990       	20        	5         	25             	DEL       
chr1        	16036837    	16060011    	16050023       	16059839       	2         	4         	6              	DUP       
chr1        	16036837    	16060011    	16036838       	16060011       	4         	0         	4              	DUP       
chr1        	16036837    	16060011    	16037287       	16060565       	4         	0         	4              	DEL       
chr1        	16036837    	16060011    	16040419       	16062851       	4         	0         	4              	DUP       
chr1        	16050022    	16059839    	16050023       	16059839       	2         	4         	6              	DUP       
chr1        	17358268    	17358591    	17358285       	17358591       	0         	4         	4              	DEL       
chr1        	20587111    	20587170    	20587115       	20587170       	0         	4         	4              	DEL       
chr1        	21427969    	21480092    	21459927       	21460197       	1         	5         	6              	DEL       
chr1        	21427969    	21480092    	21461252       	21461316       	0         	4         	4              	DEL       
chr1        	21427969    	21480092    	21427967       	21480090       	8         	0         	8              	INV       
chr1        	21459924    	21460197    	21459927       	21460197       	1         	5         	6              	DEL       
chr1        	21461251    	21461316    	21461252       	21461316       	0         	4         	4              	DEL       
chr1        	21981402    	22006042    	21981093       	22005825       	5         	0         	5              	DEL       
chr1        	21981402    	22006042    	21981402       	22006040       	8         	0         	8              	DUP       
chr1        	21981402    	22006042    	21986299       	22008929       	5         	0         	5              	DUP       
chr1        	21986299    	22008931    	21981093       	22005825       	5         	0         	5              	DEL       
chr1        	21986299    	22008931    	21981402       	22006040       	8         	0         	8              	DUP       
chr1        	21986299    	22008931    	21986299       	22008929       	5         	0         	5              	DUP       
chr1        	24015674    	24015763    	24015698       	24015763       	0         	13        	13             	DEL       
chr1        	24076494    	24076812    	24076521       	24076812       	2         	3         	5              	DEL       
chr1        	24478028    	24480950    	24478088       	24480949       	22        	0         	22             	DEL       
chr1        	24832195    	24835018    	24832212       	24835018       	50        	27        	77             	DEL       
chr1        	25287183    	25405501    	25354831       	25355245       	0         	4         	4              	DEL       
chr1        	25287183    	25405501    	25287183       	25405499       	6         	0         	6              	DUP       
chr1        	26163320    	26163647    	26163332       	26163647       	1         	12        	13             	DEL       
chr1        	27477600    	27477930    	27477617       	27477930       	0         	9         	9              	DEL       
chr1        	27921287    	27921597    	27921296       	27921597       	0         	28        	28             	DEL       
chr1        	28639103    	28639377    	28639110       	28639377       	0         	4         	4              	DEL       
chr1        	28908260    	28908560    	28908261       	28908560       	1         	4         	5              	DEL       
chr1        	30567797    	30568814    	30567813       	30568814       	29        	20        	49             	DEL       
chr1        	32500387    	32539631    	32500564       	32539744       	20        	0         	20             	DUP       
chr1        	32500387    	32539631    	32500723       	32539755       	6         	0         	6              	DEL       
chr1        	36958539    	36960142    	36958629       	36960159       	17        	0         	17             	DEL       
chr1        	37350871    	37351114    	37350872       	37351121       	0         	9         	9              	DEL       
chr1        	37742572    	37742736    	37742576       	37742736       	0         	8         	8              	DEL       
chr1        	38618560    	38620264    	38618599       	38620153       	11        	0         	11             	DEL       
chr1        	41526555    	41527182    	41526555       	41527180       	4         	0         	4              	DUP       
chr1        	42277505    	42277821    	42277516       	42277821       	2         	2         	4              	DEL       
chr1        	43106314    	43107075    	43106315       	43107075       	4         	1         	5              	DEL       
chr1        	43594216    	43594360    	43594217       	43594360       	10        	0         	10             	INV       
chr1        	45900434    	45900764    	45900453       	45900764       	2         	10        	12             	DEL       
chr1        	53128410    	53129932    	53128427       	53129276       	23        	14        	37             	DEL       
chr1        	53128410    	53129932    	53129456       	53129931       	2         	13        	15             	DEL       
chr1        	53129452    	53129931    	53129456       	53129931       	2         	13        	15             	DEL       
chr1        	55002894    	55003057    	55002895       	55003057       	0         	6         	6              	DUP       
chr1        	55935608    	55935930    	55935620       	55935930       	0         	17        	17             	DEL       
chr1        	56365433    	56369289    	56365452       	56369289       	21        	5         	26             	DEL       
chr1        	56422029    	56422347    	56422039       	56422347       	1         	9         	10             	DEL       
chr1        	57877538    	57877863    	57877551       	57877863       	2         	8         	10             	DEL       
chr1        	58278236    	58279150    	58278241       	58279150       	48        	22        	70             	DEL       
chr1        	58593943    	58594269    	58593962       	58594269       	1         	10        	11             	DEL       
chr1        	60822422    	60822663    	60822423       	60822666       	0         	6         	6              	DUP       
chr1        	61617184    	61618029    	61617191       	61618029       	54        	21        	75             	DEL       
chr1        	61647740    	61653848    	61647742       	61653848       	18        	4         	22             	DEL       
chr1        	62686147    	62686487    	62686164       	62686487       	1         	22        	23             	DEL       
chr1        	64353267    	65645331    	65443955       	65444209       	1         	18        	19             	DEL       
chr1        	64353267    	65645331    	64353266       	65645330       	7         	0         	7              	DEL       
chr1        	65443938    	65444209    	65443955       	65444209       	1         	18        	19             	DEL       
chr1        	65670031    	65670364    	65670032       	65670364       	1         	12        	13             	DEL       
chr1        	66228895    	66228957    	66228896       	66228957       	0         	6         	6              	DEL       
chr1        	67542275    	67543133    	67542311       	67543133       	39        	1         	40             	DEL       
chr1        	69341308    	69341628    	69341321       	69341628       	1         	4         	5              	DEL       
chr1        	69478031    	69478338    	69478042       	69478338       	1         	16        	17             	DEL       
chr1        	69561641    	69562000    	69561642       	69561999       	1         	7         	8              	DEL       
chr1        	70480505    	70480837    	70480522       	70480837       	0         	19        	19             	DEL       
chr1        	70683114    	70683364    	70683118       	70683364       	0         	7         	7              	DEL       
chr1        	71275635    	71275946    	71275649       	71275946       	1         	20        	21             	DEL       
chr1        	71362778    	71363193    	71362779       	71363193       	0         	12        	12             	DEL       
chr1        	72144437    	72144503    	72144438       	72144506       	0         	22        	22             	DEL       
chr1        	72300639    	72346156    	72300641       	72346156       	23        	5         	28             	DEL       
chr1        	73287916    	73288232    	73287924       	73288232       	3         	15        	18             	DEL       
chr1        	73303099    	73303451    	73303114       	73303451       	1         	11        	12             	DEL       
chr1        	73846747    	73846999    	73846749       	73846999       	0         	11        	11             	DEL       
chr1        	74289483    	74289605    	74289486       	74289605       	2         	26        	28             	DEL       
chr1        	74682550    	74682608    	74682553       	74682608       	1         	6         	7              	DEL       
chr1        	75546179    	75546510    	75546196       	75546510       	3         	22        	25             	DEL       
chr1        	76634680    	76634964    	76634690       	76634964       	0         	9         	9              	DEL       
chr1        	77010709    	77011040    	77010710       	77011042       	0         	5         	5              	DUP       
chr1        	78935822    	78936145    	78935841       	78936145       	3         	25        	28             	DEL       
chr1        	79756094    	79757343    	79756097       	79757343       	11        	6         	17             	DEL       
chr1        	80728655    	80728983    	80728668       	80728983       	1         	15        	16             	DEL       
chr1        	80939071    	80945264    	80939087       	80945263       	19        	7         	26             	DEL       
chr1        	81222098    	81222428    	81222111       	81222428       	3         	28        	31             	DEL       
chr1        	82497607    	82497932    	82497621       	82497932       	0         	6         	6              	DEL       
chr1        	82576960    	82577282    	82576971       	82577281       	0         	8         	8              	DEL       
chr1        	82660274    	82661886    	82660293       	82661886       	50        	8         	58             	DEL       
chr1        	82684166    	82684227    	82684167       	82684232       	0         	12        	12             	DEL       
chr1        	84052241    	84058946    	84052256       	84058946       	52        	18        	70             	DEL       
chr1        	85282936    	85283267    	85282951       	85283267       	0         	9         	9              	DEL       
chr1        	86275296    	86276014    	86275303       	86276014       	35        	18        	53             	DEL       
chr1        	89010224    	89012941    	89010264       	89012941       	16        	0         	16             	DEL       
chr1        	91159213    	91159497    	91159230       	91159497       	0         	14        	14             	DEL       
chr1        	91668635    	91669278    	91668636       	91669278       	8         	0         	8              	DEL       
chr1        	91766503    	91767776    	91766506       	91767776       	17        	3         	20             	DEL       
chr1        	92017612    	92018595    	92017649       	92018595       	16        	8         	24             	DEL       
chr1        	94477676    	94477767    	94477677       	94477767       	0         	7         	7              	DEL       
chr1        	95162508    	95214673    	95162508       	95214671       	5         	0         	5              	DUP       
chr1        	95224953    	95225273    	95224968       	95225273       	0         	24        	24             	DEL       
chr1        	95674418    	95676835    	95674421       	95676835       	24        	8         	32             	DEL       
chr1        	100922994   	100923315   	100923007      	100923315      	0         	10        	10             	DEL       
chr1        	101157207   	101157578   	101157216      	101157578      	3         	8         	11             	DEL       
chr1        	101258573   	101258651   	101258598      	101258651      	0         	16        	16             	DEL       
chr1        	102582121   	102582453   	102582136      	102582452      	0         	13        	13             	DEL       
chr1        	102630508   	102630828   	102630524      	102630828      	2         	29        	31             	DEL       
chr1        	103900576   	103901103   	103900577      	103901103      	6         	9         	15             	DEL       
chr1        	103908875   	103909030   	103908882      	103909030      	0         	9         	9              	DEL       
chr1        	104177224   	104177542   	104177242      	104177542      	0         	10        	10             	DEL       
chr1        	104676021   	104676840   	104676022      	104676840      	20        	9         	29             	DEL       
chr1        	104885686   	104886018   	104885698      	104886017      	4         	23        	27             	DEL       
chr1        	105124926   	105125821   	105124927      	105125839      	5         	9         	14             	DEL       
chr1        	105324147   	105324422   	105324161      	105324422      	0         	9         	9              	DEL       
chr1        	106427000   	106427166   	106427001      	106427148      	0         	12        	12             	DEL       
chr1        	108190707   	108194629   	108190703      	108194629      	50        	14        	64             	DEL       
chr1        	109055096   	109055429   	109055105      	109055418      	1         	8         	9              	DEL       
chr1        	109060014   	109060671   	109060015      	109060671      	11        	1         	12             	DEL       
chr1        	109071970   	109072121   	109071976      	109072121      	0         	6         	6              	DEL       
chr1        	111532071   	111532183   	111532075      	111532183      	0         	4         	4              	DEL       
chr1        	112149167   	112162081   	112149170      	112162081      	19        	9         	28             	DEL       
chr1        	112292464   	112295043   	112292482      	112295042      	28        	0         	28             	DEL       
chr1        	113068699   	113071155   	113068717      	113071155      	24        	13        	37             	DEL       
chr1        	113173008   	113173298   	113173023      	113173298      	2         	3         	5              	DEL       
chr1        	113257008   	113257468   	113257009      	113257468      	4         	2         	6              	DEL       
chr1        	113497204   	113503255   	113497220      	113503255      	24        	1         	25             	DEL       
chr1        	115254266   	115254551   	115254281      	115254551      	0         	26        	26             	DEL       
chr1        	115686861   	115690219   	115686865      	115690219      	15        	8         	23             	DEL       
chr1        	117029129   	192556346   	123245711      	123978202      	4         	0         	4              	DEL       
chr1        	117029129   	192556346   	124977927      	124994404      	5         	0         	5              	DEL       
chr1        	117029129   	192556346   	117548429      	117548636      	0         	16        	16             	DEL       
chr1        	117029129   	192556346   	118731591      	118731646      	0         	9         	9              	DEL       
chr1        	117029129   	192556346   	119016159      	119016467      	1         	9         	10             	DEL       
chr1        	117029129   	192556346   	121644528      	121885450      	5         	0         	5              	DEL       
chr1        	117029129   	192556346   	122552754      	122619011      	6         	0         	6              	DEL       
chr1        	117029129   	192556346   	122552537      	122689210      	4         	0         	4              	DUP       
chr1        	117029129   	192556346   	122583810      	123196782      	5         	0         	5              	DUP       
chr1        	117029129   	192556346   	122796515      	123315624      	4         	0         	4              	DEL       
chr1        	117029129   	192556346   	122742821      	123696858      	6         	0         	6              	DEL       
chr1        	117029129   	192556346   	123654674      	123760766      	5         	0         	5              	DUP       
chr1        	117029129   	192556346   	122655712      	123903874      	4         	0         	4              	DUP       
chr1        	117029129   	192556346   	122538406      	123907067      	10        	0         	10             	DUP       
chr1        	117029129   	192556346   	122966031      	123906829      	12        	0         	12             	DEL       
chr1        	117029129   	192556346   	122753034      	123923145      	4         	0         	4              	DEL       
chr1        	117029129   	192556346   	123130036      	123952804      	4         	0         	4              	DUP       
chr1        	117029129   	192556346   	122856673      	123956258      	4         	0         	4              	DUP       
chr1        	117029129   	192556346   	123350053      	123978514      	5         	0         	5              	DUP       
chr1        	117029129   	192556346   	123499472      	124044281      	6         	0         	6              	DUP       
chr1        	117029129   	192556346   	122634334      	124082557      	5         	0         	5              	DUP       
chr1        	117029129   	192556346   	123350351      	124127613      	7         	0         	7              	DEL       
chr1        	117029129   	192556346   	122648633      	124139571      	5         	0         	5              	DEL       
chr1        	117029129   	192556346   	122678583      	124139907      	4         	0         	4              	DUP       
chr1        	117029129   	192556346   	123533369      	124161277      	5         	0         	5              	DUP       
chr1        	117029129   	192556346   	122655924      	124181729      	4         	0         	4              	DEL       
chr1        	117029129   	192556346   	122592404      	124245164      	11        	0         	11             	DUP       
chr1        	117029129   	192556346   	123329463      	124245289      	20        	0         	20             	DUP       
chr1        	117029129   	192556346   	122965801      	124437056      	4         	0         	4              	DUP       
chr1        	117029129   	192556346   	122648438      	124521507      	9         	0         	9              	DUP       
chr1        	117029129   	192556346   	123804848      	124559405      	5         	0         	5              	DUP       
chr1        	117029129   	192556346   	123464040      	124583427      	4         	0         	4              	DEL       
chr1        	117029129   	192556346   	124006465      	124588212      	5         	0         	5              	DUP       
chr1        	117029129   	192556346   	124984652      	124989828      	4         	0         	4              	DEL       
chr1        	117029129   	192556346   	124978326      	124994564      	4         	1         	5              	DUP       
chr1        	117029129   	192556346   	125025272      	125025725      	8         	19        	27             	DEL       
chr1        	117029129   	192556346   	125162665      	125165961      	6         	0         	6              	DUP       
chr1        	117029129   	192556346   	125168018      	125170382      	82        	0         	82             	DUP       
chr1        	117029129   	192556346   	143196749      	143199230      	4         	0         	4              	DUP       
chr1        	117029129   	192556346   	143205594      	143242897      	10        	0         	10             	DEL       
chr1        	117029129   	192556346   	143243497      	143257967      	4         	0         	4              	DUP       
chr1        	117029129   	192556346   	143226198      	143275108      	8         	0         	8              	DEL       
chr1        	117029129   	192556346   	147920459      	147920551      	0         	11        	11             	DEL       
chr1        	117029129   	192556346   	145815068      	148070187      	6         	0         	6              	DUP       
chr1        	117029129   	192556346   	150401432      	150401695      	0         	4         	4              	DEL       
chr1        	117029129   	192556346   	150718975      	150719293      	0         	24        	24             	DEL       
chr1        	117029129   	192556346   	151932765      	151932838      	0         	5         	5              	DEL       
chr1        	117029129   	192556346   	152267946      	152268050      	0         	6         	6              	DEL       
chr1        	117029129   	192556346   	152304218      	152309109      	9         	0         	9              	DUP       
chr1        	117029129   	192556346   	152583066      	152615270      	14        	0         	14             	DEL       
chr1        	117029129   	192556346   	155147307      	155147495      	6         	0         	6              	INV       
chr1        	117029129   	192556346   	156556931      	156559143      	36        	19        	55             	DEL       
chr1        	117029129   	192556346   	157204074      	157205606      	14        	6         	20             	DEL       
chr1        	117029129   	192556346   	158080923      	158081248      	0         	10        	10             	DEL       
chr1        	117029129   	192556346   	158518618      	158518885      	3         	12        	15             	DEL       
chr1        	117029129   	192556346   	158742257      	158742563      	1         	21        	22             	DEL       
chr1        	117029129   	192556346   	158897743      	158900191      	13        	10        	23             	DEL       
chr1        	117029129   	192556346   	158991565      	158996411      	13        	4         	17             	DEL       
chr1        	117029129   	192556346   	159678918      	159679867      	59        	25        	84             	DEL       
chr1        	117029129   	192556346   	160965245      	160965546      	1         	20        	21             	DEL       
chr1        	117029129   	192556346   	161347334      	161347824      	0         	4         	4              	DEL       
chr1        	117029129   	192556346   	161512779      	161594357      	6         	0         	6              	DUP       
chr1        	117029129   	192556346   	162082890      	162083195      	0         	17        	17             	DEL       
chr1        	117029129   	192556346   	162408466      	162409087      	1         	3         	4              	DEL       
chr1        	117029129   	192556346   	165762008      	165762252      	1         	7         	8              	DEL       
chr1        	117029129   	192556346   	168055336      	168056494      	20        	9         	29             	DEL       
chr1        	117029129   	192556346   	169190799      	169191111      	5         	10        	15             	DEL       
chr1        	117029129   	192556346   	171814447      	171814509      	1         	13        	14             	DEL       
chr1        	117029129   	192556346   	173975617      	173975929      	1         	11        	12             	DEL       
chr1        	117029129   	192556346   	176509096      	176509637      	14        	16        	30             	DEL       
chr1        	117029129   	192556346   	179122733      	179123463      	2         	2         	4              	DEL       
chr1        	117029129   	192556346   	179638146      	179638924      	8         	9         	17             	DEL       
chr1        	117029129   	192556346   	180323869      	180324178      	2         	13        	15             	DEL       
chr1        	117029129   	192556346   	184845609      	184851650      	55        	21        	76             	DEL       
chr1        	117029129   	192556346   	184967921      	184968227      	3         	11        	14             	DEL       
chr1        	117029129   	192556346   	186795335      	186796288      	4         	0         	4              	DEL       
chr1        	117029129   	192556346   	187495695      	187497597      	9         	0         	9              	DEL       
chr1        	117029129   	192556346   	188570325      	188571098      	36        	18        	54             	DEL       
chr1        	117029129   	192556346   	189025833      	189026152      	0         	10        	10             	DEL       
chr1        	117029129   	192556346   	186809009      	190026764      	6         	0         	6              	DUP       
chr1        	117029129   	192556346   	190868192      	190868360      	0         	9         	9              	DEL       
chr1        	117029129   	192556346   	190941463      	190941645      	0         	13        	13             	DEL       
chr1        	117029129   	192556346   	117029129      	192556344      	5         	0         	5              	DUP       
chr1        	117029129   	192556346   	117029273      	192556876      	6         	0         	6              	DEL       
chr1        	117029129   	192556346   	159768689      	224340855      	10        	0         	10             	DEL       
chr1        	117548413   	117548636   	117548429      	117548636      	0         	16        	16             	DEL       
chr1        	118731589   	118731646   	118731591      	118731646      	0         	9         	9              	DEL       
chr1        	119016147   	119016467   	119016159      	119016467      	1         	9         	10             	DEL       
chr1        	122538405   	123907067   	123245711      	123978202      	4         	0         	4              	DEL       
chr1        	122538405   	123907067   	122552754      	122619011      	6         	0         	6              	DEL       
chr1        	122538405   	123907067   	122552537      	122689210      	4         	0         	4              	DUP       
chr1        	122538405   	123907067   	122583810      	123196782      	5         	0         	5              	DUP       
chr1        	122538405   	123907067   	122796515      	123315624      	4         	0         	4              	DEL       
chr1        	122538405   	123907067   	122742821      	123696858      	6         	0         	6              	DEL       
chr1        	122538405   	123907067   	123654674      	123760766      	5         	0         	5              	DUP       
chr1        	122538405   	123907067   	122655712      	123903874      	4         	0         	4              	DUP       
chr1        	122538405   	123907067   	122538406      	123907067      	10        	0         	10             	DUP       
chr1        	122538405   	123907067   	122966031      	123906829      	12        	0         	12             	DEL       
chr1        	122538405   	123907067   	122753034      	123923145      	4         	0         	4              	DEL       
chr1        	122538405   	123907067   	123130036      	123952804      	4         	0         	4              	DUP       
chr1        	122538405   	123907067   	122856673      	123956258      	4         	0         	4              	DUP       
chr1        	122538405   	123907067   	123350053      	123978514      	5         	0         	5              	DUP       
chr1        	122538405   	123907067   	123499472      	124044281      	6         	0         	6              	DUP       
chr1        	122538405   	123907067   	122634334      	124082557      	5         	0         	5              	DUP       
chr1        	122538405   	123907067   	123350351      	124127613      	7         	0         	7              	DEL       
chr1        	122538405   	123907067   	122648633      	124139571      	5         	0         	5              	DEL       
chr1        	122538405   	123907067   	122678583      	124139907      	4         	0         	4              	DUP       
chr1        	122538405   	123907067   	123533369      	124161277      	5         	0         	5              	DUP       
chr1        	122538405   	123907067   	122655924      	124181729      	4         	0         	4              	DEL       
chr1        	122538405   	123907067   	122592404      	124245164      	11        	0         	11             	DUP       
chr1        	122538405   	123907067   	123329463      	124245289      	20        	0         	20             	DUP       
chr1        	122538405   	123907067   	122965801      	124437056      	4         	0         	4              	DUP       
chr1        	122538405   	123907067   	122648438      	124521507      	9         	0         	9              	DUP       
chr1        	122538405   	123907067   	123804848      	124559405      	5         	0         	5              	DUP       
chr1        	122538405   	123907067   	123464040      	124583427      	4         	0         	4              	DEL       
chr1        	122552951   	122618877   	122583810      	123196782      	5         	0         	5              	DUP       
chr1        	122552951   	122618877   	122592404      	124245164      	11        	0         	11             	DUP       
chr1        	122552536   	122689210   	122552754      	122619011      	6         	0         	6              	DEL       
chr1        	122552536   	122689210   	122552537      	122689210      	4         	0         	4              	DUP       
chr1        	122552536   	122689210   	122583810      	123196782      	5         	0         	5              	DUP       
chr1        	122552536   	122689210   	122655712      	123903874      	4         	0         	4              	DUP       
chr1        	122552536   	122689210   	122634334      	124082557      	5         	0         	5              	DUP       
chr1        	122552536   	122689210   	122648633      	124139571      	5         	0         	5              	DEL       
chr1        	122552536   	122689210   	122678583      	124139907      	4         	0         	4              	DUP       
chr1        	122552536   	122689210   	122655924      	124181729      	4         	0         	4              	DEL       
chr1        	122552536   	122689210   	122592404      	124245164      	11        	0         	11             	DUP       
chr1        	122552536   	122689210   	122648438      	124521507      	9         	0         	9              	DUP       
chr1        	122583825   	123196926   	122552754      	122619011      	6         	0         	6              	DEL       
chr1        	122583825   	123196926   	122552537      	122689210      	4         	0         	4              	DUP       
chr1        	122583825   	123196926   	122583810      	123196782      	5         	0         	5              	DUP       
chr1        	122583825   	123196926   	122796515      	123315624      	4         	0         	4              	DEL       
chr1        	122583825   	123196926   	122742821      	123696858      	6         	0         	6              	DEL       
chr1        	122583825   	123196926   	122655712      	123903874      	4         	0         	4              	DUP       
chr1        	122583825   	123196926   	122966031      	123906829      	12        	0         	12             	DEL       
chr1        	122583825   	123196926   	122753034      	123923145      	4         	0         	4              	DEL       
chr1        	122583825   	123196926   	123130036      	123952804      	4         	0         	4              	DUP       
chr1        	122583825   	123196926   	122856673      	123956258      	4         	0         	4              	DUP       
chr1        	122583825   	123196926   	122634334      	124082557      	5         	0         	5              	DUP       
chr1        	122583825   	123196926   	122648633      	124139571      	5         	0         	5              	DEL       
chr1        	122583825   	123196926   	122678583      	124139907      	4         	0         	4              	DUP       
chr1        	122583825   	123196926   	122655924      	124181729      	4         	0         	4              	DEL       
chr1        	122583825   	123196926   	122592404      	124245164      	11        	0         	11             	DUP       
chr1        	122583825   	123196926   	122965801      	124437056      	4         	0         	4              	DUP       
chr1        	122583825   	123196926   	122648438      	124521507      	9         	0         	9              	DUP       
chr1        	122592403   	124245164   	123245711      	123978202      	4         	0         	4              	DEL       
chr1        	122592403   	124245164   	122552754      	122619011      	6         	0         	6              	DEL       
chr1        	122592403   	124245164   	122552537      	122689210      	4         	0         	4              	DUP       
chr1        	122592403   	124245164   	122583810      	123196782      	5         	0         	5              	DUP       
chr1        	122592403   	124245164   	122796515      	123315624      	4         	0         	4              	DEL       
chr1        	122592403   	124245164   	122742821      	123696858      	6         	0         	6              	DEL       
chr1        	122592403   	124245164   	123654674      	123760766      	5         	0         	5              	DUP       
chr1        	122592403   	124245164   	122655712      	123903874      	4         	0         	4              	DUP       
chr1        	122592403   	124245164   	122538406      	123907067      	10        	0         	10             	DUP       
chr1        	122592403   	124245164   	122966031      	123906829      	12        	0         	12             	DEL       
chr1        	122592403   	124245164   	122753034      	123923145      	4         	0         	4              	DEL       
chr1        	122592403   	124245164   	123130036      	123952804      	4         	0         	4              	DUP       
chr1        	122592403   	124245164   	122856673      	123956258      	4         	0         	4              	DUP       
chr1        	122592403   	124245164   	123350053      	123978514      	5         	0         	5              	DUP       
chr1        	122592403   	124245164   	123499472      	124044281      	6         	0         	6              	DUP       
chr1        	122592403   	124245164   	122634334      	124082557      	5         	0         	5              	DUP       
chr1        	122592403   	124245164   	123350351      	124127613      	7         	0         	7              	DEL       
chr1        	122592403   	124245164   	122648633      	124139571      	5         	0         	5              	DEL       
chr1        	122592403   	124245164   	122678583      	124139907      	4         	0         	4              	DUP       
chr1        	122592403   	124245164   	123533369      	124161277      	5         	0         	5              	DUP       
chr1        	122592403   	124245164   	122655924      	124181729      	4         	0         	4              	DEL       
chr1        	122592403   	124245164   	122592404      	124245164      	11        	0         	11             	DUP       
chr1        	122592403   	124245164   	123329463      	124245289      	20        	0         	20             	DUP       
chr1        	122592403   	124245164   	122965801      	124437056      	4         	0         	4              	DUP       
chr1        	122592403   	124245164   	122648438      	124521507      	9         	0         	9              	DUP       
chr1        	122592403   	124245164   	123804848      	124559405      	5         	0         	5              	DUP       
chr1        	122592403   	124245164   	123464040      	124583427      	4         	0         	4              	DEL       
chr1        	122592403   	124245164   	124006465      	124588212      	5         	0         	5              	DUP       
chr1        	122634333   	124082557   	123245711      	123978202      	4         	0         	4              	DEL       
chr1        	122634333   	124082557   	122552537      	122689210      	4         	0         	4              	DUP       
chr1        	122634333   	124082557   	122583810      	123196782      	5         	0         	5              	DUP       
chr1        	122634333   	124082557   	122796515      	123315624      	4         	0         	4              	DEL       
chr1        	122634333   	124082557   	122742821      	123696858      	6         	0         	6              	DEL       
chr1        	122634333   	124082557   	123654674      	123760766      	5         	0         	5              	DUP       
chr1        	122634333   	124082557   	122655712      	123903874      	4         	0         	4              	DUP       
chr1        	122634333   	124082557   	122538406      	123907067      	10        	0         	10             	DUP       
chr1        	122634333   	124082557   	122966031      	123906829      	12        	0         	12             	DEL       
chr1        	122634333   	124082557   	122753034      	123923145      	4         	0         	4              	DEL       
chr1        	122634333   	124082557   	123130036      	123952804      	4         	0         	4              	DUP       
chr1        	122634333   	124082557   	122856673      	123956258      	4         	0         	4              	DUP       
chr1        	122634333   	124082557   	123350053      	123978514      	5         	0         	5              	DUP       
chr1        	122634333   	124082557   	123499472      	124044281      	6         	0         	6              	DUP       
chr1        	122634333   	124082557   	122634334      	124082557      	5         	0         	5              	DUP       
chr1        	122634333   	124082557   	123350351      	124127613      	7         	0         	7              	DEL       
chr1        	122634333   	124082557   	122648633      	124139571      	5         	0         	5              	DEL       
chr1        	122634333   	124082557   	122678583      	124139907      	4         	0         	4              	DUP       
chr1        	122634333   	124082557   	123533369      	124161277      	5         	0         	5              	DUP       
chr1        	122634333   	124082557   	122655924      	124181729      	4         	0         	4              	DEL       
chr1        	122634333   	124082557   	123329463      	124245289      	20        	0         	20             	DUP       
chr1        	122634333   	124082557   	122965801      	124437056      	4         	0         	4              	DUP       
chr1        	122634333   	124082557   	122648438      	124521507      	9         	0         	9              	DUP       
chr1        	122634333   	124082557   	123804848      	124559405      	5         	0         	5              	DUP       
chr1        	122634333   	124082557   	123464040      	124583427      	4         	0         	4              	DEL       
chr1        	122634333   	124082557   	124006465      	124588212      	5         	0         	5              	DUP       
chr1        	122648632   	124139571   	123245711      	123978202      	4         	0         	4              	DEL       
chr1        	122648632   	124139571   	122552537      	122689210      	4         	0         	4              	DUP       
chr1        	122648632   	124139571   	122583810      	123196782      	5         	0         	5              	DUP       
chr1        	122648632   	124139571   	122796515      	123315624      	4         	0         	4              	DEL       
chr1        	122648632   	124139571   	122742821      	123696858      	6         	0         	6              	DEL       
chr1        	122648632   	124139571   	123654674      	123760766      	5         	0         	5              	DUP       
chr1        	122648632   	124139571   	122655712      	123903874      	4         	0         	4              	DUP       
chr1        	122648632   	124139571   	122538406      	123907067      	10        	0         	10             	DUP       
chr1        	122648632   	124139571   	122966031      	123906829      	12        	0         	12             	DEL       
chr1        	122648632   	124139571   	122753034      	123923145      	4         	0         	4              	DEL       
chr1        	122648632   	124139571   	123130036      	123952804      	4         	0         	4              	DUP       
chr1        	122648632   	124139571   	122856673      	123956258      	4         	0         	4              	DUP       
chr1        	122648632   	124139571   	123350053      	123978514      	5         	0         	5              	DUP       
chr1        	122648632   	124139571   	123499472      	124044281      	6         	0         	6              	DUP       
chr1        	122648632   	124139571   	122634334      	124082557      	5         	0         	5              	DUP       
chr1        	122648632   	124139571   	123350351      	124127613      	7         	0         	7              	DEL       
chr1        	122648632   	124139571   	122648633      	124139571      	5         	0         	5              	DEL       
chr1        	122648632   	124139571   	122678583      	124139907      	4         	0         	4              	DUP       
chr1        	122648632   	124139571   	123533369      	124161277      	5         	0         	5              	DUP       
chr1        	122648632   	124139571   	122655924      	124181729      	4         	0         	4              	DEL       
chr1        	122648632   	124139571   	123329463      	124245289      	20        	0         	20             	DUP       
chr1        	122648632   	124139571   	122965801      	124437056      	4         	0         	4              	DUP       
chr1        	122648632   	124139571   	123804848      	124559405      	5         	0         	5              	DUP       
chr1        	122648632   	124139571   	123464040      	124583427      	4         	0         	4              	DEL       
chr1        	122648632   	124139571   	124006465      	124588212      	5         	0         	5              	DUP       
chr1        	122648437   	124521507   	123245711      	123978202      	4         	0         	4              	DEL       
chr1        	122648437   	124521507   	122552537      	122689210      	4         	0         	4              	DUP       
chr1        	122648437   	124521507   	122583810      	123196782      	5         	0         	5              	DUP       
chr1        	122648437   	124521507   	122796515      	123315624      	4         	0         	4              	DEL       
chr1        	122648437   	124521507   	122742821      	123696858      	6         	0         	6              	DEL       
chr1        	122648437   	124521507   	123654674      	123760766      	5         	0         	5              	DUP       
chr1        	122648437   	124521507   	122655712      	123903874      	4         	0         	4              	DUP       
chr1        	122648437   	124521507   	122538406      	123907067      	10        	0         	10             	DUP       
chr1        	122648437   	124521507   	122966031      	123906829      	12        	0         	12             	DEL       
chr1        	122648437   	124521507   	122753034      	123923145      	4         	0         	4              	DEL       
chr1        	122648437   	124521507   	123130036      	123952804      	4         	0         	4              	DUP       
chr1        	122648437   	124521507   	122856673      	123956258      	4         	0         	4              	DUP       
chr1        	122648437   	124521507   	123350053      	123978514      	5         	0         	5              	DUP       
chr1        	122648437   	124521507   	123499472      	124044281      	6         	0         	6              	DUP       
chr1        	122648437   	124521507   	122634334      	124082557      	5         	0         	5              	DUP       
chr1        	122648437   	124521507   	123350351      	124127613      	7         	0         	7              	DEL       
chr1        	122648437   	124521507   	122648633      	124139571      	5         	0         	5              	DEL       
chr1        	122648437   	124521507   	122678583      	124139907      	4         	0         	4              	DUP       
chr1        	122648437   	124521507   	123533369      	124161277      	5         	0         	5              	DUP       
chr1        	122648437   	124521507   	122655924      	124181729      	4         	0         	4              	DEL       
chr1        	122648437   	124521507   	122592404      	124245164      	11        	0         	11             	DUP       
chr1        	122648437   	124521507   	123329463      	124245289      	20        	0         	20             	DUP       
chr1        	122648437   	124521507   	122965801      	124437056      	4         	0         	4              	DUP       
chr1        	122648437   	124521507   	122648438      	124521507      	9         	0         	9              	DUP       
chr1        	122648437   	124521507   	123804848      	124559405      	5         	0         	5              	DUP       
chr1        	122648437   	124521507   	123464040      	124583427      	4         	0         	4              	DEL       
chr1        	122648437   	124521507   	124006465      	124588212      	5         	0         	5              	DUP       
chr1        	122655711   	123903874   	123245711      	123978202      	4         	0         	4              	DEL       
chr1        	122655711   	123903874   	122552537      	122689210      	4         	0         	4              	DUP       
chr1        	122655711   	123903874   	122583810      	123196782      	5         	0         	5              	DUP       
chr1        	122655711   	123903874   	122796515      	123315624      	4         	0         	4              	DEL       
chr1        	122655711   	123903874   	122742821      	123696858      	6         	0         	6              	DEL       
chr1        	122655711   	123903874   	123654674      	123760766      	5         	0         	5              	DUP       
chr1        	122655711   	123903874   	122655712      	123903874      	4         	0         	4              	DUP       
chr1        	122655711   	123903874   	122966031      	123906829      	12        	0         	12             	DEL       
chr1        	122655711   	123903874   	122753034      	123923145      	4         	0         	4              	DEL       
chr1        	122655711   	123903874   	123130036      	123952804      	4         	0         	4              	DUP       
chr1        	122655711   	123903874   	122856673      	123956258      	4         	0         	4              	DUP       
chr1        	122655711   	123903874   	123350053      	123978514      	5         	0         	5              	DUP       
chr1        	122655711   	123903874   	123499472      	124044281      	6         	0         	6              	DUP       
chr1        	122655711   	123903874   	123350351      	124127613      	7         	0         	7              	DEL       
chr1        	122655711   	123903874   	122678583      	124139907      	4         	0         	4              	DUP       
chr1        	122655711   	123903874   	123533369      	124161277      	5         	0         	5              	DUP       
chr1        	122655711   	123903874   	122655924      	124181729      	4         	0         	4              	DEL       
chr1        	122655711   	123903874   	123329463      	124245289      	20        	0         	20             	DUP       
chr1        	122655711   	123903874   	122965801      	124437056      	4         	0         	4              	DUP       
chr1        	122655711   	123903874   	123804848      	124559405      	5         	0         	5              	DUP       
chr1        	122655711   	123903874   	123464040      	124583427      	4         	0         	4              	DEL       
chr1        	122655923   	124181729   	123245711      	123978202      	4         	0         	4              	DEL       
chr1        	122655923   	124181729   	122552537      	122689210      	4         	0         	4              	DUP       
chr1        	122655923   	124181729   	122583810      	123196782      	5         	0         	5              	DUP       
chr1        	122655923   	124181729   	122796515      	123315624      	4         	0         	4              	DEL       
chr1        	122655923   	124181729   	122742821      	123696858      	6         	0         	6              	DEL       
chr1        	122655923   	124181729   	123654674      	123760766      	5         	0         	5              	DUP       
chr1        	122655923   	124181729   	122655712      	123903874      	4         	0         	4              	DUP       
chr1        	122655923   	124181729   	122538406      	123907067      	10        	0         	10             	DUP       
chr1        	122655923   	124181729   	122966031      	123906829      	12        	0         	12             	DEL       
chr1        	122655923   	124181729   	122753034      	123923145      	4         	0         	4              	DEL       
chr1        	122655923   	124181729   	123130036      	123952804      	4         	0         	4              	DUP       
chr1        	122655923   	124181729   	122856673      	123956258      	4         	0         	4              	DUP       
chr1        	122655923   	124181729   	123350053      	123978514      	5         	0         	5              	DUP       
chr1        	122655923   	124181729   	123499472      	124044281      	6         	0         	6              	DUP       
chr1        	122655923   	124181729   	122634334      	124082557      	5         	0         	5              	DUP       
chr1        	122655923   	124181729   	123350351      	124127613      	7         	0         	7              	DEL       
chr1        	122655923   	124181729   	122648633      	124139571      	5         	0         	5              	DEL       
chr1        	122655923   	124181729   	122678583      	124139907      	4         	0         	4              	DUP       
chr1        	122655923   	124181729   	123533369      	124161277      	5         	0         	5              	DUP       
chr1        	122655923   	124181729   	122655924      	124181729      	4         	0         	4              	DEL       
chr1        	122655923   	124181729   	123329463      	124245289      	20        	0         	20             	DUP       
chr1        	122655923   	124181729   	122965801      	124437056      	4         	0         	4              	DUP       
chr1        	122655923   	124181729   	123804848      	124559405      	5         	0         	5              	DUP       
chr1        	122655923   	124181729   	123464040      	124583427      	4         	0         	4              	DEL       
chr1        	122655923   	124181729   	124006465      	124588212      	5         	0         	5              	DUP       
chr1        	122678582   	124139907   	123245711      	123978202      	4         	0         	4              	DEL       
chr1        	122678582   	124139907   	122552537      	122689210      	4         	0         	4              	DUP       
chr1        	122678582   	124139907   	122583810      	123196782      	5         	0         	5              	DUP       
chr1        	122678582   	124139907   	122796515      	123315624      	4         	0         	4              	DEL       
chr1        	122678582   	124139907   	122742821      	123696858      	6         	0         	6              	DEL       
chr1        	122678582   	124139907   	123654674      	123760766      	5         	0         	5              	DUP       
chr1        	122678582   	124139907   	122655712      	123903874      	4         	0         	4              	DUP       
chr1        	122678582   	124139907   	122538406      	123907067      	10        	0         	10             	DUP       
chr1        	122678582   	124139907   	122966031      	123906829      	12        	0         	12             	DEL       
chr1        	122678582   	124139907   	122753034      	123923145      	4         	0         	4              	DEL       
chr1        	122678582   	124139907   	123130036      	123952804      	4         	0         	4              	DUP       
chr1        	122678582   	124139907   	122856673      	123956258      	4         	0         	4              	DUP       
chr1        	122678582   	124139907   	123350053      	123978514      	5         	0         	5              	DUP       
chr1        	122678582   	124139907   	123499472      	124044281      	6         	0         	6              	DUP       
chr1        	122678582   	124139907   	122634334      	124082557      	5         	0         	5              	DUP       
chr1        	122678582   	124139907   	123350351      	124127613      	7         	0         	7              	DEL       
chr1        	122678582   	124139907   	122648633      	124139571      	5         	0         	5              	DEL       
chr1        	122678582   	124139907   	122678583      	124139907      	4         	0         	4              	DUP       
chr1        	122678582   	124139907   	123533369      	124161277      	5         	0         	5              	DUP       
chr1        	122678582   	124139907   	123329463      	124245289      	20        	0         	20             	DUP       
chr1        	122678582   	124139907   	122965801      	124437056      	4         	0         	4              	DUP       
chr1        	122678582   	124139907   	123804848      	124559405      	5         	0         	5              	DUP       
chr1        	122678582   	124139907   	123464040      	124583427      	4         	0         	4              	DEL       
chr1        	122678582   	124139907   	124006465      	124588212      	5         	0         	5              	DUP       
chr1        	122753033   	123923145   	123245711      	123978202      	4         	0         	4              	DEL       
chr1        	122753033   	123923145   	122583810      	123196782      	5         	0         	5              	DUP       
chr1        	122753033   	123923145   	122796515      	123315624      	4         	0         	4              	DEL       
chr1        	122753033   	123923145   	122742821      	123696858      	6         	0         	6              	DEL       
chr1        	122753033   	123923145   	123654674      	123760766      	5         	0         	5              	DUP       
chr1        	122753033   	123923145   	122655712      	123903874      	4         	0         	4              	DUP       
chr1        	122753033   	123923145   	122538406      	123907067      	10        	0         	10             	DUP       
chr1        	122753033   	123923145   	122966031      	123906829      	12        	0         	12             	DEL       
chr1        	122753033   	123923145   	122753034      	123923145      	4         	0         	4              	DEL       
chr1        	122753033   	123923145   	123130036      	123952804      	4         	0         	4              	DUP       
chr1        	122753033   	123923145   	122856673      	123956258      	4         	0         	4              	DUP       
chr1        	122753033   	123923145   	123350053      	123978514      	5         	0         	5              	DUP       
chr1        	122753033   	123923145   	123499472      	124044281      	6         	0         	6              	DUP       
chr1        	122753033   	123923145   	123350351      	124127613      	7         	0         	7              	DEL       
chr1        	122753033   	123923145   	123533369      	124161277      	5         	0         	5              	DUP       
chr1        	122753033   	123923145   	123329463      	124245289      	20        	0         	20             	DUP       
chr1        	122753033   	123923145   	122965801      	124437056      	4         	0         	4              	DUP       
chr1        	122753033   	123923145   	123804848      	124559405      	5         	0         	5              	DUP       
chr1        	122753033   	123923145   	123464040      	124583427      	4         	0         	4              	DEL       
chr1        	122796719   	123315377   	123245711      	123978202      	4         	0         	4              	DEL       
chr1        	122796719   	123315377   	122583810      	123196782      	5         	0         	5              	DUP       
chr1        	122796719   	123315377   	122966031      	123906829      	12        	0         	12             	DEL       
chr1        	122796719   	123315377   	123130036      	123952804      	4         	0         	4              	DUP       
chr1        	122796719   	123315377   	122856673      	123956258      	4         	0         	4              	DUP       
chr1        	122796719   	123315377   	122965801      	124437056      	4         	0         	4              	DUP       
chr1        	122856672   	123956258   	123245711      	123978202      	4         	0         	4              	DEL       
chr1        	122856672   	123956258   	122583810      	123196782      	5         	0         	5              	DUP       
chr1        	122856672   	123956258   	122796515      	123315624      	4         	0         	4              	DEL       
chr1        	122856672   	123956258   	122742821      	123696858      	6         	0         	6              	DEL       
chr1        	122856672   	123956258   	123654674      	123760766      	5         	0         	5              	DUP       
chr1        	122856672   	123956258   	122655712      	123903874      	4         	0         	4              	DUP       
chr1        	122856672   	123956258   	122538406      	123907067      	10        	0         	10             	DUP       
chr1        	122856672   	123956258   	122966031      	123906829      	12        	0         	12             	DEL       
chr1        	122856672   	123956258   	122753034      	123923145      	4         	0         	4              	DEL       
chr1        	122856672   	123956258   	123130036      	123952804      	4         	0         	4              	DUP       
chr1        	122856672   	123956258   	122856673      	123956258      	4         	0         	4              	DUP       
chr1        	122856672   	123956258   	123350053      	123978514      	5         	0         	5              	DUP       
chr1        	122856672   	123956258   	123499472      	124044281      	6         	0         	6              	DUP       
chr1        	122856672   	123956258   	123350351      	124127613      	7         	0         	7              	DEL       
chr1        	122856672   	123956258   	123533369      	124161277      	5         	0         	5              	DUP       
chr1        	122856672   	123956258   	123329463      	124245289      	20        	0         	20             	DUP       
chr1        	122856672   	123956258   	122965801      	124437056      	4         	0         	4              	DUP       
chr1        	122856672   	123956258   	123804848      	124559405      	5         	0         	5              	DUP       
chr1        	122856672   	123956258   	123464040      	124583427      	4         	0         	4              	DEL       
chr1        	122966030   	123906829   	123245711      	123978202      	4         	0         	4              	DEL       
chr1        	122966030   	123906829   	122583810      	123196782      	5         	0         	5              	DUP       
chr1        	122966030   	123906829   	122796515      	123315624      	4         	0         	4              	DEL       
chr1        	122966030   	123906829   	122742821      	123696858      	6         	0         	6              	DEL       
chr1        	122966030   	123906829   	123654674      	123760766      	5         	0         	5              	DUP       
chr1        	122966030   	123906829   	122655712      	123903874      	4         	0         	4              	DUP       
chr1        	122966030   	123906829   	122966031      	123906829      	12        	0         	12             	DEL       
chr1        	122966030   	123906829   	123130036      	123952804      	4         	0         	4              	DUP       
chr1        	122966030   	123906829   	123350053      	123978514      	5         	0         	5              	DUP       
chr1        	122966030   	123906829   	123499472      	124044281      	6         	0         	6              	DUP       
chr1        	122966030   	123906829   	123350351      	124127613      	7         	0         	7              	DEL       
chr1        	122966030   	123906829   	123533369      	124161277      	5         	0         	5              	DUP       
chr1        	122966030   	123906829   	123329463      	124245289      	20        	0         	20             	DUP       
chr1        	122966030   	123906829   	123804848      	124559405      	5         	0         	5              	DUP       
chr1        	122966030   	123906829   	123464040      	124583427      	4         	0         	4              	DEL       
chr1        	122965800   	124437056   	123245711      	123978202      	4         	0         	4              	DEL       
chr1        	122965800   	124437056   	122583810      	123196782      	5         	0         	5              	DUP       
chr1        	122965800   	124437056   	122796515      	123315624      	4         	0         	4              	DEL       
chr1        	122965800   	124437056   	122742821      	123696858      	6         	0         	6              	DEL       
chr1        	122965800   	124437056   	123654674      	123760766      	5         	0         	5              	DUP       
chr1        	122965800   	124437056   	122655712      	123903874      	4         	0         	4              	DUP       
chr1        	122965800   	124437056   	122538406      	123907067      	10        	0         	10             	DUP       
chr1        	122965800   	124437056   	122966031      	123906829      	12        	0         	12             	DEL       
chr1        	122965800   	124437056   	122753034      	123923145      	4         	0         	4              	DEL       
chr1        	122965800   	124437056   	123130036      	123952804      	4         	0         	4              	DUP       
chr1        	122965800   	124437056   	122856673      	123956258      	4         	0         	4              	DUP       
chr1        	122965800   	124437056   	123350053      	123978514      	5         	0         	5              	DUP       
chr1        	122965800   	124437056   	123499472      	124044281      	6         	0         	6              	DUP       
chr1        	122965800   	124437056   	122634334      	124082557      	5         	0         	5              	DUP       
chr1        	122965800   	124437056   	123350351      	124127613      	7         	0         	7              	DEL       
chr1        	122965800   	124437056   	122648633      	124139571      	5         	0         	5              	DEL       
chr1        	122965800   	124437056   	122678583      	124139907      	4         	0         	4              	DUP       
chr1        	122965800   	124437056   	123533369      	124161277      	5         	0         	5              	DUP       
chr1        	122965800   	124437056   	122655924      	124181729      	4         	0         	4              	DEL       
chr1        	122965800   	124437056   	122592404      	124245164      	11        	0         	11             	DUP       
chr1        	122965800   	124437056   	123329463      	124245289      	20        	0         	20             	DUP       
chr1        	122965800   	124437056   	122965801      	124437056      	4         	0         	4              	DUP       
chr1        	122965800   	124437056   	123804848      	124559405      	5         	0         	5              	DUP       
chr1        	122965800   	124437056   	123464040      	124583427      	4         	0         	4              	DEL       
chr1        	122965800   	124437056   	124006465      	124588212      	5         	0         	5              	DUP       
chr1        	123130035   	123952804   	123245711      	123978202      	4         	0         	4              	DEL       
chr1        	123130035   	123952804   	122583810      	123196782      	5         	0         	5              	DUP       
chr1        	123130035   	123952804   	122796515      	123315624      	4         	0         	4              	DEL       
chr1        	123130035   	123952804   	122742821      	123696858      	6         	0         	6              	DEL       
chr1        	123130035   	123952804   	123654674      	123760766      	5         	0         	5              	DUP       
chr1        	123130035   	123952804   	122655712      	123903874      	4         	0         	4              	DUP       
chr1        	123130035   	123952804   	122538406      	123907067      	10        	0         	10             	DUP       
chr1        	123130035   	123952804   	122966031      	123906829      	12        	0         	12             	DEL       
chr1        	123130035   	123952804   	122753034      	123923145      	4         	0         	4              	DEL       
chr1        	123130035   	123952804   	123130036      	123952804      	4         	0         	4              	DUP       
chr1        	123130035   	123952804   	123350053      	123978514      	5         	0         	5              	DUP       
chr1        	123130035   	123952804   	123499472      	124044281      	6         	0         	6              	DUP       
chr1        	123130035   	123952804   	123350351      	124127613      	7         	0         	7              	DEL       
chr1        	123130035   	123952804   	123533369      	124161277      	5         	0         	5              	DUP       
chr1        	123130035   	123952804   	123329463      	124245289      	20        	0         	20             	DUP       
chr1        	123130035   	123952804   	123804848      	124559405      	5         	0         	5              	DUP       
chr1        	123130035   	123952804   	123464040      	124583427      	4         	0         	4              	DEL       
chr1        	123329462   	124245289   	123245711      	123978202      	4         	0         	4              	DEL       
chr1        	123329462   	124245289   	122742821      	123696858      	6         	0         	6              	DEL       
chr1        	123329462   	124245289   	123654674      	123760766      	5         	0         	5              	DUP       
chr1        	123329462   	124245289   	122655712      	123903874      	4         	0         	4              	DUP       
chr1        	123329462   	124245289   	122538406      	123907067      	10        	0         	10             	DUP       
chr1        	123329462   	124245289   	122966031      	123906829      	12        	0         	12             	DEL       
chr1        	123329462   	124245289   	122753034      	123923145      	4         	0         	4              	DEL       
chr1        	123329462   	124245289   	123130036      	123952804      	4         	0         	4              	DUP       
chr1        	123329462   	124245289   	122856673      	123956258      	4         	0         	4              	DUP       
chr1        	123329462   	124245289   	123350053      	123978514      	5         	0         	5              	DUP       
chr1        	123329462   	124245289   	123499472      	124044281      	6         	0         	6              	DUP       
chr1        	123329462   	124245289   	122634334      	124082557      	5         	0         	5              	DUP       
chr1        	123329462   	124245289   	123350351      	124127613      	7         	0         	7              	DEL       
chr1        	123329462   	124245289   	122648633      	124139571      	5         	0         	5              	DEL       
chr1        	123329462   	124245289   	122678583      	124139907      	4         	0         	4              	DUP       
chr1        	123329462   	124245289   	123533369      	124161277      	5         	0         	5              	DUP       
chr1        	123329462   	124245289   	122655924      	124181729      	4         	0         	4              	DEL       
chr1        	123329462   	124245289   	122592404      	124245164      	11        	0         	11             	DUP       
chr1        	123329462   	124245289   	123329463      	124245289      	20        	0         	20             	DUP       
chr1        	123329462   	124245289   	123804848      	124559405      	5         	0         	5              	DUP       
chr1        	123329462   	124245289   	123464040      	124583427      	4         	0         	4              	DEL       
chr1        	123329462   	124245289   	124006465      	124588212      	5         	0         	5              	DUP       
chr1        	123350350   	124127613   	123245711      	123978202      	4         	0         	4              	DEL       
chr1        	123350350   	124127613   	122742821      	123696858      	6         	0         	6              	DEL       
chr1        	123350350   	124127613   	123654674      	123760766      	5         	0         	5              	DUP       
chr1        	123350350   	124127613   	122655712      	123903874      	4         	0         	4              	DUP       
chr1        	123350350   	124127613   	122538406      	123907067      	10        	0         	10             	DUP       
chr1        	123350350   	124127613   	122966031      	123906829      	12        	0         	12             	DEL       
chr1        	123350350   	124127613   	122753034      	123923145      	4         	0         	4              	DEL       
chr1        	123350350   	124127613   	123130036      	123952804      	4         	0         	4              	DUP       
chr1        	123350350   	124127613   	122856673      	123956258      	4         	0         	4              	DUP       
chr1        	123350350   	124127613   	123350053      	123978514      	5         	0         	5              	DUP       
chr1        	123350350   	124127613   	123499472      	124044281      	6         	0         	6              	DUP       
chr1        	123350350   	124127613   	122634334      	124082557      	5         	0         	5              	DUP       
chr1        	123350350   	124127613   	123350351      	124127613      	7         	0         	7              	DEL       
chr1        	123350350   	124127613   	123533369      	124161277      	5         	0         	5              	DUP       
chr1        	123350350   	124127613   	123804848      	124559405      	5         	0         	5              	DUP       
chr1        	123350350   	124127613   	123464040      	124583427      	4         	0         	4              	DEL       
chr1        	123350350   	124127613   	124006465      	124588212      	5         	0         	5              	DUP       
chr1        	123464039   	124583427   	123245711      	123978202      	4         	0         	4              	DEL       
chr1        	123464039   	124583427   	122742821      	123696858      	6         	0         	6              	DEL       
chr1        	123464039   	124583427   	123654674      	123760766      	5         	0         	5              	DUP       
chr1        	123464039   	124583427   	122655712      	123903874      	4         	0         	4              	DUP       
chr1        	123464039   	124583427   	122538406      	123907067      	10        	0         	10             	DUP       
chr1        	123464039   	124583427   	122966031      	123906829      	12        	0         	12             	DEL       
chr1        	123464039   	124583427   	122753034      	123923145      	4         	0         	4              	DEL       
chr1        	123464039   	124583427   	123130036      	123952804      	4         	0         	4              	DUP       
chr1        	123464039   	124583427   	122856673      	123956258      	4         	0         	4              	DUP       
chr1        	123464039   	124583427   	123350053      	123978514      	5         	0         	5              	DUP       
chr1        	123464039   	124583427   	123499472      	124044281      	6         	0         	6              	DUP       
chr1        	123464039   	124583427   	122634334      	124082557      	5         	0         	5              	DUP       
chr1        	123464039   	124583427   	123350351      	124127613      	7         	0         	7              	DEL       
chr1        	123464039   	124583427   	122648633      	124139571      	5         	0         	5              	DEL       
chr1        	123464039   	124583427   	122678583      	124139907      	4         	0         	4              	DUP       
chr1        	123464039   	124583427   	123533369      	124161277      	5         	0         	5              	DUP       
chr1        	123464039   	124583427   	122655924      	124181729      	4         	0         	4              	DEL       
chr1        	123464039   	124583427   	122592404      	124245164      	11        	0         	11             	DUP       
chr1        	123464039   	124583427   	123329463      	124245289      	20        	0         	20             	DUP       
chr1        	123464039   	124583427   	122965801      	124437056      	4         	0         	4              	DUP       
chr1        	123464039   	124583427   	122648438      	124521507      	9         	0         	9              	DUP       
chr1        	123464039   	124583427   	123804848      	124559405      	5         	0         	5              	DUP       
chr1        	123464039   	124583427   	123464040      	124583427      	4         	0         	4              	DEL       
chr1        	123464039   	124583427   	124006465      	124588212      	5         	0         	5              	DUP       
chr1        	123499471   	124044281   	123245711      	123978202      	4         	0         	4              	DEL       
chr1        	123499471   	124044281   	122742821      	123696858      	6         	0         	6              	DEL       
chr1        	123499471   	124044281   	123654674      	123760766      	5         	0         	5              	DUP       
chr1        	123499471   	124044281   	122655712      	123903874      	4         	0         	4              	DUP       
chr1        	123499471   	124044281   	122538406      	123907067      	10        	0         	10             	DUP       
chr1        	123499471   	124044281   	122966031      	123906829      	12        	0         	12             	DEL       
chr1        	123499471   	124044281   	122753034      	123923145      	4         	0         	4              	DEL       
chr1        	123499471   	124044281   	123130036      	123952804      	4         	0         	4              	DUP       
chr1        	123499471   	124044281   	122856673      	123956258      	4         	0         	4              	DUP       
chr1        	123499471   	124044281   	123350053      	123978514      	5         	0         	5              	DUP       
chr1        	123499471   	124044281   	123499472      	124044281      	6         	0         	6              	DUP       
chr1        	123499471   	124044281   	123533369      	124161277      	5         	0         	5              	DUP       
chr1        	123499471   	124044281   	123804848      	124559405      	5         	0         	5              	DUP       
chr1        	123499471   	124044281   	124006465      	124588212      	5         	0         	5              	DUP       
chr1        	123533368   	124161277   	123245711      	123978202      	4         	0         	4              	DEL       
chr1        	123533368   	124161277   	122742821      	123696858      	6         	0         	6              	DEL       
chr1        	123533368   	124161277   	123654674      	123760766      	5         	0         	5              	DUP       
chr1        	123533368   	124161277   	122655712      	123903874      	4         	0         	4              	DUP       
chr1        	123533368   	124161277   	122538406      	123907067      	10        	0         	10             	DUP       
chr1        	123533368   	124161277   	122966031      	123906829      	12        	0         	12             	DEL       
chr1        	123533368   	124161277   	122753034      	123923145      	4         	0         	4              	DEL       
chr1        	123533368   	124161277   	123130036      	123952804      	4         	0         	4              	DUP       
chr1        	123533368   	124161277   	122856673      	123956258      	4         	0         	4              	DUP       
chr1        	123533368   	124161277   	123350053      	123978514      	5         	0         	5              	DUP       
chr1        	123533368   	124161277   	123499472      	124044281      	6         	0         	6              	DUP       
chr1        	123533368   	124161277   	122634334      	124082557      	5         	0         	5              	DUP       
chr1        	123533368   	124161277   	123350351      	124127613      	7         	0         	7              	DEL       
chr1        	123533368   	124161277   	122648633      	124139571      	5         	0         	5              	DEL       
chr1        	123533368   	124161277   	122678583      	124139907      	4         	0         	4              	DUP       
chr1        	123533368   	124161277   	123533369      	124161277      	5         	0         	5              	DUP       
chr1        	123533368   	124161277   	123804848      	124559405      	5         	0         	5              	DUP       
chr1        	123533368   	124161277   	124006465      	124588212      	5         	0         	5              	DUP       
chr1        	123654511   	123760984   	122742821      	123696858      	6         	0         	6              	DEL       
chr1        	123654511   	123760984   	123654674      	123760766      	5         	0         	5              	DUP       
chr1        	123804847   	124559405   	123245711      	123978202      	4         	0         	4              	DEL       
chr1        	123804847   	124559405   	122655712      	123903874      	4         	0         	4              	DUP       
chr1        	123804847   	124559405   	122538406      	123907067      	10        	0         	10             	DUP       
chr1        	123804847   	124559405   	122966031      	123906829      	12        	0         	12             	DEL       
chr1        	123804847   	124559405   	122753034      	123923145      	4         	0         	4              	DEL       
chr1        	123804847   	124559405   	123130036      	123952804      	4         	0         	4              	DUP       
chr1        	123804847   	124559405   	122856673      	123956258      	4         	0         	4              	DUP       
chr1        	123804847   	124559405   	123350053      	123978514      	5         	0         	5              	DUP       
chr1        	123804847   	124559405   	123499472      	124044281      	6         	0         	6              	DUP       
chr1        	123804847   	124559405   	122634334      	124082557      	5         	0         	5              	DUP       
chr1        	123804847   	124559405   	123350351      	124127613      	7         	0         	7              	DEL       
chr1        	123804847   	124559405   	122648633      	124139571      	5         	0         	5              	DEL       
chr1        	123804847   	124559405   	122678583      	124139907      	4         	0         	4              	DUP       
chr1        	123804847   	124559405   	123533369      	124161277      	5         	0         	5              	DUP       
chr1        	123804847   	124559405   	122655924      	124181729      	4         	0         	4              	DEL       
chr1        	123804847   	124559405   	122592404      	124245164      	11        	0         	11             	DUP       
chr1        	123804847   	124559405   	123329463      	124245289      	20        	0         	20             	DUP       
chr1        	123804847   	124559405   	122965801      	124437056      	4         	0         	4              	DUP       
chr1        	123804847   	124559405   	122648438      	124521507      	9         	0         	9              	DUP       
chr1        	123804847   	124559405   	123804848      	124559405      	5         	0         	5              	DUP       
chr1        	123804847   	124559405   	124006465      	124588212      	5         	0         	5              	DUP       
chr1        	124006464   	124588212   	123499472      	124044281      	6         	0         	6              	DUP       
chr1        	124006464   	124588212   	122634334      	124082557      	5         	0         	5              	DUP       
chr1        	124006464   	124588212   	123350351      	124127613      	7         	0         	7              	DEL       
chr1        	124006464   	124588212   	122648633      	124139571      	5         	0         	5              	DEL       
chr1        	124006464   	124588212   	122678583      	124139907      	4         	0         	4              	DUP       
chr1        	124006464   	124588212   	123533369      	124161277      	5         	0         	5              	DUP       
chr1        	124006464   	124588212   	122655924      	124181729      	4         	0         	4              	DEL       
chr1        	124006464   	124588212   	122592404      	124245164      	11        	0         	11             	DUP       
chr1        	124006464   	124588212   	123329463      	124245289      	20        	0         	20             	DUP       
chr1        	124006464   	124588212   	122965801      	124437056      	4         	0         	4              	DUP       
chr1        	124006464   	124588212   	122648438      	124521507      	9         	0         	9              	DUP       
chr1        	124006464   	124588212   	123804848      	124559405      	5         	0         	5              	DUP       
chr1        	124006464   	124588212   	123464040      	124583427      	4         	0         	4              	DEL       
chr1        	124006464   	124588212   	124006465      	124588212      	5         	0         	5              	DUP       
chr1        	124978325   	124994547   	124977927      	124994404      	5         	0         	5              	DEL       
chr1        	124978325   	124994547   	124984652      	124989828      	4         	0         	4              	DEL       
chr1        	124978325   	124994547   	124978326      	124994564      	4         	1         	5              	DUP       
chr1        	125025270   	125025725   	125025272      	125025725      	8         	19        	27             	DEL       
chr1        	125162664   	125165961   	125162665      	125165961      	6         	0         	6              	DUP       
chr1        	125168017   	125170382   	125168018      	125170382      	82        	0         	82             	DUP       
chr1        	143205595   	143242898   	143205594      	143242897      	10        	0         	10             	DEL       
chr1        	143205595   	143242898   	143226198      	143275108      	8         	0         	8              	DEL       
chr1        	143243496   	143257967   	143243497      	143257967      	4         	0         	4              	DUP       
chr1        	145815068   	148070189   	147920459      	147920551      	0         	11        	11             	DEL       
chr1        	145815068   	148070189   	145815068      	148070187      	6         	0         	6              	DUP       
chr1        	147920450   	147920557   	147920459      	147920551      	0         	11        	11             	DEL       
chr1        	150718958   	150719293   	150718975      	150719293      	0         	24        	24             	DEL       
chr1        	151932737   	151932838   	151932765      	151932838      	0         	5         	5              	DEL       
chr1        	152267931   	152268050   	152267946      	152268050      	0         	6         	6              	DEL       
chr1        	152304218   	152309111   	152304218      	152309109      	9         	0         	9              	DUP       
chr1        	152583065   	152615264   	152583066      	152615270      	14        	0         	14             	DEL       
chr1        	155147306   	155147495   	155147307      	155147495      	6         	0         	6              	INV       
chr1        	156556911   	156559143   	156556931      	156559143      	36        	19        	55             	DEL       
chr1        	157204073   	157205606   	157204074      	157205606      	14        	6         	20             	DEL       
chr1        	158080922   	158081248   	158080923      	158081248      	0         	10        	10             	DEL       
chr1        	158518617   	158518885   	158518618      	158518885      	3         	12        	15             	DEL       
chr1        	158742240   	158742563   	158742257      	158742563      	1         	21        	22             	DEL       
chr1        	158897566   	158900192   	158897743      	158900191      	13        	10        	23             	DEL       
chr1        	158991560   	158996411   	158991565      	158996411      	13        	4         	17             	DEL       
chr1        	159678916   	159679867   	159678918      	159679867      	59        	25        	84             	DEL       
chr1        	159768690   	224340856   	207368689      	207372219      	51        	0         	51             	DEL       
chr1        	159768690   	224340856   	160965245      	160965546      	1         	20        	21             	DEL       
chr1        	159768690   	224340856   	161347334      	161347824      	0         	4         	4              	DEL       
chr1        	159768690   	224340856   	161512779      	161594357      	6         	0         	6              	DUP       
chr1        	159768690   	224340856   	162082890      	162083195      	0         	17        	17             	DEL       
chr1        	159768690   	224340856   	162408466      	162409087      	1         	3         	4              	DEL       
chr1        	159768690   	224340856   	165762008      	165762252      	1         	7         	8              	DEL       
chr1        	159768690   	224340856   	168055336      	168056494      	20        	9         	29             	DEL       
chr1        	159768690   	224340856   	169190799      	169191111      	5         	10        	15             	DEL       
chr1        	159768690   	224340856   	171814447      	171814509      	1         	13        	14             	DEL       
chr1        	159768690   	224340856   	173975617      	173975929      	1         	11        	12             	DEL       
chr1        	159768690   	224340856   	176509096      	176509637      	14        	16        	30             	DEL       
chr1        	159768690   	224340856   	179122733      	179123463      	2         	2         	4              	DEL       
chr1        	159768690   	224340856   	179638146      	179638924      	8         	9         	17             	DEL       
chr1        	159768690   	224340856   	180323869      	180324178      	2         	13        	15             	DEL       
chr1        	159768690   	224340856   	184845609      	184851650      	55        	21        	76             	DEL       
chr1        	159768690   	224340856   	184967921      	184968227      	3         	11        	14             	DEL       
chr1        	159768690   	224340856   	186795335      	186796288      	4         	0         	4              	DEL       
chr1        	159768690   	224340856   	187495695      	187497597      	9         	0         	9              	DEL       
chr1        	159768690   	224340856   	188570325      	188571098      	36        	18        	54             	DEL       
chr1        	159768690   	224340856   	189025833      	189026152      	0         	10        	10             	DEL       
chr1        	159768690   	224340856   	186809009      	190026764      	6         	0         	6              	DUP       
chr1        	159768690   	224340856   	190868192      	190868360      	0         	9         	9              	DEL       
chr1        	159768690   	224340856   	190941463      	190941645      	0         	13        	13             	DEL       
chr1        	159768690   	224340856   	117029129      	192556344      	5         	0         	5              	DUP       
chr1        	159768690   	224340856   	117029273      	192556876      	6         	0         	6              	DEL       
chr1        	159768690   	224340856   	192640670      	192640734      	1         	24        	25             	DEL       
chr1        	159768690   	224340856   	193266300      	193266527      	0         	12        	12             	DEL       
chr1        	159768690   	224340856   	194090950      	194091112      	0         	9         	9              	DEL       
chr1        	159768690   	224340856   	194381377      	194382173      	8         	0         	8              	DEL       
chr1        	159768690   	224340856   	194481920      	194485182      	15        	0         	15             	DEL       
chr1        	159768690   	224340856   	194548478      	194548737      	1         	15        	16             	DEL       
chr1        	159768690   	224340856   	194669488      	194669563      	15        	4         	19             	INV       
chr1        	159768690   	224340856   	196818850      	196943009      	4         	0         	4              	DEL       
chr1        	159768690   	224340856   	197531390      	197534141      	37        	26        	63             	DEL       
chr1        	159768690   	224340856   	197787658      	197788856      	37        	13        	50             	INV       
chr1        	159768690   	224340856   	198804620      	198806285      	21        	12        	33             	DEL       
chr1        	159768690   	224340856   	199469615      	199471105      	19        	5         	24             	DEL       
chr1        	159768690   	224340856   	203715244      	203717071      	21        	0         	21             	DEL       
chr1        	159768690   	224340856   	203918555      	203920758      	12        	10        	22             	DEL       
chr1        	159768690   	224340856   	203925137      	203926752      	8         	0         	8              	DEL       
chr1        	159768690   	224340856   	203966703      	203976314      	22        	4         	26             	DEL       
chr1        	159768690   	224340856   	205126765      	205127179      	1         	3         	4              	DEL       
chr1        	159768690   	224340856   	205209500      	205209646      	10        	5         	15             	INV       
chr1        	159768690   	224340856   	205470730      	205470896      	0         	5         	5              	DEL       
chr1        	159768690   	224340856   	205906490      	205906556      	0         	11        	11             	DEL       
chr1        	159768690   	224340856   	205957921      	205958411      	4         	10        	14             	DEL       
chr1        	159768690   	224340856   	205966752      	205967054      	0         	9         	9              	DEL       
chr1        	159768690   	224340856   	206052518      	206058499      	20        	0         	20             	DUP       
chr1        	159768690   	224340856   	206923954      	206924522      	16        	1         	17             	DUP       
chr1        	159768690   	224340856   	207119016      	207119850      	14        	0         	14             	DEL       
chr1        	159768690   	224340856   	207118999      	207119850      	5         	7         	12             	INV       
chr1        	159768690   	224340856   	207667720      	207672469      	21        	10        	31             	DEL       
chr1        	159768690   	224340856   	209761662      	209762730      	8         	3         	11             	DUP       
chr1        	159768690   	224340856   	209761993      	209762731      	12        	9         	21             	DEL       
chr1        	159768690   	224340856   	209771379      	209771512      	3         	1         	4              	DEL       
chr1        	159768690   	224340856   	212297811      	212299274      	45        	19        	64             	DEL       
chr1        	159768690   	224340856   	212468679      	212468763      	0         	4         	4              	DEL       
chr1        	159768690   	224340856   	214596760      	214597096      	1         	4         	5              	DEL       
chr1        	159768690   	224340856   	215021384      	215021437      	0         	10        	10             	DEL       
chr1        	159768690   	224340856   	217096618      	217096681      	0         	6         	6              	DEL       
chr1        	159768690   	224340856   	217744180      	217744482      	0         	10        	10             	DEL       
chr1        	159768690   	224340856   	218009160      	218015252      	45        	17        	62             	DEL       
chr1        	159768690   	224340856   	219749981      	219750284      	0         	16        	16             	DEL       
chr1        	159768690   	224340856   	220052684      	220052765      	1         	17        	18             	DEL       
chr1        	159768690   	224340856   	220112129      	220112432      	0         	9         	9              	DEL       
chr1        	159768690   	224340856   	220329603      	220330240      	9         	5         	14             	DEL       
chr1        	159768690   	224340856   	221860816      	221861133      	3         	18        	21             	DEL       
chr1        	159768690   	224340856   	224059415      	224059876      	11        	13        	24             	DEL       
chr1        	159768690   	224340856   	224205132      	224205432      	1         	17        	18             	DEL       
chr1        	159768690   	224340856   	159768689      	224340855      	10        	0         	10             	DEL       
chr1        	160965229   	160965546   	160965245      	160965546      	1         	20        	21             	DEL       
chr1        	161512779   	161594359   	161512779      	161594357      	6         	0         	6              	DUP       
chr1        	162082874   	162083195   	162082890      	162083195      	0         	17        	17             	DEL       
chr1        	165761971   	165762252   	165762008      	165762252      	1         	7         	8              	DEL       
chr1        	168055320   	168056494   	168055336      	168056494      	20        	9         	29             	DEL       
chr1        	169190781   	169191111   	169190799      	169191111      	5         	10        	15             	DEL       
chr1        	171814446   	171814509   	171814447      	171814509      	1         	13        	14             	DEL       
chr1        	173975598   	173975929   	173975617      	173975929      	1         	11        	12             	DEL       
chr1        	176509080   	176509637   	176509096      	176509637      	14        	16        	30             	DEL       
chr1        	179638152   	179638924   	179638146      	179638924      	8         	9         	17             	DEL       
chr1        	180323853   	180324178   	180323869      	180324178      	2         	13        	15             	DEL       
chr1        	184845593   	184851651   	184845609      	184851650      	55        	21        	76             	DEL       
chr1        	184967904   	184968227   	184967921      	184968227      	3         	11        	14             	DEL       
chr1        	186795334   	186796288   	186795335      	186796288      	4         	0         	4              	DEL       
chr1        	186809009   	190026766   	187495695      	187497597      	9         	0         	9              	DEL       
chr1        	186809009   	190026766   	188570325      	188571098      	36        	18        	54             	DEL       
chr1        	186809009   	190026766   	189025833      	189026152      	0         	10        	10             	DEL       
chr1        	186809009   	190026766   	186809009      	190026764      	6         	0         	6              	DUP       
chr1        	187495753   	187497548   	187495695      	187497597      	9         	0         	9              	DEL       
chr1        	188570322   	188571098   	188570325      	188571098      	36        	18        	54             	DEL       
chr1        	189025816   	189026152   	189025833      	189026152      	0         	10        	10             	DEL       
chr1        	190868188   	190868360   	190868192      	190868360      	0         	9         	9              	DEL       
chr1        	190941462   	190941645   	190941463      	190941645      	0         	13        	13             	DEL       
chr1        	192640667   	192640734   	192640670      	192640734      	1         	24        	25             	DEL       
chr1        	193266299   	193266527   	193266300      	193266527      	0         	12        	12             	DEL       
chr1        	194090948   	194091112   	194090950      	194091112      	0         	9         	9              	DEL       
chr1        	194381376   	194382173   	194381377      	194382173      	8         	0         	8              	DEL       
chr1        	194481861   	194485266   	194481920      	194485182      	15        	0         	15             	DEL       
chr1        	194548476   	194548737   	194548478      	194548737      	1         	15        	16             	DEL       
chr1        	194669487   	194669563   	194669488      	194669563      	15        	4         	19             	INV       
chr1        	197531377   	197534141   	197531390      	197534141      	37        	26        	63             	DEL       
chr1        	197787656   	197788856   	197787658      	197788856      	37        	13        	50             	INV       
chr1        	198804619   	198806285   	198804620      	198806285      	21        	12        	33             	DEL       
chr1        	199469597   	199471106   	199469615      	199471105      	19        	5         	24             	DEL       
chr1        	203715214   	203717113   	203715244      	203717071      	21        	0         	21             	DEL       
chr1        	203918537   	203920758   	203918555      	203920758      	12        	10        	22             	DEL       
chr1        	203925138   	203926753   	203925137      	203926752      	8         	0         	8              	DEL       
chr1        	203966702   	203976314   	203966703      	203976314      	22        	4         	26             	DEL       
chr1        	205209477   	205209655   	205209500      	205209646      	10        	5         	15             	INV       
chr1        	205470726   	205470896   	205470730      	205470896      	0         	5         	5              	DEL       
chr1        	205906489   	205906573   	205906490      	205906556      	0         	11        	11             	DEL       
chr1        	205957902   	205958411   	205957921      	205958411      	4         	10        	14             	DEL       
chr1        	205966737   	205967054   	205966752      	205967054      	0         	9         	9              	DEL       
chr1        	206052518   	206058501   	206052518      	206058499      	20        	0         	20             	DUP       
chr1        	206923992   	206924622   	206923954      	206924522      	16        	1         	17             	DUP       
chr1        	207118998   	207119850   	207119016      	207119850      	14        	0         	14             	DEL       
chr1        	207118998   	207119850   	207118999      	207119850      	5         	7         	12             	INV       
chr1        	207368617   	207372219   	207368689      	207372219      	51        	0         	51             	DEL       
chr1        	207667716   	207672469   	207667720      	207672469      	21        	10        	31             	DEL       
chr1        	209761661   	209762730   	209761662      	209762730      	8         	3         	11             	DUP       
chr1        	209761661   	209762730   	209761993      	209762731      	12        	9         	21             	DEL       
chr1        	209761989   	209762731   	209761662      	209762730      	8         	3         	11             	DUP       
chr1        	209761989   	209762731   	209761993      	209762731      	12        	9         	21             	DEL       
chr1        	212297792   	212299274   	212297811      	212299274      	45        	19        	64             	DEL       
chr1        	212468677   	212468763   	212468679      	212468763      	0         	4         	4              	DEL       
chr1        	214596759   	214597096   	214596760      	214597096      	1         	4         	5              	DEL       
chr1        	215021383   	215021437   	215021384      	215021437      	0         	10        	10             	DEL       
chr1        	217096615   	217096681   	217096618      	217096681      	0         	6         	6              	DEL       
chr1        	217744168   	217744482   	217744180      	217744482      	0         	10        	10             	DEL       
chr1        	218009145   	218015252   	218009160      	218015252      	45        	17        	62             	DEL       
chr1        	219749965   	219750284   	219749981      	219750284      	0         	16        	16             	DEL       
chr1        	220052682   	220052765   	220052684      	220052765      	1         	17        	18             	DEL       
chr1        	220112111   	220112432   	220112129      	220112432      	0         	9         	9              	DEL       
chr1        	220329600   	220330240   	220329603      	220330240      	9         	5         	14             	DEL       
chr1        	221860800   	221861133   	221860816      	221861133      	3         	18        	21             	DEL       
chr1        	224059399   	224059877   	224059415      	224059876      	11        	13        	24             	DEL       
chr1        	224205118   	224205432   	224205132      	224205432      	1         	17        	18             	DEL       
chr1        	224945628   	225060589   	224945628      	225060587      	10        	0         	10             	DUP       
chr1        	224945628   	225060589   	224945975      	225061110      	13        	0         	13             	DEL       
chr1        	224946112   	225061045   	224945628      	225060587      	10        	0         	10             	DUP       
chr1        	224946112   	225061045   	224945975      	225061110      	13        	0         	13             	DEL       
chr1        	225068828   	225069099   	225068843      	225069099      	0         	12        	12             	DEL       
chr1        	225574612   	225574932   	225574619      	225574923      	2         	10        	12             	DEL       
chr1        	225815111   	225815439   	225815115      	225815439      	1         	7         	8              	DEL       
chr1        	227836391   	227836704   	227836405      	227836704      	2         	20        	22             	DEL       
chr1        	228384458   	228384789   	228384474      	228384788      	1         	15        	16             	DEL       
chr1        	228518181   	228518315   	228518192      	228518315      	0         	10        	10             	DEL       
chr1        	228965617   	228965670   	228965618      	228965670      	0         	4         	4              	DEL       
chr1        	229237640   	229238015   	229237641      	229238015      	1         	11        	12             	DEL       
chr1        	232287371   	232287700   	232287387      	232287700      	0         	6         	6              	DEL       
chr1        	232322843   	232324505   	232322847      	232324505      	23        	6         	29             	DEL       
chr1        	232700828   	232701013   	232700830      	232701013      	0         	8         	8              	DEL       
chr1        	233826462   	233827806   	233826464      	233827820      	31        	0         	31             	DEL       
chr1        	233947342   	233947968   	233947343      	233947968      	4         	0         	4              	DEL       
chr1        	234451455   	234451766   	234451465      	234451766      	1         	19        	20             	DEL       
chr1        	235078244   	235078651   	235078244      	235078548      	0         	14        	14             	DUP       
chr1        	235398745   	235399058   	235398746      	235399058      	0         	4         	4              	DEL       
chr1        	235891274   	235891613   	235891291      	235891613      	0         	12        	12             	DEL       
chr1        	236385785   	236388029   	236385803      	236388029      	27        	16        	43             	DEL       
chr1        	236431624   	236431950   	236431639      	236431950      	2         	19        	21             	DEL       
chr1        	237402799   	237402911   	237402800      	237402911      	15        	11        	26             	INV       
chr1        	238689006   	238689950   	238689017      	238689950      	32        	16        	48             	DEL       
chr1        	240139269   	240139363   	240139272      	240139363      	0         	9         	9              	DEL       
chr1        	240229698   	240231482   	240229699      	240231482      	17        	11        	28             	DEL       
chr1        	240453689   	240454014   	240453707      	240454014      	2         	23        	25             	DEL       
chr1        	240675330   	240675928   	240675332      	240675928      	9         	4         	13             	DEL       
chr1        	240986555   	240986881   	240986573      	240986881      	2         	16        	18             	DEL       
chr1        	241197236   	241197552   	241197253      	241197552      	0         	21        	21             	DEL       
chr1        	241422924   	241423188   	241422927      	241423188      	0         	8         	8              	DEL       
chr1        	241528389   	241528744   	241528392      	241528744      	1         	6         	7              	DEL       
chr1        	243619442   	243620457   	243619443      	243620461      	36        	9         	45             	DEL       
chr1        	244275796   	244276338   	244275797      	244276338      	5         	0         	5              	DEL       
chr1        	245614856   	245614993   	245614894      	245614993      	0         	5         	5              	DEL       
chr1        	246003979   	246004077   	246003981      	246004077      	1         	17        	18             	DEL       
chr1        	246806594   	246806687   	246806595      	246806687      	0         	24        	24             	DEL       
chr1        	247128947   	247130060   	247128948      	247130060      	4         	0         	4              	DEL       
chr1        	247687159   	247693213   	247687173      	247693206      	55        	23        	78             	DEL       
chr1        	247795747   	247795801   	247795750      	247795801      	0         	6         	6              	DEL       
chr1        	247888175   	247894336   	247888190      	247894336      	26        	35        	61             	DEL       
chr1        	248443902   	248648187   	248443903      	248648187      	7         	0         	7              	INV       
chr1        	248674956   	248675918   	248674957      	248675918      	13        	0         	13             	DEL       
chr1        	248753078   	248753785   	248753078      	248753784      	6         	2         	8              	DUP       
chr10       	402011      	403621      	402012         	403621         	4         	0         	4              	DEL       
chr10       	723325      	723785      	723326         	723785         	8         	0         	8              	DEL       
chr10       	783832      	784504      	783787         	784494         	13        	0         	13             	DEL       
chr10       	1046566     	1047570     	1046567        	1047570        	13        	0         	13             	DEL       
chr10       	1326775     	1327751     	1326776        	1327751        	6         	0         	6              	DEL       
chr10       	1460004     	1460876     	1460005        	1460876        	5         	0         	5              	DEL       
chr10       	1560471     	1560586     	1560472        	1560546        	0         	8         	8              	DEL       
chr10       	2337275     	2337603     	2337292        	2337603        	3         	11        	14             	DEL       
chr10       	4247869     	4249490     	4247871        	4249490        	12        	10        	22             	DEL       
chr10       	4592608     	4592928     	4592619        	4592928        	3         	35        	38             	DEL       
chr10       	4666325     	4668330     	4666326        	4668330        	25        	9         	34             	DEL       
chr10       	6055406     	6055905     	6055423        	6055905        	10        	23        	33             	DEL       
chr10       	6210029     	6210933     	6210030        	6210933        	11        	0         	11             	DEL       
chr10       	6369600     	6375667     	6369618        	6375667        	58        	24        	82             	DEL       
chr10       	6835570     	6835673     	6835001        	6835621        	5         	0         	5              	DEL       
chr10       	7035077     	7036339     	7035078        	7036339        	19        	5         	24             	DEL       
chr10       	7751853     	7752075     	7751867        	7752075        	1         	20        	21             	DEL       
chr10       	7953864     	7954408     	7953921        	7954976        	24        	0         	24             	DEL       
chr10       	8562764     	8562888     	8562799        	8562888        	0         	5         	5              	DEL       
chr10       	9477851     	9478158     	9477865        	9478158        	1         	14        	15             	DEL       
chr10       	10193217    	10193272    	10193218       	10193272       	1         	3         	4              	DEL       
chr10       	10352704    	10352952    	10352713       	10352952       	0         	5         	5              	DEL       
chr10       	10451445    	10451769    	10451456       	10451769       	1         	7         	8              	DEL       
chr10       	10666579    	10666900    	10666580       	10666889       	3         	25        	28             	DEL       
chr10       	11365714    	11366602    	11365715       	11366602       	5         	0         	5              	DEL       
chr10       	11442966    	11443148    	11442970       	11443148       	0         	8         	8              	DEL       
chr10       	11915010    	11917681    	11914518       	11917414       	4         	0         	4              	DEL       
chr10       	11915010    	11917681    	11915010       	11917679       	5         	0         	5              	DUP       
chr10       	12518459    	12520974    	12518474       	12520974       	31        	11        	42             	DEL       
chr10       	12554202    	12554585    	12554210       	12554570       	0         	6         	6              	DEL       
chr10       	12775113    	12776023    	12775114       	12776023       	7         	0         	7              	DEL       
chr10       	12825167    	12825246    	12825168       	12825246       	13        	12        	25             	INV       
chr10       	13063036    	13063272    	13063037       	13063272       	45        	19        	64             	INV       
chr10       	13216020    	13216334    	13216021       	13216320       	2         	19        	21             	DEL       
chr10       	13217248    	13218740    	13217268       	13218740       	20        	13        	33             	DEL       
chr10       	14894348    	14894666    	14894360       	14894666       	0         	20        	20             	DEL       
chr10       	14981282    	14993470    	14981301       	14993491       	5         	0         	5              	DUP       
chr10       	15429080    	15429402    	15429090       	15429393       	2         	13        	15             	DEL       
chr10       	15490464    	15490775    	15490478       	15490775       	1         	6         	7              	DEL       
chr10       	19108378    	19108717    	19108388       	19108716       	1         	11        	12             	DEL       
chr10       	19215727    	19215870    	19215728       	19215855       	0         	10        	10             	DEL       
chr10       	19473088    	19473178    	19473099       	19473178       	0         	10        	10             	DEL       
chr10       	20189026    	20189194    	20189028       	20189194       	0         	11        	11             	DEL       
chr10       	20378315    	20378636    	20378330       	20378636       	1         	20        	21             	DEL       
chr10       	20535520    	20535638    	20535523       	20535638       	0         	9         	9              	DEL       
chr10       	23346562    	23346692    	23346565       	23346692       	0         	12        	12             	DEL       
chr10       	24087907    	24089512    	24087908       	24089512       	30        	4         	34             	DEL       
chr10       	24746256    	24746353    	24746263       	24746353       	1         	3         	4              	DEL       
chr10       	24809151    	24809491    	24809160       	24809490       	0         	12        	12             	DEL       
chr10       	25896167    	25896237    	25896168       	25896240       	0         	6         	6              	DEL       
chr10       	26065825    	26066144    	26065838       	26066144       	0         	7         	7              	DEL       
chr10       	26319289    	26319398    	26319293       	26319398       	1         	3         	4              	DEL       
chr10       	26479011    	26479318    	26479028       	26479318       	0         	21        	21             	DEL       
chr10       	26710085    	26713224    	26710111       	26713203       	17        	0         	17             	DEL       
chr10       	26935270    	26939156    	26935274       	26939156       	15        	8         	23             	DEL       
chr10       	26935270    	26939156    	26935698       	26940377       	20        	0         	20             	DUP       
chr10       	26935697    	26940378    	26935274       	26939156       	15        	8         	23             	DEL       
chr10       	26935697    	26940378    	26935698       	26940377       	20        	0         	20             	DUP       
chr10       	29629591    	29630062    	29629595       	29630062       	0         	7         	7              	DEL       
chr10       	31154420    	31155935    	31154439       	31155935       	35        	13        	48             	DEL       
chr10       	31687213    	31687619    	31687214       	31687619       	0         	5         	5              	DEL       
chr10       	31968951    	31971684    	31968967       	31971684       	21        	9         	30             	DEL       
chr10       	32416797    	32417136    	32416809       	32417136       	3         	22        	25             	DEL       
chr10       	33203711    	33204001    	33203726       	33204001       	0         	11        	11             	DEL       
chr10       	33728837    	33728930    	33728839       	33728930       	0         	7         	7              	DEL       
chr10       	34395539    	34395865    	34395555       	34395865       	2         	21        	23             	DEL       
chr10       	35742880    	35742966    	35742881       	35742942       	0         	8         	8              	DEL       
chr10       	36122938    	36123258    	36122957       	36123258       	2         	6         	8              	DEL       
chr10       	36395315    	37585955    	37167597       	37179476       	12        	0         	12             	DUP       
chr10       	36395315    	37585955    	36395315       	37585953       	7         	0         	7              	DUP       
chr10       	37167597    	37179478    	37167597       	37179476       	12        	0         	12             	DUP       
chr10       	37983056    	37983214    	37983072       	37983214       	0         	4         	4              	DEL       
chr10       	38594427    	38594503    	38594446       	38594503       	0         	10        	10             	DEL       
chr10       	38807120    	38809039    	38807120       	38808797       	24        	0         	24             	DUP       
chr10       	38807120    	38809039    	38808217       	38809094       	10        	0         	10             	DEL       
chr10       	38808216    	38809094    	38807120       	38808797       	24        	0         	24             	DUP       
chr10       	38808216    	38809094    	38808217       	38809094       	10        	0         	10             	DEL       
chr10       	39183198    	39183514    	39183199       	39183514       	1         	4         	5              	DEL       
chr10       	39257159    	39267936    	39257160       	39267936       	22        	11        	33             	DEL       
chr10       	39337846    	39338556    	39337847       	39338556       	27        	0         	27             	DEL       
chr10       	39337846    	39338556    	39338143       	39341998       	4         	0         	4              	DEL       
chr10       	39338142    	39341998    	39337847       	39338556       	27        	0         	27             	DEL       
chr10       	39338142    	39341998    	39338143       	39341998       	4         	0         	4              	DEL       
chr10       	39338142    	39341998    	39340874       	39359899       	26        	0         	26             	DEL       
chr10       	39340799    	39359943    	39338143       	39341998       	4         	0         	4              	DEL       
chr10       	39340799    	39359943    	39346682       	39347282       	13        	0         	13             	DEL       
chr10       	39340799    	39359943    	39340874       	39359899       	26        	0         	26             	DEL       
chr10       	39346681    	39347282    	39346682       	39347282       	13        	0         	13             	DEL       
chr10       	39365487    	39376022    	39365487       	39376018       	159       	0         	159            	DUP       
chr10       	39381759    	39382582    	39381832       	39382467       	23        	0         	23             	DUP       
chr10       	39405020    	39411635    	39404997       	39411696       	41        	0         	41             	DUP       
chr10       	39502411    	39503039    	39502412       	39503039       	6         	0         	6              	DEL       
chr10       	39529781    	39529907    	39529787       	39529907       	0         	8         	8              	DEL       
chr10       	39561653    	39900566    	39578023       	39578708       	8         	0         	8              	DEL       
chr10       	39561653    	39900566    	39561460       	39900402       	23        	0         	23             	DUP       
chr10       	39561653    	39900566    	39576326       	41228231       	4         	0         	4              	DUP       
chr10       	39576282    	41228469    	39578023       	39578708       	8         	0         	8              	DEL       
chr10       	39576282    	41228469    	39561460       	39900402       	23        	0         	23             	DUP       
chr10       	39576282    	41228469    	39576326       	41228231       	4         	0         	4              	DUP       
chr10       	42094598    	42101549    	42099797       	42100783       	4         	0         	4              	DEL       
chr10       	42094598    	42101549    	42094598       	42101547       	16        	0         	16             	DUP       
chr10       	42099796    	42100783    	42099797       	42100783       	4         	0         	4              	DEL       
chr10       	42206102    	42221342    	42206105       	42221389       	12        	0         	12             	DEL       
chr10       	44179784    	44179877    	44179788       	44179877       	0         	5         	5              	DEL       
chr10       	45986730    	49956082    	46271345       	46271954       	5         	0         	5              	DEL       
chr10       	45986730    	49956082    	46106685       	46283218       	13        	0         	13             	DUP       
chr10       	45986730    	49956082    	48709126       	48709434       	2         	29        	31             	DEL       
chr10       	45986730    	49956082    	45986730       	49956067       	5         	0         	5              	DUP       
chr10       	46106665    	46283212    	46271345       	46271954       	5         	0         	5              	DEL       
chr10       	46106665    	46283212    	46106685       	46283218       	13        	0         	13             	DUP       
chr10       	46271344    	46271954    	46271345       	46271954       	5         	0         	5              	DEL       
chr10       	48709110    	48709434    	48709126       	48709434       	2         	29        	31             	DEL       
chr10       	52224770    	52274343    	52255968       	52258483       	11        	0         	11             	DEL       
chr10       	52224770    	52274343    	52224770       	52274341       	4         	0         	4              	DUP       
chr10       	52255913    	52258511    	52255968       	52258483       	11        	0         	11             	DEL       
chr10       	52681435    	52681753    	52681449       	52681753       	1         	25        	26             	DEL       
chr10       	53101049    	53101369    	53101060       	53101369       	3         	17        	20             	DEL       
chr10       	54133904    	54134372    	54133905       	54134372       	5         	4         	9              	DEL       
chr10       	55158077    	55158190    	55158080       	55158190       	0         	4         	4              	DEL       
chr10       	55942264    	55942605    	55942287       	55942605       	1         	13        	14             	DEL       
chr10       	57497183    	57498223    	57497184       	57498223       	11        	0         	11             	DEL       
chr10       	59442926    	59443769    	59442928       	59443769       	27        	11        	38             	DEL       
chr10       	59605722    	59606042    	59605736       	59606042       	1         	6         	7              	DEL       
chr10       	61680597    	61680770    	61680600       	61680770       	0         	5         	5              	DEL       
chr10       	61983854    	61984033    	61983869       	61984033       	0         	10        	10             	DEL       
chr10       	65082046    	65082303    	65082049       	65082303       	0         	11        	11             	DEL       
chr10       	65272627    	65273043    	65272628       	65273043       	5         	16        	21             	DEL       
chr10       	65668864    	65668943    	65668865       	65668943       	6         	1         	7              	INV       
chr10       	65843226    	65843339    	65843227       	65843339       	0         	8         	8              	DEL       
chr10       	68827631    	68828250    	68827632       	68828250       	5         	0         	5              	DEL       
chr10       	68874567    	68874680    	68874582       	68874680       	0         	6         	6              	DEL       
chr10       	69026572    	69027556    	69026605       	69027420       	16        	1         	17             	DEL       
chr10       	69238353    	69238678    	69238368       	69238678       	1         	14        	15             	DEL       
chr10       	69555197    	69555312    	69555209       	69555312       	0         	12        	12             	DEL       
chr10       	70688978    	70691578    	70688984       	70691578       	4         	8         	12             	DEL       
chr10       	71496823    	71496944    	71496825       	71496944       	0         	11        	11             	DEL       
chr10       	73038612    	73038925    	73038627       	73038925       	5         	22        	27             	DEL       
chr10       	73082849    	73083074    	73082850       	73083074       	0         	16        	16             	DEL       
chr10       	73659954    	73660152    	73659953       	73660152       	34        	29        	63             	INV       
chr10       	76495813    	76501261    	76495820       	76501261       	60        	36        	96             	DEL       
chr10       	76586830    	76591819    	76586846       	76591819       	22        	8         	30             	DEL       
chr10       	77041143    	77041463    	77041153       	77041463       	2         	6         	8              	DEL       
chr10       	79332424    	79333023    	79332425       	79333023       	7         	7         	14             	DEL       
chr10       	79428401    	79428478    	79428402       	79428478       	0         	5         	5              	DEL       
chr10       	80027680    	80043766    	80027680       	80043749       	7         	0         	7              	DUP       
chr10       	80977980    	80978300    	80977995       	80978300       	2         	10        	12             	DEL       
chr10       	81144900    	81145154    	81144901       	81145154       	0         	17        	17             	DEL       
chr10       	82478215    	82478709    	82478233       	82478709       	9         	20        	29             	DEL       
chr10       	82640999    	82641149    	82641016       	82641149       	0         	9         	9              	DEL       
chr10       	83616168    	83616388    	83616180       	83616388       	0         	15        	15             	DEL       
chr10       	83762958    	83764149    	83762959       	83764149       	28        	14        	42             	DEL       
chr10       	83866465    	83866673    	83866476       	83866668       	1         	8         	9              	DEL       
chr10       	83907450    	83907659    	83907451       	83907659       	0         	11        	11             	DUP       
chr10       	86353443    	86353555    	86353444       	86353555       	0         	4         	4              	DEL       
chr10       	86906417    	86906758    	86906437       	86906758       	1         	12        	13             	DEL       
chr10       	87516038    	87516811    	87516039       	87516811       	15        	0         	15             	DEL       
chr10       	88695220    	88695346    	88695247       	88695346       	0         	8         	8              	DEL       
chr10       	89787626    	89787963    	89787642       	89787963       	3         	15        	18             	DEL       
chr10       	91209467    	91209806    	91209474       	91209806       	0         	23        	23             	DEL       
chr10       	91615007    	91615121    	91615012       	91615121       	0         	12        	12             	DEL       
chr10       	91873577    	91874805    	91873581       	91874805       	36        	22        	58             	DEL       
chr10       	92374841    	92377896    	92374842       	92377896       	32        	12        	44             	DEL       
chr10       	93785719    	93786738    	93785720       	93786738       	37        	12        	49             	DEL       
chr10       	94491783    	94491960    	94491787       	94491960       	1         	25        	26             	DEL       
chr10       	95049856    	95049947    	95049857       	95049952       	0         	9         	9              	DEL       
chr10       	95447027    	95448263    	95447028       	95448268       	10        	5         	15             	DUP       
chr10       	95447027    	95448263    	95447298       	95448270       	5         	3         	8              	DEL       
chr10       	95447296    	95448270    	95447028       	95448268       	10        	5         	15             	DUP       
chr10       	95447296    	95448270    	95447298       	95448270       	5         	3         	8              	DEL       
chr10       	97275105    	97277640    	97275116       	97277640       	34        	14        	48             	DEL       
chr10       	97348524    	97348851    	97348534       	97348851       	1         	15        	16             	DEL       
chr10       	97657810    	97657869    	97657819       	97657869       	0         	14        	14             	DEL       
chr10       	99535443    	99535528    	99535444       	99535528       	0         	4         	4              	DEL       
chr10       	99900318    	99900695    	99900319       	99900695       	2         	4         	6              	DUP       
chr10       	101634254   	101635335   	101634259      	101635335      	18        	6         	24             	DEL       
chr10       	102087101   	102092460   	102087132      	102092464      	13        	0         	13             	DEL       
chr10       	102787990   	102788200   	102788003      	102788200      	0         	4         	4              	DEL       
chr10       	103293406   	103294435   	103293452      	103294414      	15        	0         	15             	DEL       
chr10       	103337764   	103338079   	103337782      	103338079      	1         	5         	6              	DEL       
chr10       	105493239   	105493593   	105493244      	105493593      	0         	8         	8              	DEL       
chr10       	106190923   	106191837   	106190926      	106191837      	35        	9         	44             	DEL       
chr10       	106237427   	106237532   	106237446      	106237532      	0         	8         	8              	DEL       
chr10       	106270558   	106272783   	106270563      	106272783      	44        	13        	57             	DEL       
chr10       	107483945   	107484102   	107483946      	107484104      	0         	5         	5              	DEL       
chr10       	109276618   	109276939   	109276636      	109276939      	1         	12        	13             	DEL       
chr10       	109812351   	109818459   	109812297      	109818458      	36        	0         	36             	DEL       
chr10       	111431789   	111432100   	111431805      	111432100      	1         	10        	11             	DEL       
chr10       	112398025   	112398364   	112398043      	112398364      	1         	11        	12             	DEL       
chr10       	115952104   	115952491   	115952106      	115952491      	2         	9         	11             	DEL       
chr10       	116505796   	116506120   	116505812      	116506120      	3         	9         	12             	DEL       
chr10       	117570737   	117570921   	117570738      	117570921      	0         	4         	4              	DEL       
chr10       	117874762   	117875094   	117874772      	117875094      	3         	16        	19             	DEL       
chr10       	120467141   	120469291   	120467194      	120469249      	46        	0         	46             	DEL       
chr10       	123619427   	123619498   	123619425      	123619498      	0         	4         	4              	DEL       
chr10       	123683112   	123683174   	123683114      	123683174      	0         	4         	4              	DEL       
chr10       	124227034   	124227582   	124227034      	124227551      	6         	0         	6              	DUP       
chr10       	125503085   	125508665   	125503088      	125508665      	17        	5         	22             	DEL       
chr10       	125824765   	125825185   	125824766      	125825185      	5         	15        	20             	DUP       
chr10       	126251396   	126252264   	126251497      	126252160      	12        	0         	12             	DUP       
chr10       	126417902   	126418217   	126417916      	126418217      	0         	16        	16             	DEL       
chr10       	126952678   	126952875   	126952679      	126952875      	0         	5         	5              	DUP       
chr10       	127222774   	127222855   	127222776      	127222855      	0         	5         	5              	DEL       
chr10       	127767037   	127767344   	127767049      	127767344      	2         	7         	9              	DEL       
chr10       	129038606   	129039010   	129038607      	129039010      	4         	14        	18             	DEL       
chr10       	129796912   	129797209   	129796916      	129797209      	3         	13        	16             	DEL       
chr10       	130573914   	130574060   	130573917      	130574060      	0         	7         	7              	DEL       
chr10       	130759120   	130760656   	130759121      	130760656      	5         	0         	5              	DEL       
chr10       	130790016   	130791120   	130790069      	130790684      	8         	1         	9              	DUP       
chr10       	131060207   	131060558   	131060226      	131060557      	1         	8         	9              	DEL       
chr10       	131176383   	131177219   	131176466      	131177158      	16        	3         	19             	DUP       
chr10       	131190420   	131192941   	131190421      	131192945      	27        	3         	30             	DEL       
chr10       	132358358   	132358934   	132358359      	132358934      	6         	0         	6              	DEL       
chr10       	132914063   	132914721   	132914064      	132914721      	6         	0         	6              	DEL       
chr10       	133221830   	133221999   	133221839      	133221977      	0         	9         	9              	DEL       
chr10       	133291287   	133292479   	133291311      	133291882      	23        	0         	23             	DEL       
chr11       	356450      	356741      	356450         	357511         	11        	0         	11             	DUP       
chr11       	1016583     	1018032     	1016606        	1017992        	54        	0         	54             	DUP       
chr11       	1894043     	1915725     	1894044        	1915725        	39        	10        	49             	DEL       
chr11       	3442804     	67825330    	4946959        	4955624        	10        	0         	10             	DEL       
chr11       	3442804     	67825330    	5085744        	5085981        	0         	12        	12             	DEL       
chr11       	3442804     	67825330    	5602310        	5602877        	10        	0         	10             	DEL       
chr11       	3442804     	67825330    	6551849        	6552281        	0         	5         	5              	DEL       
chr11       	3442804     	67825330    	6860133        	6860777        	5         	0         	5              	DEL       
chr11       	3442804     	67825330    	7113546        	7115212        	35        	0         	35             	DEL       
chr11       	3442804     	67825330    	7188079        	7188381        	0         	17        	17             	DEL       
chr11       	3442804     	67825330    	7768802        	7770409        	24        	0         	24             	DEL       
chr11       	3442804     	67825330    	8304521        	8304648        	0         	8         	8              	DEL       
chr11       	3442804     	67825330    	9302132        	9303057        	34        	0         	34             	DEL       
chr11       	3442804     	67825330    	9504260        	9505278        	12        	0         	12             	DEL       
chr11       	3442804     	67825330    	9583756        	9583828        	0         	6         	6              	DEL       
chr11       	3442804     	67825330    	10238502       	10239766       	18        	9         	27             	DEL       
chr11       	3442804     	67825330    	10271199       	10272287       	18        	9         	27             	DEL       
chr11       	3442804     	67825330    	11358074       	11359480       	14        	11        	25             	DEL       
chr11       	3442804     	67825330    	11801441       	11803076       	20        	13        	33             	DEL       
chr11       	3442804     	67825330    	11854080       	11854952       	16        	0         	16             	DEL       
chr11       	3442804     	67825330    	12131011       	12131321       	0         	17        	17             	DEL       
chr11       	3442804     	67825330    	12922195       	12922462       	0         	5         	5              	DEL       
chr11       	3442804     	67825330    	14326779       	14327080       	2         	24        	26             	DEL       
chr11       	3442804     	67825330    	16565615       	16565752       	0         	24        	24             	DEL       
chr11       	3442804     	67825330    	16576031       	16576339       	0         	17        	17             	DEL       
chr11       	3442804     	67825330    	16884003       	16884053       	0         	5         	5              	DEL       
chr11       	3442804     	67825330    	16974631       	16975046       	6         	22        	28             	DEL       
chr11       	3442804     	67825330    	17188209       	17189668       	19        	1         	20             	DEL       
chr11       	3442804     	67825330    	18538335       	18538966       	0         	4         	4              	DEL       
chr11       	3442804     	67825330    	20823011       	20828401       	16        	5         	21             	DEL       
chr11       	3442804     	67825330    	22991040       	22991091       	0         	5         	5              	DEL       
chr11       	3442804     	67825330    	24421607       	24430741       	24        	10        	34             	DEL       
chr11       	3442804     	67825330    	25047331       	25047416       	1         	5         	6              	DEL       
chr11       	3442804     	67825330    	25410957       	25411180       	1         	25        	26             	DEL       
chr11       	3442804     	67825330    	25413688       	25413754       	0         	23        	23             	DEL       
chr11       	3442804     	67825330    	26127739       	26127885       	0         	9         	9              	DEL       
chr11       	3442804     	67825330    	26383497       	26383562       	0         	6         	6              	DEL       
chr11       	3442804     	67825330    	26658408       	26658500       	1         	18        	19             	DEL       
chr11       	3442804     	67825330    	9751721        	27194661       	0         	4         	4              	DEL       
chr11       	3442804     	67825330    	27286339       	27286655       	0         	14        	14             	DEL       
chr11       	3442804     	67825330    	27635716       	27636048       	1         	13        	14             	DEL       
chr11       	3442804     	67825330    	28688409       	28688471       	0         	12        	12             	DEL       
chr11       	3442804     	67825330    	28985654       	28991341       	21        	0         	21             	DEL       
chr11       	3442804     	67825330    	29946032       	29946919       	24        	17        	41             	DEL       
chr11       	3442804     	67825330    	31130900       	31131200       	1         	10        	11             	DEL       
chr11       	3442804     	67825330    	31372229       	31376099       	11        	6         	17             	DEL       
chr11       	3442804     	67825330    	32212215       	32212604       	0         	4         	4              	DEL       
chr11       	3442804     	67825330    	32265107       	32265427       	0         	12        	12             	DEL       
chr11       	3442804     	67825330    	32367715       	32369112       	26        	0         	26             	DEL       
chr11       	3442804     	67825330    	33516141       	33516449       	1         	25        	26             	DEL       
chr11       	3442804     	67825330    	33638404       	33638469       	0         	12        	12             	DEL       
chr11       	3442804     	67825330    	34706576       	34707069       	5         	10        	15             	DEL       
chr11       	3442804     	67825330    	37427267       	37427346       	1         	5         	6              	DEL       
chr11       	3442804     	67825330    	38078052       	38078357       	4         	9         	13             	DEL       
chr11       	3442804     	67825330    	38989192       	38989255       	0         	12        	12             	DEL       
chr11       	3442804     	67825330    	39595141       	39595570       	7         	0         	7              	INV       
chr11       	3442804     	67825330    	39764358       	39764424       	2         	19        	21             	DEL       
chr11       	3442804     	67825330    	39783577       	39783899       	1         	16        	17             	DEL       
chr11       	3442804     	67825330    	40985482       	40985790       	2         	8         	10             	DEL       
chr11       	3442804     	67825330    	41341968       	41342185       	0         	6         	6              	DEL       
chr11       	3442804     	67825330    	41796648       	41797472       	39        	8         	47             	DEL       
chr11       	3442804     	67825330    	41800745       	41801057       	1         	23        	24             	DEL       
chr11       	3442804     	67825330    	42134614       	42134928       	0         	5         	5              	DEL       
chr11       	3442804     	67825330    	42442556       	42442859       	0         	21        	21             	DEL       
chr11       	3442804     	67825330    	43870294       	43870615       	1         	16        	17             	DEL       
chr11       	3442804     	67825330    	43888076       	43888349       	0         	10        	10             	DEL       
chr11       	3442804     	67825330    	45111214       	45111405       	0         	14        	14             	DEL       
chr11       	3442804     	67825330    	45408299       	45410063       	10        	6         	16             	DEL       
chr11       	3442804     	67825330    	47036037       	47042160       	53        	11        	64             	DEL       
chr11       	3442804     	67825330    	47866115       	47866642       	3         	5         	8              	DEL       
chr11       	3442804     	67825330    	48098519       	48098818       	1         	20        	21             	DEL       
chr11       	3442804     	67825330    	48579306       	48582730       	54        	24        	78             	DEL       
chr11       	3442804     	67825330    	48668466       	48668602       	2         	13        	15             	DEL       
chr11       	3442804     	67825330    	48713231       	48715366       	52        	0         	52             	DEL       
chr11       	3442804     	67825330    	48791951       	48792845       	6         	0         	6              	DEL       
chr11       	3442804     	67825330    	48833331       	48834235       	5         	0         	5              	DEL       
chr11       	3442804     	67825330    	48859231       	48860183       	43        	0         	43             	DEL       
chr11       	3442804     	67825330    	48907396       	48907703       	2         	3         	5              	DEL       
chr11       	3442804     	67825330    	48912762       	48913320       	6         	0         	6              	DEL       
chr11       	3442804     	67825330    	48923189       	48923798       	48        	0         	48             	DEL       
chr11       	3442804     	67825330    	48926938       	48927657       	16        	0         	16             	DEL       
chr11       	3442804     	67825330    	49817793       	49852373       	18        	0         	18             	DUP       
chr11       	3442804     	67825330    	49818107       	49852814       	4         	0         	4              	DEL       
chr11       	3442804     	67825330    	50482740       	50483226       	3         	1         	4              	DEL       
chr11       	3442804     	67825330    	50588416       	50589234       	8         	0         	8              	DEL       
chr11       	3442804     	67825330    	50653357       	50655059       	23        	0         	23             	DUP       
chr11       	3442804     	67825330    	50681116       	50681903       	52        	0         	52             	DEL       
chr11       	3442804     	67825330    	50764193       	50765083       	5         	0         	5              	DEL       
chr11       	3442804     	67825330    	51142865       	52308261       	16        	0         	16             	DEL       
chr11       	3442804     	67825330    	51125059       	52308266       	7         	0         	7              	DEL       
chr11       	3442804     	67825330    	51124785       	52673450       	11        	0         	11             	DUP       
chr11       	3442804     	67825330    	52308264       	52673468       	15        	0         	15             	DUP       
chr11       	3442804     	67825330    	51124788       	52730354       	22        	0         	22             	DUP       
chr11       	3442804     	67825330    	52308259       	52730447       	19        	0         	19             	DUP       
chr11       	3442804     	67825330    	52795279       	52853884       	7         	0         	7              	DUP       
chr11       	3442804     	67825330    	52560870       	53048902       	9         	0         	9              	DEL       
chr11       	3442804     	67825330    	53022578       	53074589       	4         	0         	4              	DEL       
chr11       	3442804     	67825330    	52211675       	53193821       	4         	0         	4              	DUP       
chr11       	3442804     	67825330    	52826759       	53622459       	7         	0         	7              	DEL       
chr11       	3442804     	67825330    	53559186       	53665628       	5         	0         	5              	DUP       
chr11       	3442804     	67825330    	51142481       	53716719       	33        	0         	33             	DUP       
chr11       	3442804     	67825330    	51124895       	53716747       	13        	0         	13             	DUP       
chr11       	3442804     	67825330    	53193647       	53716754       	7         	0         	7              	DUP       
chr11       	3442804     	67825330    	52308258       	53716836       	16        	0         	16             	DUP       
chr11       	3442804     	67825330    	53716340       	53742598       	9         	0         	9              	DUP       
chr11       	3442804     	67825330    	52304543       	53742372       	9         	0         	9              	DEL       
chr11       	3442804     	67825330    	53108426       	53900199       	5         	0         	5              	DEL       
chr11       	3442804     	67825330    	52304530       	54013868       	10        	0         	10             	DEL       
chr11       	3442804     	67825330    	53193620       	54014281       	5         	0         	5              	DUP       
chr11       	3442804     	67825330    	53716293       	54014299       	15        	0         	15             	DUP       
chr11       	3442804     	67825330    	52161850       	54227856       	4         	0         	4              	DUP       
chr11       	3442804     	67825330    	52211857       	54272665       	5         	0         	5              	DEL       
chr11       	3442804     	67825330    	54241776       	54311703       	4         	0         	4              	DUP       
chr11       	3442804     	67825330    	52730033       	54351091       	4         	0         	4              	DUP       
chr11       	3442804     	67825330    	53900489       	54369514       	5         	0         	5              	DEL       
chr11       	3442804     	67825330    	54345323       	54372909       	6         	0         	6              	DUP       
chr11       	3442804     	67825330    	54372653       	54376865       	9         	0         	9              	DEL       
chr11       	3442804     	67825330    	54371449       	54377382       	9         	0         	9              	DUP       
chr11       	3442804     	67825330    	54371716       	54380032       	5         	0         	5              	DEL       
chr11       	3442804     	67825330    	54346547       	54390784       	9         	0         	9              	DUP       
chr11       	3442804     	67825330    	54347409       	54403779       	5         	0         	5              	DEL       
chr11       	3442804     	67825330    	54347382       	54405634       	4         	0         	4              	DUP       
chr11       	3442804     	67825330    	54369455       	54405445       	4         	0         	4              	DEL       
chr11       	3442804     	67825330    	54347148       	54409398       	10        	0         	10             	DUP       
chr11       	3442804     	67825330    	54374245       	54409220       	4         	0         	4              	DEL       
chr11       	3442804     	67825330    	54344917       	54409518       	4         	0         	4              	DEL       
chr11       	3442804     	67825330    	54369108       	54415838       	5         	0         	5              	DUP       
chr11       	3442804     	67825330    	54345321       	54419794       	5         	0         	5              	DUP       
chr11       	3442804     	67825330    	53108468       	54423489       	7         	0         	7              	DEL       
chr11       	3442804     	67825330    	54542731       	54543587       	27        	0         	27             	DEL       
chr11       	3442804     	67825330    	54544101       	54548200       	7         	0         	7              	DEL       
chr11       	3442804     	67825330    	54415670       	54549078       	10        	0         	10             	DUP       
chr11       	3442804     	67825330    	54384302       	54549176       	8         	0         	8              	DUP       
chr11       	3442804     	67825330    	54359866       	54549392       	8         	0         	8              	DUP       
chr11       	3442804     	67825330    	54756334       	54778069       	54        	0         	54             	DEL       
chr11       	3442804     	67825330    	54934922       	54937899       	51        	0         	51             	DUP       
chr11       	3442804     	67825330    	55057736       	55057935       	0         	13        	13             	DUP       
chr11       	3442804     	67825330    	55117879       	55124742       	20        	0         	20             	DEL       
chr11       	3442804     	67825330    	48726978       	55124774       	16        	0         	16             	DEL       
chr11       	3442804     	67825330    	48727094       	55125503       	22        	0         	22             	DUP       
chr11       	3442804     	67825330    	55247405       	55249031       	48        	0         	48             	DUP       
chr11       	3442804     	67825330    	58399526       	58400676       	35        	17        	52             	DEL       
chr11       	3442804     	67825330    	61099466       	61100057       	8         	0         	8              	DUP       
chr11       	3442804     	67825330    	62009734       	62010566       	21        	0         	21             	DUP       
chr11       	3442804     	67825330    	62122849       	62122922       	0         	15        	15             	DEL       
chr11       	3442804     	67825330    	62177315       	62177613       	1         	12        	13             	DEL       
chr11       	3442804     	67825330    	62366672       	62385323       	8         	0         	8              	DUP       
chr11       	3442804     	67825330    	63931437       	63934181       	28        	12        	40             	DEL       
chr11       	3442804     	67825330    	63931434       	63934472       	22        	9         	31             	DUP       
chr11       	3442804     	67825330    	64199451       	64199614       	0         	4         	4              	DEL       
chr11       	3442804     	67825330    	64500969       	64501027       	0         	10        	10             	DEL       
chr11       	3442804     	67825330    	22433304       	65396970       	14        	2         	16             	DEL       
chr11       	3442804     	67825330    	22433287       	65397332       	14        	14        	28             	DUP       
chr11       	3442804     	67825330    	65874640       	65876048       	30        	10        	40             	DEL       
chr11       	3442804     	67825330    	66944033       	66945934       	11        	0         	11             	DEL       
chr11       	3442804     	67825330    	67717014       	67739782       	5         	0         	5              	DUP       
chr11       	3442804     	67825330    	3442804        	67825328       	5         	0         	5              	DUP       
chr11       	3442804     	67825330    	3463872        	67837613       	7         	0         	7              	DUP       
chr11       	3463872     	67837615    	4946959        	4955624        	10        	0         	10             	DEL       
chr11       	3463872     	67837615    	5085744        	5085981        	0         	12        	12             	DEL       
chr11       	3463872     	67837615    	5602310        	5602877        	10        	0         	10             	DEL       
chr11       	3463872     	67837615    	6551849        	6552281        	0         	5         	5              	DEL       
chr11       	3463872     	67837615    	6860133        	6860777        	5         	0         	5              	DEL       
chr11       	3463872     	67837615    	7113546        	7115212        	35        	0         	35             	DEL       
chr11       	3463872     	67837615    	7188079        	7188381        	0         	17        	17             	DEL       
chr11       	3463872     	67837615    	7768802        	7770409        	24        	0         	24             	DEL       
chr11       	3463872     	67837615    	8304521        	8304648        	0         	8         	8              	DEL       
chr11       	3463872     	67837615    	9302132        	9303057        	34        	0         	34             	DEL       
chr11       	3463872     	67837615    	9504260        	9505278        	12        	0         	12             	DEL       
chr11       	3463872     	67837615    	9583756        	9583828        	0         	6         	6              	DEL       
chr11       	3463872     	67837615    	10238502       	10239766       	18        	9         	27             	DEL       
chr11       	3463872     	67837615    	10271199       	10272287       	18        	9         	27             	DEL       
chr11       	3463872     	67837615    	11358074       	11359480       	14        	11        	25             	DEL       
chr11       	3463872     	67837615    	11801441       	11803076       	20        	13        	33             	DEL       
chr11       	3463872     	67837615    	11854080       	11854952       	16        	0         	16             	DEL       
chr11       	3463872     	67837615    	12131011       	12131321       	0         	17        	17             	DEL       
chr11       	3463872     	67837615    	12922195       	12922462       	0         	5         	5              	DEL       
chr11       	3463872     	67837615    	14326779       	14327080       	2         	24        	26             	DEL       
chr11       	3463872     	67837615    	16565615       	16565752       	0         	24        	24             	DEL       
chr11       	3463872     	67837615    	16576031       	16576339       	0         	17        	17             	DEL       
chr11       	3463872     	67837615    	16884003       	16884053       	0         	5         	5              	DEL       
chr11       	3463872     	67837615    	16974631       	16975046       	6         	22        	28             	DEL       
chr11       	3463872     	67837615    	17188209       	17189668       	19        	1         	20             	DEL       
chr11       	3463872     	67837615    	18538335       	18538966       	0         	4         	4              	DEL       
chr11       	3463872     	67837615    	20823011       	20828401       	16        	5         	21             	DEL       
chr11       	3463872     	67837615    	22991040       	22991091       	0         	5         	5              	DEL       
chr11       	3463872     	67837615    	24421607       	24430741       	24        	10        	34             	DEL       
chr11       	3463872     	67837615    	25047331       	25047416       	1         	5         	6              	DEL       
chr11       	3463872     	67837615    	25410957       	25411180       	1         	25        	26             	DEL       
chr11       	3463872     	67837615    	25413688       	25413754       	0         	23        	23             	DEL       
chr11       	3463872     	67837615    	26127739       	26127885       	0         	9         	9              	DEL       
chr11       	3463872     	67837615    	26383497       	26383562       	0         	6         	6              	DEL       
chr11       	3463872     	67837615    	26658408       	26658500       	1         	18        	19             	DEL       
chr11       	3463872     	67837615    	9751721        	27194661       	0         	4         	4              	DEL       
chr11       	3463872     	67837615    	27286339       	27286655       	0         	14        	14             	DEL       
chr11       	3463872     	67837615    	27635716       	27636048       	1         	13        	14             	DEL       
chr11       	3463872     	67837615    	28688409       	28688471       	0         	12        	12             	DEL       
chr11       	3463872     	67837615    	28985654       	28991341       	21        	0         	21             	DEL       
chr11       	3463872     	67837615    	29946032       	29946919       	24        	17        	41             	DEL       
chr11       	3463872     	67837615    	31130900       	31131200       	1         	10        	11             	DEL       
chr11       	3463872     	67837615    	31372229       	31376099       	11        	6         	17             	DEL       
chr11       	3463872     	67837615    	32212215       	32212604       	0         	4         	4              	DEL       
chr11       	3463872     	67837615    	32265107       	32265427       	0         	12        	12             	DEL       
chr11       	3463872     	67837615    	32367715       	32369112       	26        	0         	26             	DEL       
chr11       	3463872     	67837615    	33516141       	33516449       	1         	25        	26             	DEL       
chr11       	3463872     	67837615    	33638404       	33638469       	0         	12        	12             	DEL       
chr11       	3463872     	67837615    	34706576       	34707069       	5         	10        	15             	DEL       
chr11       	3463872     	67837615    	37427267       	37427346       	1         	5         	6              	DEL       
chr11       	3463872     	67837615    	38078052       	38078357       	4         	9         	13             	DEL       
chr11       	3463872     	67837615    	38989192       	38989255       	0         	12        	12             	DEL       
chr11       	3463872     	67837615    	39595141       	39595570       	7         	0         	7              	INV       
chr11       	3463872     	67837615    	39764358       	39764424       	2         	19        	21             	DEL       
chr11       	3463872     	67837615    	39783577       	39783899       	1         	16        	17             	DEL       
chr11       	3463872     	67837615    	40985482       	40985790       	2         	8         	10             	DEL       
chr11       	3463872     	67837615    	41341968       	41342185       	0         	6         	6              	DEL       
chr11       	3463872     	67837615    	41796648       	41797472       	39        	8         	47             	DEL       
chr11       	3463872     	67837615    	41800745       	41801057       	1         	23        	24             	DEL       
chr11       	3463872     	67837615    	42134614       	42134928       	0         	5         	5              	DEL       
chr11       	3463872     	67837615    	42442556       	42442859       	0         	21        	21             	DEL       
chr11       	3463872     	67837615    	43870294       	43870615       	1         	16        	17             	DEL       
chr11       	3463872     	67837615    	43888076       	43888349       	0         	10        	10             	DEL       
chr11       	3463872     	67837615    	45111214       	45111405       	0         	14        	14             	DEL       
chr11       	3463872     	67837615    	45408299       	45410063       	10        	6         	16             	DEL       
chr11       	3463872     	67837615    	47036037       	47042160       	53        	11        	64             	DEL       
chr11       	3463872     	67837615    	47866115       	47866642       	3         	5         	8              	DEL       
chr11       	3463872     	67837615    	48098519       	48098818       	1         	20        	21             	DEL       
chr11       	3463872     	67837615    	48579306       	48582730       	54        	24        	78             	DEL       
chr11       	3463872     	67837615    	48668466       	48668602       	2         	13        	15             	DEL       
chr11       	3463872     	67837615    	48713231       	48715366       	52        	0         	52             	DEL       
chr11       	3463872     	67837615    	48791951       	48792845       	6         	0         	6              	DEL       
chr11       	3463872     	67837615    	48833331       	48834235       	5         	0         	5              	DEL       
chr11       	3463872     	67837615    	48859231       	48860183       	43        	0         	43             	DEL       
chr11       	3463872     	67837615    	48907396       	48907703       	2         	3         	5              	DEL       
chr11       	3463872     	67837615    	48912762       	48913320       	6         	0         	6              	DEL       
chr11       	3463872     	67837615    	48923189       	48923798       	48        	0         	48             	DEL       
chr11       	3463872     	67837615    	48926938       	48927657       	16        	0         	16             	DEL       
chr11       	3463872     	67837615    	49817793       	49852373       	18        	0         	18             	DUP       
chr11       	3463872     	67837615    	49818107       	49852814       	4         	0         	4              	DEL       
chr11       	3463872     	67837615    	50482740       	50483226       	3         	1         	4              	DEL       
chr11       	3463872     	67837615    	50588416       	50589234       	8         	0         	8              	DEL       
chr11       	3463872     	67837615    	50653357       	50655059       	23        	0         	23             	DUP       
chr11       	3463872     	67837615    	50681116       	50681903       	52        	0         	52             	DEL       
chr11       	3463872     	67837615    	50764193       	50765083       	5         	0         	5              	DEL       
chr11       	3463872     	67837615    	51142865       	52308261       	16        	0         	16             	DEL       
chr11       	3463872     	67837615    	51125059       	52308266       	7         	0         	7              	DEL       
chr11       	3463872     	67837615    	51124785       	52673450       	11        	0         	11             	DUP       
chr11       	3463872     	67837615    	52308264       	52673468       	15        	0         	15             	DUP       
chr11       	3463872     	67837615    	51124788       	52730354       	22        	0         	22             	DUP       
chr11       	3463872     	67837615    	52308259       	52730447       	19        	0         	19             	DUP       
chr11       	3463872     	67837615    	52795279       	52853884       	7         	0         	7              	DUP       
chr11       	3463872     	67837615    	52560870       	53048902       	9         	0         	9              	DEL       
chr11       	3463872     	67837615    	53022578       	53074589       	4         	0         	4              	DEL       
chr11       	3463872     	67837615    	52211675       	53193821       	4         	0         	4              	DUP       
chr11       	3463872     	67837615    	52826759       	53622459       	7         	0         	7              	DEL       
chr11       	3463872     	67837615    	53559186       	53665628       	5         	0         	5              	DUP       
chr11       	3463872     	67837615    	51142481       	53716719       	33        	0         	33             	DUP       
chr11       	3463872     	67837615    	51124895       	53716747       	13        	0         	13             	DUP       
chr11       	3463872     	67837615    	53193647       	53716754       	7         	0         	7              	DUP       
chr11       	3463872     	67837615    	52308258       	53716836       	16        	0         	16             	DUP       
chr11       	3463872     	67837615    	53716340       	53742598       	9         	0         	9              	DUP       
chr11       	3463872     	67837615    	52304543       	53742372       	9         	0         	9              	DEL       
chr11       	3463872     	67837615    	53108426       	53900199       	5         	0         	5              	DEL       
chr11       	3463872     	67837615    	52304530       	54013868       	10        	0         	10             	DEL       
chr11       	3463872     	67837615    	53193620       	54014281       	5         	0         	5              	DUP       
chr11       	3463872     	67837615    	53716293       	54014299       	15        	0         	15             	DUP       
chr11       	3463872     	67837615    	52161850       	54227856       	4         	0         	4              	DUP       
chr11       	3463872     	67837615    	52211857       	54272665       	5         	0         	5              	DEL       
chr11       	3463872     	67837615    	54241776       	54311703       	4         	0         	4              	DUP       
chr11       	3463872     	67837615    	52730033       	54351091       	4         	0         	4              	DUP       
chr11       	3463872     	67837615    	53900489       	54369514       	5         	0         	5              	DEL       
chr11       	3463872     	67837615    	54345323       	54372909       	6         	0         	6              	DUP       
chr11       	3463872     	67837615    	54372653       	54376865       	9         	0         	9              	DEL       
chr11       	3463872     	67837615    	54371449       	54377382       	9         	0         	9              	DUP       
chr11       	3463872     	67837615    	54371716       	54380032       	5         	0         	5              	DEL       
chr11       	3463872     	67837615    	54346547       	54390784       	9         	0         	9              	DUP       
chr11       	3463872     	67837615    	54347409       	54403779       	5         	0         	5              	DEL       
chr11       	3463872     	67837615    	54347382       	54405634       	4         	0         	4              	DUP       
chr11       	3463872     	67837615    	54369455       	54405445       	4         	0         	4              	DEL       
chr11       	3463872     	67837615    	54347148       	54409398       	10        	0         	10             	DUP       
chr11       	3463872     	67837615    	54374245       	54409220       	4         	0         	4              	DEL       
chr11       	3463872     	67837615    	54344917       	54409518       	4         	0         	4              	DEL       
chr11       	3463872     	67837615    	54369108       	54415838       	5         	0         	5              	DUP       
chr11       	3463872     	67837615    	54345321       	54419794       	5         	0         	5              	DUP       
chr11       	3463872     	67837615    	53108468       	54423489       	7         	0         	7              	DEL       
chr11       	3463872     	67837615    	54542731       	54543587       	27        	0         	27             	DEL       
chr11       	3463872     	67837615    	54544101       	54548200       	7         	0         	7              	DEL       
chr11       	3463872     	67837615    	54415670       	54549078       	10        	0         	10             	DUP       
chr11       	3463872     	67837615    	54384302       	54549176       	8         	0         	8              	DUP       
chr11       	3463872     	67837615    	54359866       	54549392       	8         	0         	8              	DUP       
chr11       	3463872     	67837615    	54756334       	54778069       	54        	0         	54             	DEL       
chr11       	3463872     	67837615    	54934922       	54937899       	51        	0         	51             	DUP       
chr11       	3463872     	67837615    	55057736       	55057935       	0         	13        	13             	DUP       
chr11       	3463872     	67837615    	55117879       	55124742       	20        	0         	20             	DEL       
chr11       	3463872     	67837615    	48726978       	55124774       	16        	0         	16             	DEL       
chr11       	3463872     	67837615    	48727094       	55125503       	22        	0         	22             	DUP       
chr11       	3463872     	67837615    	55247405       	55249031       	48        	0         	48             	DUP       
chr11       	3463872     	67837615    	58399526       	58400676       	35        	17        	52             	DEL       
chr11       	3463872     	67837615    	61099466       	61100057       	8         	0         	8              	DUP       
chr11       	3463872     	67837615    	62009734       	62010566       	21        	0         	21             	DUP       
chr11       	3463872     	67837615    	62122849       	62122922       	0         	15        	15             	DEL       
chr11       	3463872     	67837615    	62177315       	62177613       	1         	12        	13             	DEL       
chr11       	3463872     	67837615    	62366672       	62385323       	8         	0         	8              	DUP       
chr11       	3463872     	67837615    	63931437       	63934181       	28        	12        	40             	DEL       
chr11       	3463872     	67837615    	63931434       	63934472       	22        	9         	31             	DUP       
chr11       	3463872     	67837615    	64199451       	64199614       	0         	4         	4              	DEL       
chr11       	3463872     	67837615    	64500969       	64501027       	0         	10        	10             	DEL       
chr11       	3463872     	67837615    	22433304       	65396970       	14        	2         	16             	DEL       
chr11       	3463872     	67837615    	22433287       	65397332       	14        	14        	28             	DUP       
chr11       	3463872     	67837615    	65874640       	65876048       	30        	10        	40             	DEL       
chr11       	3463872     	67837615    	66944033       	66945934       	11        	0         	11             	DEL       
chr11       	3463872     	67837615    	67717014       	67739782       	5         	0         	5              	DUP       
chr11       	3463872     	67837615    	3442804        	67825328       	5         	0         	5              	DUP       
chr11       	3463872     	67837615    	3463872        	67837613       	7         	0         	7              	DUP       
chr11       	4947091     	4955633     	4946959        	4955624        	10        	0         	10             	DEL       
chr11       	5085733     	5085981     	5085744        	5085981        	0         	12        	12             	DEL       
chr11       	5602309     	5602877     	5602310        	5602877        	10        	0         	10             	DEL       
chr11       	6551832     	6552281     	6551849        	6552281        	0         	5         	5              	DEL       
chr11       	6860132     	6860777     	6860133        	6860777        	5         	0         	5              	DEL       
chr11       	7113410     	7115404     	7113546        	7115212        	35        	0         	35             	DEL       
chr11       	7188063     	7188381     	7188079        	7188381        	0         	17        	17             	DEL       
chr11       	7768759     	7770447     	7768802        	7770409        	24        	0         	24             	DEL       
chr11       	8304509     	8304648     	8304521        	8304648        	0         	8         	8              	DEL       
chr11       	9302092     	9303103     	9302132        	9303057        	34        	0         	34             	DEL       
chr11       	9504238     	9505252     	9504260        	9505278        	12        	0         	12             	DEL       
chr11       	9583771     	9583829     	9583756        	9583828        	0         	6         	6              	DEL       
chr11       	10238499    	10239766    	10238502       	10239766       	18        	9         	27             	DEL       
chr11       	10271180    	10272287    	10271199       	10272287       	18        	9         	27             	DEL       
chr11       	11358070    	11359480    	11358074       	11359480       	14        	11        	25             	DEL       
chr11       	11801439    	11803076    	11801441       	11803076       	20        	13        	33             	DEL       
chr11       	11854050    	11855011    	11854080       	11854952       	16        	0         	16             	DEL       
chr11       	12130996    	12131321    	12131011       	12131321       	0         	17        	17             	DEL       
chr11       	12922184    	12922462    	12922195       	12922462       	0         	5         	5              	DEL       
chr11       	14326763    	14327080    	14326779       	14327080       	2         	24        	26             	DEL       
chr11       	16565617    	16565753    	16565615       	16565752       	0         	24        	24             	DEL       
chr11       	16576015    	16576339    	16576031       	16576339       	0         	17        	17             	DEL       
chr11       	16883999    	16884053    	16884003       	16884053       	0         	5         	5              	DEL       
chr11       	16974621    	16975046    	16974631       	16975046       	6         	22        	28             	DEL       
chr11       	17188204    	17189668    	17188209       	17189668       	19        	1         	20             	DEL       
chr11       	20823007    	20828401    	20823011       	20828401       	16        	5         	21             	DEL       
chr11       	22433301    	65396971    	22991040       	22991091       	0         	5         	5              	DEL       
chr11       	22433301    	65396971    	24421607       	24430741       	24        	10        	34             	DEL       
chr11       	22433301    	65396971    	25047331       	25047416       	1         	5         	6              	DEL       
chr11       	22433301    	65396971    	25410957       	25411180       	1         	25        	26             	DEL       
chr11       	22433301    	65396971    	25413688       	25413754       	0         	23        	23             	DEL       
chr11       	22433301    	65396971    	26127739       	26127885       	0         	9         	9              	DEL       
chr11       	22433301    	65396971    	26383497       	26383562       	0         	6         	6              	DEL       
chr11       	22433301    	65396971    	26658408       	26658500       	1         	18        	19             	DEL       
chr11       	22433301    	65396971    	9751721        	27194661       	0         	4         	4              	DEL       
chr11       	22433301    	65396971    	27286339       	27286655       	0         	14        	14             	DEL       
chr11       	22433301    	65396971    	27635716       	27636048       	1         	13        	14             	DEL       
chr11       	22433301    	65396971    	28688409       	28688471       	0         	12        	12             	DEL       
chr11       	22433301    	65396971    	28985654       	28991341       	21        	0         	21             	DEL       
chr11       	22433301    	65396971    	29946032       	29946919       	24        	17        	41             	DEL       
chr11       	22433301    	65396971    	31130900       	31131200       	1         	10        	11             	DEL       
chr11       	22433301    	65396971    	31372229       	31376099       	11        	6         	17             	DEL       
chr11       	22433301    	65396971    	32212215       	32212604       	0         	4         	4              	DEL       
chr11       	22433301    	65396971    	32265107       	32265427       	0         	12        	12             	DEL       
chr11       	22433301    	65396971    	32367715       	32369112       	26        	0         	26             	DEL       
chr11       	22433301    	65396971    	33516141       	33516449       	1         	25        	26             	DEL       
chr11       	22433301    	65396971    	33638404       	33638469       	0         	12        	12             	DEL       
chr11       	22433301    	65396971    	34706576       	34707069       	5         	10        	15             	DEL       
chr11       	22433301    	65396971    	37427267       	37427346       	1         	5         	6              	DEL       
chr11       	22433301    	65396971    	38078052       	38078357       	4         	9         	13             	DEL       
chr11       	22433301    	65396971    	38989192       	38989255       	0         	12        	12             	DEL       
chr11       	22433301    	65396971    	39595141       	39595570       	7         	0         	7              	INV       
chr11       	22433301    	65396971    	39764358       	39764424       	2         	19        	21             	DEL       
chr11       	22433301    	65396971    	39783577       	39783899       	1         	16        	17             	DEL       
chr11       	22433301    	65396971    	40985482       	40985790       	2         	8         	10             	DEL       
chr11       	22433301    	65396971    	41341968       	41342185       	0         	6         	6              	DEL       
chr11       	22433301    	65396971    	41796648       	41797472       	39        	8         	47             	DEL       
chr11       	22433301    	65396971    	41800745       	41801057       	1         	23        	24             	DEL       
chr11       	22433301    	65396971    	42134614       	42134928       	0         	5         	5              	DEL       
chr11       	22433301    	65396971    	42442556       	42442859       	0         	21        	21             	DEL       
chr11       	22433301    	65396971    	43870294       	43870615       	1         	16        	17             	DEL       
chr11       	22433301    	65396971    	43888076       	43888349       	0         	10        	10             	DEL       
chr11       	22433301    	65396971    	45111214       	45111405       	0         	14        	14             	DEL       
chr11       	22433301    	65396971    	45408299       	45410063       	10        	6         	16             	DEL       
chr11       	22433301    	65396971    	47036037       	47042160       	53        	11        	64             	DEL       
chr11       	22433301    	65396971    	47866115       	47866642       	3         	5         	8              	DEL       
chr11       	22433301    	65396971    	48098519       	48098818       	1         	20        	21             	DEL       
chr11       	22433301    	65396971    	48579306       	48582730       	54        	24        	78             	DEL       
chr11       	22433301    	65396971    	48668466       	48668602       	2         	13        	15             	DEL       
chr11       	22433301    	65396971    	48713231       	48715366       	52        	0         	52             	DEL       
chr11       	22433301    	65396971    	48791951       	48792845       	6         	0         	6              	DEL       
chr11       	22433301    	65396971    	48833331       	48834235       	5         	0         	5              	DEL       
chr11       	22433301    	65396971    	48859231       	48860183       	43        	0         	43             	DEL       
chr11       	22433301    	65396971    	48907396       	48907703       	2         	3         	5              	DEL       
chr11       	22433301    	65396971    	48912762       	48913320       	6         	0         	6              	DEL       
chr11       	22433301    	65396971    	48923189       	48923798       	48        	0         	48             	DEL       
chr11       	22433301    	65396971    	48926938       	48927657       	16        	0         	16             	DEL       
chr11       	22433301    	65396971    	49817793       	49852373       	18        	0         	18             	DUP       
chr11       	22433301    	65396971    	49818107       	49852814       	4         	0         	4              	DEL       
chr11       	22433301    	65396971    	50482740       	50483226       	3         	1         	4              	DEL       
chr11       	22433301    	65396971    	50588416       	50589234       	8         	0         	8              	DEL       
chr11       	22433301    	65396971    	50653357       	50655059       	23        	0         	23             	DUP       
chr11       	22433301    	65396971    	50681116       	50681903       	52        	0         	52             	DEL       
chr11       	22433301    	65396971    	50764193       	50765083       	5         	0         	5              	DEL       
chr11       	22433301    	65396971    	51142865       	52308261       	16        	0         	16             	DEL       
chr11       	22433301    	65396971    	51125059       	52308266       	7         	0         	7              	DEL       
chr11       	22433301    	65396971    	51124785       	52673450       	11        	0         	11             	DUP       
chr11       	22433301    	65396971    	52308264       	52673468       	15        	0         	15             	DUP       
chr11       	22433301    	65396971    	51124788       	52730354       	22        	0         	22             	DUP       
chr11       	22433301    	65396971    	52308259       	52730447       	19        	0         	19             	DUP       
chr11       	22433301    	65396971    	52795279       	52853884       	7         	0         	7              	DUP       
chr11       	22433301    	65396971    	52560870       	53048902       	9         	0         	9              	DEL       
chr11       	22433301    	65396971    	53022578       	53074589       	4         	0         	4              	DEL       
chr11       	22433301    	65396971    	52211675       	53193821       	4         	0         	4              	DUP       
chr11       	22433301    	65396971    	52826759       	53622459       	7         	0         	7              	DEL       
chr11       	22433301    	65396971    	53559186       	53665628       	5         	0         	5              	DUP       
chr11       	22433301    	65396971    	51142481       	53716719       	33        	0         	33             	DUP       
chr11       	22433301    	65396971    	51124895       	53716747       	13        	0         	13             	DUP       
chr11       	22433301    	65396971    	53193647       	53716754       	7         	0         	7              	DUP       
chr11       	22433301    	65396971    	52308258       	53716836       	16        	0         	16             	DUP       
chr11       	22433301    	65396971    	53716340       	53742598       	9         	0         	9              	DUP       
chr11       	22433301    	65396971    	52304543       	53742372       	9         	0         	9              	DEL       
chr11       	22433301    	65396971    	53108426       	53900199       	5         	0         	5              	DEL       
chr11       	22433301    	65396971    	52304530       	54013868       	10        	0         	10             	DEL       
chr11       	22433301    	65396971    	53193620       	54014281       	5         	0         	5              	DUP       
chr11       	22433301    	65396971    	53716293       	54014299       	15        	0         	15             	DUP       
chr11       	22433301    	65396971    	52161850       	54227856       	4         	0         	4              	DUP       
chr11       	22433301    	65396971    	52211857       	54272665       	5         	0         	5              	DEL       
chr11       	22433301    	65396971    	54241776       	54311703       	4         	0         	4              	DUP       
chr11       	22433301    	65396971    	52730033       	54351091       	4         	0         	4              	DUP       
chr11       	22433301    	65396971    	53900489       	54369514       	5         	0         	5              	DEL       
chr11       	22433301    	65396971    	54345323       	54372909       	6         	0         	6              	DUP       
chr11       	22433301    	65396971    	54372653       	54376865       	9         	0         	9              	DEL       
chr11       	22433301    	65396971    	54371449       	54377382       	9         	0         	9              	DUP       
chr11       	22433301    	65396971    	54371716       	54380032       	5         	0         	5              	DEL       
chr11       	22433301    	65396971    	54346547       	54390784       	9         	0         	9              	DUP       
chr11       	22433301    	65396971    	54347409       	54403779       	5         	0         	5              	DEL       
chr11       	22433301    	65396971    	54347382       	54405634       	4         	0         	4              	DUP       
chr11       	22433301    	65396971    	54369455       	54405445       	4         	0         	4              	DEL       
chr11       	22433301    	65396971    	54347148       	54409398       	10        	0         	10             	DUP       
chr11       	22433301    	65396971    	54374245       	54409220       	4         	0         	4              	DEL       
chr11       	22433301    	65396971    	54344917       	54409518       	4         	0         	4              	DEL       
chr11       	22433301    	65396971    	54369108       	54415838       	5         	0         	5              	DUP       
chr11       	22433301    	65396971    	54345321       	54419794       	5         	0         	5              	DUP       
chr11       	22433301    	65396971    	53108468       	54423489       	7         	0         	7              	DEL       
chr11       	22433301    	65396971    	54542731       	54543587       	27        	0         	27             	DEL       
chr11       	22433301    	65396971    	54544101       	54548200       	7         	0         	7              	DEL       
chr11       	22433301    	65396971    	54415670       	54549078       	10        	0         	10             	DUP       
chr11       	22433301    	65396971    	54384302       	54549176       	8         	0         	8              	DUP       
chr11       	22433301    	65396971    	54359866       	54549392       	8         	0         	8              	DUP       
chr11       	22433301    	65396971    	54756334       	54778069       	54        	0         	54             	DEL       
chr11       	22433301    	65396971    	54934922       	54937899       	51        	0         	51             	DUP       
chr11       	22433301    	65396971    	55057736       	55057935       	0         	13        	13             	DUP       
chr11       	22433301    	65396971    	55117879       	55124742       	20        	0         	20             	DEL       
chr11       	22433301    	65396971    	48726978       	55124774       	16        	0         	16             	DEL       
chr11       	22433301    	65396971    	48727094       	55125503       	22        	0         	22             	DUP       
chr11       	22433301    	65396971    	55247405       	55249031       	48        	0         	48             	DUP       
chr11       	22433301    	65396971    	58399526       	58400676       	35        	17        	52             	DEL       
chr11       	22433301    	65396971    	61099466       	61100057       	8         	0         	8              	DUP       
chr11       	22433301    	65396971    	62009734       	62010566       	21        	0         	21             	DUP       
chr11       	22433301    	65396971    	62122849       	62122922       	0         	15        	15             	DEL       
chr11       	22433301    	65396971    	62177315       	62177613       	1         	12        	13             	DEL       
chr11       	22433301    	65396971    	62366672       	62385323       	8         	0         	8              	DUP       
chr11       	22433301    	65396971    	63931437       	63934181       	28        	12        	40             	DEL       
chr11       	22433301    	65396971    	63931434       	63934472       	22        	9         	31             	DUP       
chr11       	22433301    	65396971    	64199451       	64199614       	0         	4         	4              	DEL       
chr11       	22433301    	65396971    	64500969       	64501027       	0         	10        	10             	DEL       
chr11       	22433301    	65396971    	22433304       	65396970       	14        	2         	16             	DEL       
chr11       	22433301    	65396971    	22433287       	65397332       	14        	14        	28             	DUP       
chr11       	22433287    	65397329    	22991040       	22991091       	0         	5         	5              	DEL       
chr11       	22433287    	65397329    	24421607       	24430741       	24        	10        	34             	DEL       
chr11       	22433287    	65397329    	25047331       	25047416       	1         	5         	6              	DEL       
chr11       	22433287    	65397329    	25410957       	25411180       	1         	25        	26             	DEL       
chr11       	22433287    	65397329    	25413688       	25413754       	0         	23        	23             	DEL       
chr11       	22433287    	65397329    	26127739       	26127885       	0         	9         	9              	DEL       
chr11       	22433287    	65397329    	26383497       	26383562       	0         	6         	6              	DEL       
chr11       	22433287    	65397329    	26658408       	26658500       	1         	18        	19             	DEL       
chr11       	22433287    	65397329    	9751721        	27194661       	0         	4         	4              	DEL       
chr11       	22433287    	65397329    	27286339       	27286655       	0         	14        	14             	DEL       
chr11       	22433287    	65397329    	27635716       	27636048       	1         	13        	14             	DEL       
chr11       	22433287    	65397329    	28688409       	28688471       	0         	12        	12             	DEL       
chr11       	22433287    	65397329    	28985654       	28991341       	21        	0         	21             	DEL       
chr11       	22433287    	65397329    	29946032       	29946919       	24        	17        	41             	DEL       
chr11       	22433287    	65397329    	31130900       	31131200       	1         	10        	11             	DEL       
chr11       	22433287    	65397329    	31372229       	31376099       	11        	6         	17             	DEL       
chr11       	22433287    	65397329    	32212215       	32212604       	0         	4         	4              	DEL       
chr11       	22433287    	65397329    	32265107       	32265427       	0         	12        	12             	DEL       
chr11       	22433287    	65397329    	32367715       	32369112       	26        	0         	26             	DEL       
chr11       	22433287    	65397329    	33516141       	33516449       	1         	25        	26             	DEL       
chr11       	22433287    	65397329    	33638404       	33638469       	0         	12        	12             	DEL       
chr11       	22433287    	65397329    	34706576       	34707069       	5         	10        	15             	DEL       
chr11       	22433287    	65397329    	37427267       	37427346       	1         	5         	6              	DEL       
chr11       	22433287    	65397329    	38078052       	38078357       	4         	9         	13             	DEL       
chr11       	22433287    	65397329    	38989192       	38989255       	0         	12        	12             	DEL       
chr11       	22433287    	65397329    	39595141       	39595570       	7         	0         	7              	INV       
chr11       	22433287    	65397329    	39764358       	39764424       	2         	19        	21             	DEL       
chr11       	22433287    	65397329    	39783577       	39783899       	1         	16        	17             	DEL       
chr11       	22433287    	65397329    	40985482       	40985790       	2         	8         	10             	DEL       
chr11       	22433287    	65397329    	41341968       	41342185       	0         	6         	6              	DEL       
chr11       	22433287    	65397329    	41796648       	41797472       	39        	8         	47             	DEL       
chr11       	22433287    	65397329    	41800745       	41801057       	1         	23        	24             	DEL       
chr11       	22433287    	65397329    	42134614       	42134928       	0         	5         	5              	DEL       
chr11       	22433287    	65397329    	42442556       	42442859       	0         	21        	21             	DEL       
chr11       	22433287    	65397329    	43870294       	43870615       	1         	16        	17             	DEL       
chr11       	22433287    	65397329    	43888076       	43888349       	0         	10        	10             	DEL       
chr11       	22433287    	65397329    	45111214       	45111405       	0         	14        	14             	DEL       
chr11       	22433287    	65397329    	45408299       	45410063       	10        	6         	16             	DEL       
chr11       	22433287    	65397329    	47036037       	47042160       	53        	11        	64             	DEL       
chr11       	22433287    	65397329    	47866115       	47866642       	3         	5         	8              	DEL       
chr11       	22433287    	65397329    	48098519       	48098818       	1         	20        	21             	DEL       
chr11       	22433287    	65397329    	48579306       	48582730       	54        	24        	78             	DEL       
chr11       	22433287    	65397329    	48668466       	48668602       	2         	13        	15             	DEL       
chr11       	22433287    	65397329    	48713231       	48715366       	52        	0         	52             	DEL       
chr11       	22433287    	65397329    	48791951       	48792845       	6         	0         	6              	DEL       
chr11       	22433287    	65397329    	48833331       	48834235       	5         	0         	5              	DEL       
chr11       	22433287    	65397329    	48859231       	48860183       	43        	0         	43             	DEL       
chr11       	22433287    	65397329    	48907396       	48907703       	2         	3         	5              	DEL       
chr11       	22433287    	65397329    	48912762       	48913320       	6         	0         	6              	DEL       
chr11       	22433287    	65397329    	48923189       	48923798       	48        	0         	48             	DEL       
chr11       	22433287    	65397329    	48926938       	48927657       	16        	0         	16             	DEL       
chr11       	22433287    	65397329    	49817793       	49852373       	18        	0         	18             	DUP       
chr11       	22433287    	65397329    	49818107       	49852814       	4         	0         	4              	DEL       
chr11       	22433287    	65397329    	50482740       	50483226       	3         	1         	4              	DEL       
chr11       	22433287    	65397329    	50588416       	50589234       	8         	0         	8              	DEL       
chr11       	22433287    	65397329    	50653357       	50655059       	23        	0         	23             	DUP       
chr11       	22433287    	65397329    	50681116       	50681903       	52        	0         	52             	DEL       
chr11       	22433287    	65397329    	50764193       	50765083       	5         	0         	5              	DEL       
chr11       	22433287    	65397329    	51142865       	52308261       	16        	0         	16             	DEL       
chr11       	22433287    	65397329    	51125059       	52308266       	7         	0         	7              	DEL       
chr11       	22433287    	65397329    	51124785       	52673450       	11        	0         	11             	DUP       
chr11       	22433287    	65397329    	52308264       	52673468       	15        	0         	15             	DUP       
chr11       	22433287    	65397329    	51124788       	52730354       	22        	0         	22             	DUP       
chr11       	22433287    	65397329    	52308259       	52730447       	19        	0         	19             	DUP       
chr11       	22433287    	65397329    	52795279       	52853884       	7         	0         	7              	DUP       
chr11       	22433287    	65397329    	52560870       	53048902       	9         	0         	9              	DEL       
chr11       	22433287    	65397329    	53022578       	53074589       	4         	0         	4              	DEL       
chr11       	22433287    	65397329    	52211675       	53193821       	4         	0         	4              	DUP       
chr11       	22433287    	65397329    	52826759       	53622459       	7         	0         	7              	DEL       
chr11       	22433287    	65397329    	53559186       	53665628       	5         	0         	5              	DUP       
chr11       	22433287    	65397329    	51142481       	53716719       	33        	0         	33             	DUP       
chr11       	22433287    	65397329    	51124895       	53716747       	13        	0         	13             	DUP       
chr11       	22433287    	65397329    	53193647       	53716754       	7         	0         	7              	DUP       
chr11       	22433287    	65397329    	52308258       	53716836       	16        	0         	16             	DUP       
chr11       	22433287    	65397329    	53716340       	53742598       	9         	0         	9              	DUP       
chr11       	22433287    	65397329    	52304543       	53742372       	9         	0         	9              	DEL       
chr11       	22433287    	65397329    	53108426       	53900199       	5         	0         	5              	DEL       
chr11       	22433287    	65397329    	52304530       	54013868       	10        	0         	10             	DEL       
chr11       	22433287    	65397329    	53193620       	54014281       	5         	0         	5              	DUP       
chr11       	22433287    	65397329    	53716293       	54014299       	15        	0         	15             	DUP       
chr11       	22433287    	65397329    	52161850       	54227856       	4         	0         	4              	DUP       
chr11       	22433287    	65397329    	52211857       	54272665       	5         	0         	5              	DEL       
chr11       	22433287    	65397329    	54241776       	54311703       	4         	0         	4              	DUP       
chr11       	22433287    	65397329    	52730033       	54351091       	4         	0         	4              	DUP       
chr11       	22433287    	65397329    	53900489       	54369514       	5         	0         	5              	DEL       
chr11       	22433287    	65397329    	54345323       	54372909       	6         	0         	6              	DUP       
chr11       	22433287    	65397329    	54372653       	54376865       	9         	0         	9              	DEL       
chr11       	22433287    	65397329    	54371449       	54377382       	9         	0         	9              	DUP       
chr11       	22433287    	65397329    	54371716       	54380032       	5         	0         	5              	DEL       
chr11       	22433287    	65397329    	54346547       	54390784       	9         	0         	9              	DUP       
chr11       	22433287    	65397329    	54347409       	54403779       	5         	0         	5              	DEL       
chr11       	22433287    	65397329    	54347382       	54405634       	4         	0         	4              	DUP       
chr11       	22433287    	65397329    	54369455       	54405445       	4         	0         	4              	DEL       
chr11       	22433287    	65397329    	54347148       	54409398       	10        	0         	10             	DUP       
chr11       	22433287    	65397329    	54374245       	54409220       	4         	0         	4              	DEL       
chr11       	22433287    	65397329    	54344917       	54409518       	4         	0         	4              	DEL       
chr11       	22433287    	65397329    	54369108       	54415838       	5         	0         	5              	DUP       
chr11       	22433287    	65397329    	54345321       	54419794       	5         	0         	5              	DUP       
chr11       	22433287    	65397329    	53108468       	54423489       	7         	0         	7              	DEL       
chr11       	22433287    	65397329    	54542731       	54543587       	27        	0         	27             	DEL       
chr11       	22433287    	65397329    	54544101       	54548200       	7         	0         	7              	DEL       
chr11       	22433287    	65397329    	54415670       	54549078       	10        	0         	10             	DUP       
chr11       	22433287    	65397329    	54384302       	54549176       	8         	0         	8              	DUP       
chr11       	22433287    	65397329    	54359866       	54549392       	8         	0         	8              	DUP       
chr11       	22433287    	65397329    	54756334       	54778069       	54        	0         	54             	DEL       
chr11       	22433287    	65397329    	54934922       	54937899       	51        	0         	51             	DUP       
chr11       	22433287    	65397329    	55057736       	55057935       	0         	13        	13             	DUP       
chr11       	22433287    	65397329    	55117879       	55124742       	20        	0         	20             	DEL       
chr11       	22433287    	65397329    	48726978       	55124774       	16        	0         	16             	DEL       
chr11       	22433287    	65397329    	48727094       	55125503       	22        	0         	22             	DUP       
chr11       	22433287    	65397329    	55247405       	55249031       	48        	0         	48             	DUP       
chr11       	22433287    	65397329    	58399526       	58400676       	35        	17        	52             	DEL       
chr11       	22433287    	65397329    	61099466       	61100057       	8         	0         	8              	DUP       
chr11       	22433287    	65397329    	62009734       	62010566       	21        	0         	21             	DUP       
chr11       	22433287    	65397329    	62122849       	62122922       	0         	15        	15             	DEL       
chr11       	22433287    	65397329    	62177315       	62177613       	1         	12        	13             	DEL       
chr11       	22433287    	65397329    	62366672       	62385323       	8         	0         	8              	DUP       
chr11       	22433287    	65397329    	63931437       	63934181       	28        	12        	40             	DEL       
chr11       	22433287    	65397329    	63931434       	63934472       	22        	9         	31             	DUP       
chr11       	22433287    	65397329    	64199451       	64199614       	0         	4         	4              	DEL       
chr11       	22433287    	65397329    	64500969       	64501027       	0         	10        	10             	DEL       
chr11       	22433287    	65397329    	22433304       	65396970       	14        	2         	16             	DEL       
chr11       	22433287    	65397329    	22433287       	65397332       	14        	14        	28             	DUP       
chr11       	22991037    	22991091    	22991040       	22991091       	0         	5         	5              	DEL       
chr11       	24421606    	24430741    	24421607       	24430741       	24        	10        	34             	DEL       
chr11       	25047310    	25047416    	25047331       	25047416       	1         	5         	6              	DEL       
chr11       	25410956    	25411180    	25410957       	25411180       	1         	25        	26             	DEL       
chr11       	25413676    	25413754    	25413688       	25413754       	0         	23        	23             	DEL       
chr11       	26127738    	26127885    	26127739       	26127885       	0         	9         	9              	DEL       
chr11       	26383496    	26383562    	26383497       	26383562       	0         	6         	6              	DEL       
chr11       	26658400    	26658500    	26658408       	26658500       	1         	18        	19             	DEL       
chr11       	27286321    	27286655    	27286339       	27286655       	0         	14        	14             	DEL       
chr11       	27635715    	27636048    	27635716       	27636048       	1         	13        	14             	DEL       
chr11       	28688394    	28688472    	28688409       	28688471       	0         	12        	12             	DEL       
chr11       	28985645    	28991254    	28985654       	28991341       	21        	0         	21             	DEL       
chr11       	29946030    	29946919    	29946032       	29946919       	24        	17        	41             	DEL       
chr11       	31130883    	31131200    	31130900       	31131200       	1         	10        	11             	DEL       
chr11       	31372225    	31376099    	31372229       	31376099       	11        	6         	17             	DEL       
chr11       	32212214    	32212604    	32212215       	32212604       	0         	4         	4              	DEL       
chr11       	32265093    	32265428    	32265107       	32265427       	0         	12        	12             	DEL       
chr11       	32367715    	32369112    	32367715       	32369112       	26        	0         	26             	DEL       
chr11       	33516125    	33516449    	33516141       	33516449       	1         	25        	26             	DEL       
chr11       	33638403    	33638465    	33638404       	33638469       	0         	12        	12             	DEL       
chr11       	34706573    	34707069    	34706576       	34707069       	5         	10        	15             	DEL       
chr11       	37427253    	37427347    	37427267       	37427346       	1         	5         	6              	DEL       
chr11       	38078025    	38078357    	38078052       	38078357       	4         	9         	13             	DEL       
chr11       	38989188    	38989255    	38989192       	38989255       	0         	12        	12             	DEL       
chr11       	39595140    	39595570    	39595141       	39595570       	7         	0         	7              	INV       
chr11       	39764354    	39764424    	39764358       	39764424       	2         	19        	21             	DEL       
chr11       	39783563    	39783899    	39783577       	39783899       	1         	16        	17             	DEL       
chr11       	40985467    	40985790    	40985482       	40985790       	2         	8         	10             	DEL       
chr11       	41341966    	41342185    	41341968       	41342185       	0         	6         	6              	DEL       
chr11       	41796645    	41797472    	41796648       	41797472       	39        	8         	47             	DEL       
chr11       	41800729    	41801057    	41800745       	41801057       	1         	23        	24             	DEL       
chr11       	42134598    	42134928    	42134614       	42134928       	0         	5         	5              	DEL       
chr11       	42442547    	42442859    	42442556       	42442859       	0         	21        	21             	DEL       
chr11       	43870278    	43870615    	43870294       	43870615       	1         	16        	17             	DEL       
chr11       	43888042    	43888349    	43888076       	43888349       	0         	10        	10             	DEL       
chr11       	45111211    	45111405    	45111214       	45111405       	0         	14        	14             	DEL       
chr11       	45408295    	45410063    	45408299       	45410063       	10        	6         	16             	DEL       
chr11       	47036036    	47042155    	47036037       	47042160       	53        	11        	64             	DEL       
chr11       	47866114    	47866642    	47866115       	47866642       	3         	5         	8              	DEL       
chr11       	48098508    	48098818    	48098519       	48098818       	1         	20        	21             	DEL       
chr11       	48579303    	48582730    	48579306       	48582730       	54        	24        	78             	DEL       
chr11       	48668449    	48668619    	48668466       	48668602       	2         	13        	15             	DEL       
chr11       	48713179    	48715396    	48713231       	48715366       	52        	0         	52             	DEL       
chr11       	48726842    	55124799    	48791951       	48792845       	6         	0         	6              	DEL       
chr11       	48726842    	55124799    	48833331       	48834235       	5         	0         	5              	DEL       
chr11       	48726842    	55124799    	48859231       	48860183       	43        	0         	43             	DEL       
chr11       	48726842    	55124799    	48907396       	48907703       	2         	3         	5              	DEL       
chr11       	48726842    	55124799    	48912762       	48913320       	6         	0         	6              	DEL       
chr11       	48726842    	55124799    	48923189       	48923798       	48        	0         	48             	DEL       
chr11       	48726842    	55124799    	48926938       	48927657       	16        	0         	16             	DEL       
chr11       	48726842    	55124799    	49817793       	49852373       	18        	0         	18             	DUP       
chr11       	48726842    	55124799    	49818107       	49852814       	4         	0         	4              	DEL       
chr11       	48726842    	55124799    	50482740       	50483226       	3         	1         	4              	DEL       
chr11       	48726842    	55124799    	50588416       	50589234       	8         	0         	8              	DEL       
chr11       	48726842    	55124799    	50653357       	50655059       	23        	0         	23             	DUP       
chr11       	48726842    	55124799    	50681116       	50681903       	52        	0         	52             	DEL       
chr11       	48726842    	55124799    	50764193       	50765083       	5         	0         	5              	DEL       
chr11       	48726842    	55124799    	51142865       	52308261       	16        	0         	16             	DEL       
chr11       	48726842    	55124799    	51125059       	52308266       	7         	0         	7              	DEL       
chr11       	48726842    	55124799    	51124785       	52673450       	11        	0         	11             	DUP       
chr11       	48726842    	55124799    	52308264       	52673468       	15        	0         	15             	DUP       
chr11       	48726842    	55124799    	51124788       	52730354       	22        	0         	22             	DUP       
chr11       	48726842    	55124799    	52308259       	52730447       	19        	0         	19             	DUP       
chr11       	48726842    	55124799    	52795279       	52853884       	7         	0         	7              	DUP       
chr11       	48726842    	55124799    	52560870       	53048902       	9         	0         	9              	DEL       
chr11       	48726842    	55124799    	53022578       	53074589       	4         	0         	4              	DEL       
chr11       	48726842    	55124799    	52211675       	53193821       	4         	0         	4              	DUP       
chr11       	48726842    	55124799    	52826759       	53622459       	7         	0         	7              	DEL       
chr11       	48726842    	55124799    	53559186       	53665628       	5         	0         	5              	DUP       
chr11       	48726842    	55124799    	51142481       	53716719       	33        	0         	33             	DUP       
chr11       	48726842    	55124799    	51124895       	53716747       	13        	0         	13             	DUP       
chr11       	48726842    	55124799    	53193647       	53716754       	7         	0         	7              	DUP       
chr11       	48726842    	55124799    	52308258       	53716836       	16        	0         	16             	DUP       
chr11       	48726842    	55124799    	53716340       	53742598       	9         	0         	9              	DUP       
chr11       	48726842    	55124799    	52304543       	53742372       	9         	0         	9              	DEL       
chr11       	48726842    	55124799    	53108426       	53900199       	5         	0         	5              	DEL       
chr11       	48726842    	55124799    	52304530       	54013868       	10        	0         	10             	DEL       
chr11       	48726842    	55124799    	53193620       	54014281       	5         	0         	5              	DUP       
chr11       	48726842    	55124799    	53716293       	54014299       	15        	0         	15             	DUP       
chr11       	48726842    	55124799    	52161850       	54227856       	4         	0         	4              	DUP       
chr11       	48726842    	55124799    	52211857       	54272665       	5         	0         	5              	DEL       
chr11       	48726842    	55124799    	54241776       	54311703       	4         	0         	4              	DUP       
chr11       	48726842    	55124799    	52730033       	54351091       	4         	0         	4              	DUP       
chr11       	48726842    	55124799    	53900489       	54369514       	5         	0         	5              	DEL       
chr11       	48726842    	55124799    	54345323       	54372909       	6         	0         	6              	DUP       
chr11       	48726842    	55124799    	54372653       	54376865       	9         	0         	9              	DEL       
chr11       	48726842    	55124799    	54371449       	54377382       	9         	0         	9              	DUP       
chr11       	48726842    	55124799    	54371716       	54380032       	5         	0         	5              	DEL       
chr11       	48726842    	55124799    	54346547       	54390784       	9         	0         	9              	DUP       
chr11       	48726842    	55124799    	54347409       	54403779       	5         	0         	5              	DEL       
chr11       	48726842    	55124799    	54347382       	54405634       	4         	0         	4              	DUP       
chr11       	48726842    	55124799    	54369455       	54405445       	4         	0         	4              	DEL       
chr11       	48726842    	55124799    	54347148       	54409398       	10        	0         	10             	DUP       
chr11       	48726842    	55124799    	54374245       	54409220       	4         	0         	4              	DEL       
chr11       	48726842    	55124799    	54344917       	54409518       	4         	0         	4              	DEL       
chr11       	48726842    	55124799    	54369108       	54415838       	5         	0         	5              	DUP       
chr11       	48726842    	55124799    	54345321       	54419794       	5         	0         	5              	DUP       
chr11       	48726842    	55124799    	53108468       	54423489       	7         	0         	7              	DEL       
chr11       	48726842    	55124799    	54542731       	54543587       	27        	0         	27             	DEL       
chr11       	48726842    	55124799    	54544101       	54548200       	7         	0         	7              	DEL       
chr11       	48726842    	55124799    	54415670       	54549078       	10        	0         	10             	DUP       
chr11       	48726842    	55124799    	54384302       	54549176       	8         	0         	8              	DUP       
chr11       	48726842    	55124799    	54359866       	54549392       	8         	0         	8              	DUP       
chr11       	48726842    	55124799    	54756334       	54778069       	54        	0         	54             	DEL       
chr11       	48726842    	55124799    	54934922       	54937899       	51        	0         	51             	DUP       
chr11       	48726842    	55124799    	55057736       	55057935       	0         	13        	13             	DUP       
chr11       	48726842    	55124799    	55117879       	55124742       	20        	0         	20             	DEL       
chr11       	48726842    	55124799    	48726978       	55124774       	16        	0         	16             	DEL       
chr11       	48726842    	55124799    	48727094       	55125503       	22        	0         	22             	DUP       
chr11       	48727391    	55125498    	48791951       	48792845       	6         	0         	6              	DEL       
chr11       	48727391    	55125498    	48833331       	48834235       	5         	0         	5              	DEL       
chr11       	48727391    	55125498    	48859231       	48860183       	43        	0         	43             	DEL       
chr11       	48727391    	55125498    	48907396       	48907703       	2         	3         	5              	DEL       
chr11       	48727391    	55125498    	48912762       	48913320       	6         	0         	6              	DEL       
chr11       	48727391    	55125498    	48923189       	48923798       	48        	0         	48             	DEL       
chr11       	48727391    	55125498    	48926938       	48927657       	16        	0         	16             	DEL       
chr11       	48727391    	55125498    	49817793       	49852373       	18        	0         	18             	DUP       
chr11       	48727391    	55125498    	49818107       	49852814       	4         	0         	4              	DEL       
chr11       	48727391    	55125498    	50482740       	50483226       	3         	1         	4              	DEL       
chr11       	48727391    	55125498    	50588416       	50589234       	8         	0         	8              	DEL       
chr11       	48727391    	55125498    	50653357       	50655059       	23        	0         	23             	DUP       
chr11       	48727391    	55125498    	50681116       	50681903       	52        	0         	52             	DEL       
chr11       	48727391    	55125498    	50764193       	50765083       	5         	0         	5              	DEL       
chr11       	48727391    	55125498    	51142865       	52308261       	16        	0         	16             	DEL       
chr11       	48727391    	55125498    	51125059       	52308266       	7         	0         	7              	DEL       
chr11       	48727391    	55125498    	51124785       	52673450       	11        	0         	11             	DUP       
chr11       	48727391    	55125498    	52308264       	52673468       	15        	0         	15             	DUP       
chr11       	48727391    	55125498    	51124788       	52730354       	22        	0         	22             	DUP       
chr11       	48727391    	55125498    	52308259       	52730447       	19        	0         	19             	DUP       
chr11       	48727391    	55125498    	52795279       	52853884       	7         	0         	7              	DUP       
chr11       	48727391    	55125498    	52560870       	53048902       	9         	0         	9              	DEL       
chr11       	48727391    	55125498    	53022578       	53074589       	4         	0         	4              	DEL       
chr11       	48727391    	55125498    	52211675       	53193821       	4         	0         	4              	DUP       
chr11       	48727391    	55125498    	52826759       	53622459       	7         	0         	7              	DEL       
chr11       	48727391    	55125498    	53559186       	53665628       	5         	0         	5              	DUP       
chr11       	48727391    	55125498    	51142481       	53716719       	33        	0         	33             	DUP       
chr11       	48727391    	55125498    	51124895       	53716747       	13        	0         	13             	DUP       
chr11       	48727391    	55125498    	53193647       	53716754       	7         	0         	7              	DUP       
chr11       	48727391    	55125498    	52308258       	53716836       	16        	0         	16             	DUP       
chr11       	48727391    	55125498    	53716340       	53742598       	9         	0         	9              	DUP       
chr11       	48727391    	55125498    	52304543       	53742372       	9         	0         	9              	DEL       
chr11       	48727391    	55125498    	53108426       	53900199       	5         	0         	5              	DEL       
chr11       	48727391    	55125498    	52304530       	54013868       	10        	0         	10             	DEL       
chr11       	48727391    	55125498    	53193620       	54014281       	5         	0         	5              	DUP       
chr11       	48727391    	55125498    	53716293       	54014299       	15        	0         	15             	DUP       
chr11       	48727391    	55125498    	52161850       	54227856       	4         	0         	4              	DUP       
chr11       	48727391    	55125498    	52211857       	54272665       	5         	0         	5              	DEL       
chr11       	48727391    	55125498    	54241776       	54311703       	4         	0         	4              	DUP       
chr11       	48727391    	55125498    	52730033       	54351091       	4         	0         	4              	DUP       
chr11       	48727391    	55125498    	53900489       	54369514       	5         	0         	5              	DEL       
chr11       	48727391    	55125498    	54345323       	54372909       	6         	0         	6              	DUP       
chr11       	48727391    	55125498    	54372653       	54376865       	9         	0         	9              	DEL       
chr11       	48727391    	55125498    	54371449       	54377382       	9         	0         	9              	DUP       
chr11       	48727391    	55125498    	54371716       	54380032       	5         	0         	5              	DEL       
chr11       	48727391    	55125498    	54346547       	54390784       	9         	0         	9              	DUP       
chr11       	48727391    	55125498    	54347409       	54403779       	5         	0         	5              	DEL       
chr11       	48727391    	55125498    	54347382       	54405634       	4         	0         	4              	DUP       
chr11       	48727391    	55125498    	54369455       	54405445       	4         	0         	4              	DEL       
chr11       	48727391    	55125498    	54347148       	54409398       	10        	0         	10             	DUP       
chr11       	48727391    	55125498    	54374245       	54409220       	4         	0         	4              	DEL       
chr11       	48727391    	55125498    	54344917       	54409518       	4         	0         	4              	DEL       
chr11       	48727391    	55125498    	54369108       	54415838       	5         	0         	5              	DUP       
chr11       	48727391    	55125498    	54345321       	54419794       	5         	0         	5              	DUP       
chr11       	48727391    	55125498    	53108468       	54423489       	7         	0         	7              	DEL       
chr11       	48727391    	55125498    	54542731       	54543587       	27        	0         	27             	DEL       
chr11       	48727391    	55125498    	54544101       	54548200       	7         	0         	7              	DEL       
chr11       	48727391    	55125498    	54415670       	54549078       	10        	0         	10             	DUP       
chr11       	48727391    	55125498    	54384302       	54549176       	8         	0         	8              	DUP       
chr11       	48727391    	55125498    	54359866       	54549392       	8         	0         	8              	DUP       
chr11       	48727391    	55125498    	54756334       	54778069       	54        	0         	54             	DEL       
chr11       	48727391    	55125498    	54934922       	54937899       	51        	0         	51             	DUP       
chr11       	48727391    	55125498    	55057736       	55057935       	0         	13        	13             	DUP       
chr11       	48727391    	55125498    	55117879       	55124742       	20        	0         	20             	DEL       
chr11       	48727391    	55125498    	48726978       	55124774       	16        	0         	16             	DEL       
chr11       	48727391    	55125498    	48727094       	55125503       	22        	0         	22             	DUP       
chr11       	48859162    	48860189    	48859231       	48860183       	43        	0         	43             	DEL       
chr11       	48907391    	48907703    	48907396       	48907703       	2         	3         	5              	DEL       
chr11       	48912761    	48913320    	48912762       	48913320       	6         	0         	6              	DEL       
chr11       	48923188    	48923798    	48923189       	48923798       	48        	0         	48             	DEL       
chr11       	48927158    	48927670    	48926938       	48927657       	16        	0         	16             	DEL       
chr11       	49817659    	49852429    	49817793       	49852373       	18        	0         	18             	DUP       
chr11       	49817659    	49852429    	49818107       	49852814       	4         	0         	4              	DEL       
chr11       	50588415    	50589234    	50588416       	50589234       	8         	0         	8              	DEL       
chr11       	50653374    	50655011    	50653357       	50655059       	23        	0         	23             	DUP       
chr11       	50681045    	50681903    	50681116       	50681903       	52        	0         	52             	DEL       
chr11       	51125058    	52308266    	51142865       	52308261       	16        	0         	16             	DEL       
chr11       	51125058    	52308266    	51125059       	52308266       	7         	0         	7              	DEL       
chr11       	51125058    	52308266    	52308264       	52673468       	15        	0         	15             	DUP       
chr11       	51125058    	52308266    	52308259       	52730447       	19        	0         	19             	DUP       
chr11       	51125058    	52308266    	52211675       	53193821       	4         	0         	4              	DUP       
chr11       	51125058    	52308266    	51142481       	53716719       	33        	0         	33             	DUP       
chr11       	51125058    	52308266    	52308258       	53716836       	16        	0         	16             	DUP       
chr11       	51125058    	52308266    	52304543       	53742372       	9         	0         	9              	DEL       
chr11       	51125058    	52308266    	52304530       	54013868       	10        	0         	10             	DEL       
chr11       	51125058    	52308266    	52161850       	54227856       	4         	0         	4              	DUP       
chr11       	51125058    	52308266    	52211857       	54272665       	5         	0         	5              	DEL       
chr11       	51124784    	52673450    	51142865       	52308261       	16        	0         	16             	DEL       
chr11       	51124784    	52673450    	51125059       	52308266       	7         	0         	7              	DEL       
chr11       	51124784    	52673450    	51124785       	52673450       	11        	0         	11             	DUP       
chr11       	51124784    	52673450    	52308264       	52673468       	15        	0         	15             	DUP       
chr11       	51124784    	52673450    	51124788       	52730354       	22        	0         	22             	DUP       
chr11       	51124784    	52673450    	52308259       	52730447       	19        	0         	19             	DUP       
chr11       	51124784    	52673450    	52560870       	53048902       	9         	0         	9              	DEL       
chr11       	51124784    	52673450    	52211675       	53193821       	4         	0         	4              	DUP       
chr11       	51124784    	52673450    	51142481       	53716719       	33        	0         	33             	DUP       
chr11       	51124784    	52673450    	51124895       	53716747       	13        	0         	13             	DUP       
chr11       	51124784    	52673450    	52308258       	53716836       	16        	0         	16             	DUP       
chr11       	51124784    	52673450    	52304543       	53742372       	9         	0         	9              	DEL       
chr11       	51124784    	52673450    	52304530       	54013868       	10        	0         	10             	DEL       
chr11       	51124784    	52673450    	52161850       	54227856       	4         	0         	4              	DUP       
chr11       	51124784    	52673450    	52211857       	54272665       	5         	0         	5              	DEL       
chr11       	51124787    	52730354    	51142865       	52308261       	16        	0         	16             	DEL       
chr11       	51124787    	52730354    	51125059       	52308266       	7         	0         	7              	DEL       
chr11       	51124787    	52730354    	51124785       	52673450       	11        	0         	11             	DUP       
chr11       	51124787    	52730354    	52308264       	52673468       	15        	0         	15             	DUP       
chr11       	51124787    	52730354    	51124788       	52730354       	22        	0         	22             	DUP       
chr11       	51124787    	52730354    	52308259       	52730447       	19        	0         	19             	DUP       
chr11       	51124787    	52730354    	52560870       	53048902       	9         	0         	9              	DEL       
chr11       	51124787    	52730354    	52211675       	53193821       	4         	0         	4              	DUP       
chr11       	51124787    	52730354    	51142481       	53716719       	33        	0         	33             	DUP       
chr11       	51124787    	52730354    	51124895       	53716747       	13        	0         	13             	DUP       
chr11       	51124787    	52730354    	52308258       	53716836       	16        	0         	16             	DUP       
chr11       	51124787    	52730354    	52304543       	53742372       	9         	0         	9              	DEL       
chr11       	51124787    	52730354    	52304530       	54013868       	10        	0         	10             	DEL       
chr11       	51124787    	52730354    	52161850       	54227856       	4         	0         	4              	DUP       
chr11       	51124787    	52730354    	52211857       	54272665       	5         	0         	5              	DEL       
chr11       	51124787    	52730354    	52730033       	54351091       	4         	0         	4              	DUP       
chr11       	51124894    	53716747    	51142865       	52308261       	16        	0         	16             	DEL       
chr11       	51124894    	53716747    	51125059       	52308266       	7         	0         	7              	DEL       
chr11       	51124894    	53716747    	51124785       	52673450       	11        	0         	11             	DUP       
chr11       	51124894    	53716747    	52308264       	52673468       	15        	0         	15             	DUP       
chr11       	51124894    	53716747    	51124788       	52730354       	22        	0         	22             	DUP       
chr11       	51124894    	53716747    	52308259       	52730447       	19        	0         	19             	DUP       
chr11       	51124894    	53716747    	52795279       	52853884       	7         	0         	7              	DUP       
chr11       	51124894    	53716747    	52560870       	53048902       	9         	0         	9              	DEL       
chr11       	51124894    	53716747    	53022578       	53074589       	4         	0         	4              	DEL       
chr11       	51124894    	53716747    	52211675       	53193821       	4         	0         	4              	DUP       
chr11       	51124894    	53716747    	52826759       	53622459       	7         	0         	7              	DEL       
chr11       	51124894    	53716747    	53559186       	53665628       	5         	0         	5              	DUP       
chr11       	51124894    	53716747    	51142481       	53716719       	33        	0         	33             	DUP       
chr11       	51124894    	53716747    	51124895       	53716747       	13        	0         	13             	DUP       
chr11       	51124894    	53716747    	53193647       	53716754       	7         	0         	7              	DUP       
chr11       	51124894    	53716747    	52308258       	53716836       	16        	0         	16             	DUP       
chr11       	51124894    	53716747    	53716340       	53742598       	9         	0         	9              	DUP       
chr11       	51124894    	53716747    	52304543       	53742372       	9         	0         	9              	DEL       
chr11       	51124894    	53716747    	53108426       	53900199       	5         	0         	5              	DEL       
chr11       	51124894    	53716747    	52304530       	54013868       	10        	0         	10             	DEL       
chr11       	51124894    	53716747    	53193620       	54014281       	5         	0         	5              	DUP       
chr11       	51124894    	53716747    	53716293       	54014299       	15        	0         	15             	DUP       
chr11       	51124894    	53716747    	52161850       	54227856       	4         	0         	4              	DUP       
chr11       	51124894    	53716747    	52211857       	54272665       	5         	0         	5              	DEL       
chr11       	51124894    	53716747    	52730033       	54351091       	4         	0         	4              	DUP       
chr11       	51124894    	53716747    	53108468       	54423489       	7         	0         	7              	DEL       
chr11       	51142864    	52308261    	51142865       	52308261       	16        	0         	16             	DEL       
chr11       	51142864    	52308261    	51125059       	52308266       	7         	0         	7              	DEL       
chr11       	51142864    	52308261    	52308264       	52673468       	15        	0         	15             	DUP       
chr11       	51142864    	52308261    	52308259       	52730447       	19        	0         	19             	DUP       
chr11       	51142864    	52308261    	52211675       	53193821       	4         	0         	4              	DUP       
chr11       	51142864    	52308261    	52308258       	53716836       	16        	0         	16             	DUP       
chr11       	51142864    	52308261    	52304543       	53742372       	9         	0         	9              	DEL       
chr11       	51142864    	52308261    	52304530       	54013868       	10        	0         	10             	DEL       
chr11       	51142864    	52308261    	52161850       	54227856       	4         	0         	4              	DUP       
chr11       	51142864    	52308261    	52211857       	54272665       	5         	0         	5              	DEL       
chr11       	51142480    	53716719    	51142865       	52308261       	16        	0         	16             	DEL       
chr11       	51142480    	53716719    	51125059       	52308266       	7         	0         	7              	DEL       
chr11       	51142480    	53716719    	51124785       	52673450       	11        	0         	11             	DUP       
chr11       	51142480    	53716719    	52308264       	52673468       	15        	0         	15             	DUP       
chr11       	51142480    	53716719    	51124788       	52730354       	22        	0         	22             	DUP       
chr11       	51142480    	53716719    	52308259       	52730447       	19        	0         	19             	DUP       
chr11       	51142480    	53716719    	52795279       	52853884       	7         	0         	7              	DUP       
chr11       	51142480    	53716719    	52560870       	53048902       	9         	0         	9              	DEL       
chr11       	51142480    	53716719    	53022578       	53074589       	4         	0         	4              	DEL       
chr11       	51142480    	53716719    	52211675       	53193821       	4         	0         	4              	DUP       
chr11       	51142480    	53716719    	52826759       	53622459       	7         	0         	7              	DEL       
chr11       	51142480    	53716719    	53559186       	53665628       	5         	0         	5              	DUP       
chr11       	51142480    	53716719    	51142481       	53716719       	33        	0         	33             	DUP       
chr11       	51142480    	53716719    	51124895       	53716747       	13        	0         	13             	DUP       
chr11       	51142480    	53716719    	53193647       	53716754       	7         	0         	7              	DUP       
chr11       	51142480    	53716719    	52308258       	53716836       	16        	0         	16             	DUP       
chr11       	51142480    	53716719    	53716340       	53742598       	9         	0         	9              	DUP       
chr11       	51142480    	53716719    	52304543       	53742372       	9         	0         	9              	DEL       
chr11       	51142480    	53716719    	53108426       	53900199       	5         	0         	5              	DEL       
chr11       	51142480    	53716719    	52304530       	54013868       	10        	0         	10             	DEL       
chr11       	51142480    	53716719    	53193620       	54014281       	5         	0         	5              	DUP       
chr11       	51142480    	53716719    	53716293       	54014299       	15        	0         	15             	DUP       
chr11       	51142480    	53716719    	52161850       	54227856       	4         	0         	4              	DUP       
chr11       	51142480    	53716719    	52211857       	54272665       	5         	0         	5              	DEL       
chr11       	51142480    	53716719    	52730033       	54351091       	4         	0         	4              	DUP       
chr11       	51142480    	53716719    	53108468       	54423489       	7         	0         	7              	DEL       
chr11       	52211674    	53193821    	51142865       	52308261       	16        	0         	16             	DEL       
chr11       	52211674    	53193821    	51125059       	52308266       	7         	0         	7              	DEL       
chr11       	52211674    	53193821    	51124785       	52673450       	11        	0         	11             	DUP       
chr11       	52211674    	53193821    	52308264       	52673468       	15        	0         	15             	DUP       
chr11       	52211674    	53193821    	51124788       	52730354       	22        	0         	22             	DUP       
chr11       	52211674    	53193821    	52308259       	52730447       	19        	0         	19             	DUP       
chr11       	52211674    	53193821    	52795279       	52853884       	7         	0         	7              	DUP       
chr11       	52211674    	53193821    	52560870       	53048902       	9         	0         	9              	DEL       
chr11       	52211674    	53193821    	53022578       	53074589       	4         	0         	4              	DEL       
chr11       	52211674    	53193821    	52211675       	53193821       	4         	0         	4              	DUP       
chr11       	52211674    	53193821    	52826759       	53622459       	7         	0         	7              	DEL       
chr11       	52211674    	53193821    	53193647       	53716754       	7         	0         	7              	DUP       
chr11       	52211674    	53193821    	52308258       	53716836       	16        	0         	16             	DUP       
chr11       	52211674    	53193821    	52304543       	53742372       	9         	0         	9              	DEL       
chr11       	52211674    	53193821    	53108426       	53900199       	5         	0         	5              	DEL       
chr11       	52211674    	53193821    	52304530       	54013868       	10        	0         	10             	DEL       
chr11       	52211674    	53193821    	53193620       	54014281       	5         	0         	5              	DUP       
chr11       	52211674    	53193821    	52211857       	54272665       	5         	0         	5              	DEL       
chr11       	52211674    	53193821    	52730033       	54351091       	4         	0         	4              	DUP       
chr11       	52211674    	53193821    	53108468       	54423489       	7         	0         	7              	DEL       
chr11       	52211856    	54272665    	51142865       	52308261       	16        	0         	16             	DEL       
chr11       	52211856    	54272665    	51125059       	52308266       	7         	0         	7              	DEL       
chr11       	52211856    	54272665    	51124785       	52673450       	11        	0         	11             	DUP       
chr11       	52211856    	54272665    	52308264       	52673468       	15        	0         	15             	DUP       
chr11       	52211856    	54272665    	51124788       	52730354       	22        	0         	22             	DUP       
chr11       	52211856    	54272665    	52308259       	52730447       	19        	0         	19             	DUP       
chr11       	52211856    	54272665    	52795279       	52853884       	7         	0         	7              	DUP       
chr11       	52211856    	54272665    	52560870       	53048902       	9         	0         	9              	DEL       
chr11       	52211856    	54272665    	53022578       	53074589       	4         	0         	4              	DEL       
chr11       	52211856    	54272665    	52211675       	53193821       	4         	0         	4              	DUP       
chr11       	52211856    	54272665    	52826759       	53622459       	7         	0         	7              	DEL       
chr11       	52211856    	54272665    	53559186       	53665628       	5         	0         	5              	DUP       
chr11       	52211856    	54272665    	51142481       	53716719       	33        	0         	33             	DUP       
chr11       	52211856    	54272665    	51124895       	53716747       	13        	0         	13             	DUP       
chr11       	52211856    	54272665    	53193647       	53716754       	7         	0         	7              	DUP       
chr11       	52211856    	54272665    	52308258       	53716836       	16        	0         	16             	DUP       
chr11       	52211856    	54272665    	53716340       	53742598       	9         	0         	9              	DUP       
chr11       	52211856    	54272665    	52304543       	53742372       	9         	0         	9              	DEL       
chr11       	52211856    	54272665    	53108426       	53900199       	5         	0         	5              	DEL       
chr11       	52211856    	54272665    	52304530       	54013868       	10        	0         	10             	DEL       
chr11       	52211856    	54272665    	53193620       	54014281       	5         	0         	5              	DUP       
chr11       	52211856    	54272665    	53716293       	54014299       	15        	0         	15             	DUP       
chr11       	52211856    	54272665    	52161850       	54227856       	4         	0         	4              	DUP       
chr11       	52211856    	54272665    	52211857       	54272665       	5         	0         	5              	DEL       
chr11       	52211856    	54272665    	54241776       	54311703       	4         	0         	4              	DUP       
chr11       	52211856    	54272665    	52730033       	54351091       	4         	0         	4              	DUP       
chr11       	52211856    	54272665    	53900489       	54369514       	5         	0         	5              	DEL       
chr11       	52211856    	54272665    	53108468       	54423489       	7         	0         	7              	DEL       
chr11       	52304542    	53742372    	51142865       	52308261       	16        	0         	16             	DEL       
chr11       	52304542    	53742372    	51125059       	52308266       	7         	0         	7              	DEL       
chr11       	52304542    	53742372    	51124785       	52673450       	11        	0         	11             	DUP       
chr11       	52304542    	53742372    	52308264       	52673468       	15        	0         	15             	DUP       
chr11       	52304542    	53742372    	51124788       	52730354       	22        	0         	22             	DUP       
chr11       	52304542    	53742372    	52308259       	52730447       	19        	0         	19             	DUP       
chr11       	52304542    	53742372    	52795279       	52853884       	7         	0         	7              	DUP       
chr11       	52304542    	53742372    	52560870       	53048902       	9         	0         	9              	DEL       
chr11       	52304542    	53742372    	53022578       	53074589       	4         	0         	4              	DEL       
chr11       	52304542    	53742372    	52211675       	53193821       	4         	0         	4              	DUP       
chr11       	52304542    	53742372    	52826759       	53622459       	7         	0         	7              	DEL       
chr11       	52304542    	53742372    	53559186       	53665628       	5         	0         	5              	DUP       
chr11       	52304542    	53742372    	51142481       	53716719       	33        	0         	33             	DUP       
chr11       	52304542    	53742372    	51124895       	53716747       	13        	0         	13             	DUP       
chr11       	52304542    	53742372    	53193647       	53716754       	7         	0         	7              	DUP       
chr11       	52304542    	53742372    	52308258       	53716836       	16        	0         	16             	DUP       
chr11       	52304542    	53742372    	53716340       	53742598       	9         	0         	9              	DUP       
chr11       	52304542    	53742372    	52304543       	53742372       	9         	0         	9              	DEL       
chr11       	52304542    	53742372    	53108426       	53900199       	5         	0         	5              	DEL       
chr11       	52304542    	53742372    	52304530       	54013868       	10        	0         	10             	DEL       
chr11       	52304542    	53742372    	53193620       	54014281       	5         	0         	5              	DUP       
chr11       	52304542    	53742372    	53716293       	54014299       	15        	0         	15             	DUP       
chr11       	52304542    	53742372    	52730033       	54351091       	4         	0         	4              	DUP       
chr11       	52304542    	53742372    	53108468       	54423489       	7         	0         	7              	DEL       
chr11       	52304529    	54013868    	51142865       	52308261       	16        	0         	16             	DEL       
chr11       	52304529    	54013868    	51125059       	52308266       	7         	0         	7              	DEL       
chr11       	52304529    	54013868    	51124785       	52673450       	11        	0         	11             	DUP       
chr11       	52304529    	54013868    	52308264       	52673468       	15        	0         	15             	DUP       
chr11       	52304529    	54013868    	51124788       	52730354       	22        	0         	22             	DUP       
chr11       	52304529    	54013868    	52308259       	52730447       	19        	0         	19             	DUP       
chr11       	52304529    	54013868    	52795279       	52853884       	7         	0         	7              	DUP       
chr11       	52304529    	54013868    	52560870       	53048902       	9         	0         	9              	DEL       
chr11       	52304529    	54013868    	53022578       	53074589       	4         	0         	4              	DEL       
chr11       	52304529    	54013868    	52211675       	53193821       	4         	0         	4              	DUP       
chr11       	52304529    	54013868    	52826759       	53622459       	7         	0         	7              	DEL       
chr11       	52304529    	54013868    	53559186       	53665628       	5         	0         	5              	DUP       
chr11       	52304529    	54013868    	51142481       	53716719       	33        	0         	33             	DUP       
chr11       	52304529    	54013868    	51124895       	53716747       	13        	0         	13             	DUP       
chr11       	52304529    	54013868    	53193647       	53716754       	7         	0         	7              	DUP       
chr11       	52304529    	54013868    	52308258       	53716836       	16        	0         	16             	DUP       
chr11       	52304529    	54013868    	53716340       	53742598       	9         	0         	9              	DUP       
chr11       	52304529    	54013868    	52304543       	53742372       	9         	0         	9              	DEL       
chr11       	52304529    	54013868    	53108426       	53900199       	5         	0         	5              	DEL       
chr11       	52304529    	54013868    	52304530       	54013868       	10        	0         	10             	DEL       
chr11       	52304529    	54013868    	53193620       	54014281       	5         	0         	5              	DUP       
chr11       	52304529    	54013868    	53716293       	54014299       	15        	0         	15             	DUP       
chr11       	52304529    	54013868    	52730033       	54351091       	4         	0         	4              	DUP       
chr11       	52304529    	54013868    	53900489       	54369514       	5         	0         	5              	DEL       
chr11       	52304529    	54013868    	53108468       	54423489       	7         	0         	7              	DEL       
chr11       	52308263    	52673468    	51142865       	52308261       	16        	0         	16             	DEL       
chr11       	52308263    	52673468    	51125059       	52308266       	7         	0         	7              	DEL       
chr11       	52308263    	52673468    	51124785       	52673450       	11        	0         	11             	DUP       
chr11       	52308263    	52673468    	52308264       	52673468       	15        	0         	15             	DUP       
chr11       	52308263    	52673468    	52308259       	52730447       	19        	0         	19             	DUP       
chr11       	52308263    	52673468    	52560870       	53048902       	9         	0         	9              	DEL       
chr11       	52308263    	52673468    	52308258       	53716836       	16        	0         	16             	DUP       
chr11       	52308258    	52730447    	51142865       	52308261       	16        	0         	16             	DEL       
chr11       	52308258    	52730447    	51125059       	52308266       	7         	0         	7              	DEL       
chr11       	52308258    	52730447    	51124785       	52673450       	11        	0         	11             	DUP       
chr11       	52308258    	52730447    	52308264       	52673468       	15        	0         	15             	DUP       
chr11       	52308258    	52730447    	51124788       	52730354       	22        	0         	22             	DUP       
chr11       	52308258    	52730447    	52308259       	52730447       	19        	0         	19             	DUP       
chr11       	52308258    	52730447    	52560870       	53048902       	9         	0         	9              	DEL       
chr11       	52308258    	52730447    	52308258       	53716836       	16        	0         	16             	DUP       
chr11       	52308258    	52730447    	52730033       	54351091       	4         	0         	4              	DUP       
chr11       	52308257    	53716836    	51142865       	52308261       	16        	0         	16             	DEL       
chr11       	52308257    	53716836    	51125059       	52308266       	7         	0         	7              	DEL       
chr11       	52308257    	53716836    	51124785       	52673450       	11        	0         	11             	DUP       
chr11       	52308257    	53716836    	52308264       	52673468       	15        	0         	15             	DUP       
chr11       	52308257    	53716836    	51124788       	52730354       	22        	0         	22             	DUP       
chr11       	52308257    	53716836    	52308259       	52730447       	19        	0         	19             	DUP       
chr11       	52308257    	53716836    	52795279       	52853884       	7         	0         	7              	DUP       
chr11       	52308257    	53716836    	52560870       	53048902       	9         	0         	9              	DEL       
chr11       	52308257    	53716836    	53022578       	53074589       	4         	0         	4              	DEL       
chr11       	52308257    	53716836    	52211675       	53193821       	4         	0         	4              	DUP       
chr11       	52308257    	53716836    	52826759       	53622459       	7         	0         	7              	DEL       
chr11       	52308257    	53716836    	53559186       	53665628       	5         	0         	5              	DUP       
chr11       	52308257    	53716836    	51142481       	53716719       	33        	0         	33             	DUP       
chr11       	52308257    	53716836    	51124895       	53716747       	13        	0         	13             	DUP       
chr11       	52308257    	53716836    	53193647       	53716754       	7         	0         	7              	DUP       
chr11       	52308257    	53716836    	52308258       	53716836       	16        	0         	16             	DUP       
chr11       	52308257    	53716836    	53716340       	53742598       	9         	0         	9              	DUP       
chr11       	52308257    	53716836    	53108426       	53900199       	5         	0         	5              	DEL       
chr11       	52308257    	53716836    	53193620       	54014281       	5         	0         	5              	DUP       
chr11       	52308257    	53716836    	53716293       	54014299       	15        	0         	15             	DUP       
chr11       	52308257    	53716836    	52730033       	54351091       	4         	0         	4              	DUP       
chr11       	52308257    	53716836    	53108468       	54423489       	7         	0         	7              	DEL       
chr11       	52561123    	53048730    	51124785       	52673450       	11        	0         	11             	DUP       
chr11       	52561123    	53048730    	52308264       	52673468       	15        	0         	15             	DUP       
chr11       	52561123    	53048730    	51124788       	52730354       	22        	0         	22             	DUP       
chr11       	52561123    	53048730    	52308259       	52730447       	19        	0         	19             	DUP       
chr11       	52561123    	53048730    	52795279       	52853884       	7         	0         	7              	DUP       
chr11       	52561123    	53048730    	53022578       	53074589       	4         	0         	4              	DEL       
chr11       	52561123    	53048730    	52826759       	53622459       	7         	0         	7              	DEL       
chr11       	52561123    	53048730    	52730033       	54351091       	4         	0         	4              	DUP       
chr11       	52730032    	54351091    	51124788       	52730354       	22        	0         	22             	DUP       
chr11       	52730032    	54351091    	52308259       	52730447       	19        	0         	19             	DUP       
chr11       	52730032    	54351091    	52795279       	52853884       	7         	0         	7              	DUP       
chr11       	52730032    	54351091    	52560870       	53048902       	9         	0         	9              	DEL       
chr11       	52730032    	54351091    	53022578       	53074589       	4         	0         	4              	DEL       
chr11       	52730032    	54351091    	52211675       	53193821       	4         	0         	4              	DUP       
chr11       	52730032    	54351091    	52826759       	53622459       	7         	0         	7              	DEL       
chr11       	52730032    	54351091    	53559186       	53665628       	5         	0         	5              	DUP       
chr11       	52730032    	54351091    	51142481       	53716719       	33        	0         	33             	DUP       
chr11       	52730032    	54351091    	51124895       	53716747       	13        	0         	13             	DUP       
chr11       	52730032    	54351091    	53193647       	53716754       	7         	0         	7              	DUP       
chr11       	52730032    	54351091    	52308258       	53716836       	16        	0         	16             	DUP       
chr11       	52730032    	54351091    	53716340       	53742598       	9         	0         	9              	DUP       
chr11       	52730032    	54351091    	52304543       	53742372       	9         	0         	9              	DEL       
chr11       	52730032    	54351091    	53108426       	53900199       	5         	0         	5              	DEL       
chr11       	52730032    	54351091    	52304530       	54013868       	10        	0         	10             	DEL       
chr11       	52730032    	54351091    	53193620       	54014281       	5         	0         	5              	DUP       
chr11       	52730032    	54351091    	53716293       	54014299       	15        	0         	15             	DUP       
chr11       	52730032    	54351091    	52161850       	54227856       	4         	0         	4              	DUP       
chr11       	52730032    	54351091    	52211857       	54272665       	5         	0         	5              	DEL       
chr11       	52730032    	54351091    	54241776       	54311703       	4         	0         	4              	DUP       
chr11       	52730032    	54351091    	52730033       	54351091       	4         	0         	4              	DUP       
chr11       	52730032    	54351091    	53900489       	54369514       	5         	0         	5              	DEL       
chr11       	52730032    	54351091    	54345323       	54372909       	6         	0         	6              	DUP       
chr11       	52730032    	54351091    	54346547       	54390784       	9         	0         	9              	DUP       
chr11       	52730032    	54351091    	54347409       	54403779       	5         	0         	5              	DEL       
chr11       	52730032    	54351091    	54347382       	54405634       	4         	0         	4              	DUP       
chr11       	52730032    	54351091    	54347148       	54409398       	10        	0         	10             	DUP       
chr11       	52730032    	54351091    	54344917       	54409518       	4         	0         	4              	DEL       
chr11       	52730032    	54351091    	54345321       	54419794       	5         	0         	5              	DUP       
chr11       	52730032    	54351091    	53108468       	54423489       	7         	0         	7              	DEL       
chr11       	52795157    	52854010    	52795279       	52853884       	7         	0         	7              	DUP       
chr11       	52795157    	52854010    	52826759       	53622459       	7         	0         	7              	DEL       
chr11       	52826874    	53622271    	52795279       	52853884       	7         	0         	7              	DUP       
chr11       	52826874    	53622271    	52560870       	53048902       	9         	0         	9              	DEL       
chr11       	52826874    	53622271    	53022578       	53074589       	4         	0         	4              	DEL       
chr11       	52826874    	53622271    	52211675       	53193821       	4         	0         	4              	DUP       
chr11       	52826874    	53622271    	53559186       	53665628       	5         	0         	5              	DUP       
chr11       	52826874    	53622271    	53193647       	53716754       	7         	0         	7              	DUP       
chr11       	52826874    	53622271    	53108426       	53900199       	5         	0         	5              	DEL       
chr11       	52826874    	53622271    	53193620       	54014281       	5         	0         	5              	DUP       
chr11       	52826874    	53622271    	53108468       	54423489       	7         	0         	7              	DEL       
chr11       	53022577    	53074589    	52560870       	53048902       	9         	0         	9              	DEL       
chr11       	53022577    	53074589    	53022578       	53074589       	4         	0         	4              	DEL       
chr11       	53108566    	53900043    	52211675       	53193821       	4         	0         	4              	DUP       
chr11       	53108566    	53900043    	52826759       	53622459       	7         	0         	7              	DEL       
chr11       	53108566    	53900043    	53559186       	53665628       	5         	0         	5              	DUP       
chr11       	53108566    	53900043    	51142481       	53716719       	33        	0         	33             	DUP       
chr11       	53108566    	53900043    	51124895       	53716747       	13        	0         	13             	DUP       
chr11       	53108566    	53900043    	53193647       	53716754       	7         	0         	7              	DUP       
chr11       	53108566    	53900043    	52308258       	53716836       	16        	0         	16             	DUP       
chr11       	53108566    	53900043    	53716340       	53742598       	9         	0         	9              	DUP       
chr11       	53108566    	53900043    	52304543       	53742372       	9         	0         	9              	DEL       
chr11       	53108566    	53900043    	53193620       	54014281       	5         	0         	5              	DUP       
chr11       	53108566    	53900043    	53716293       	54014299       	15        	0         	15             	DUP       
chr11       	53108566    	53900043    	53108468       	54423489       	7         	0         	7              	DEL       
chr11       	53108467    	54423489    	52211675       	53193821       	4         	0         	4              	DUP       
chr11       	53108467    	54423489    	52826759       	53622459       	7         	0         	7              	DEL       
chr11       	53108467    	54423489    	53559186       	53665628       	5         	0         	5              	DUP       
chr11       	53108467    	54423489    	51142481       	53716719       	33        	0         	33             	DUP       
chr11       	53108467    	54423489    	51124895       	53716747       	13        	0         	13             	DUP       
chr11       	53108467    	54423489    	53193647       	53716754       	7         	0         	7              	DUP       
chr11       	53108467    	54423489    	52308258       	53716836       	16        	0         	16             	DUP       
chr11       	53108467    	54423489    	53716340       	53742598       	9         	0         	9              	DUP       
chr11       	53108467    	54423489    	52304543       	53742372       	9         	0         	9              	DEL       
chr11       	53108467    	54423489    	53108426       	53900199       	5         	0         	5              	DEL       
chr11       	53108467    	54423489    	52304530       	54013868       	10        	0         	10             	DEL       
chr11       	53108467    	54423489    	53193620       	54014281       	5         	0         	5              	DUP       
chr11       	53108467    	54423489    	53716293       	54014299       	15        	0         	15             	DUP       
chr11       	53108467    	54423489    	52161850       	54227856       	4         	0         	4              	DUP       
chr11       	53108467    	54423489    	52211857       	54272665       	5         	0         	5              	DEL       
chr11       	53108467    	54423489    	54241776       	54311703       	4         	0         	4              	DUP       
chr11       	53108467    	54423489    	52730033       	54351091       	4         	0         	4              	DUP       
chr11       	53108467    	54423489    	53900489       	54369514       	5         	0         	5              	DEL       
chr11       	53108467    	54423489    	54345323       	54372909       	6         	0         	6              	DUP       
chr11       	53108467    	54423489    	54372653       	54376865       	9         	0         	9              	DEL       
chr11       	53108467    	54423489    	54371449       	54377382       	9         	0         	9              	DUP       
chr11       	53108467    	54423489    	54371716       	54380032       	5         	0         	5              	DEL       
chr11       	53108467    	54423489    	54346547       	54390784       	9         	0         	9              	DUP       
chr11       	53108467    	54423489    	54347409       	54403779       	5         	0         	5              	DEL       
chr11       	53108467    	54423489    	54347382       	54405634       	4         	0         	4              	DUP       
chr11       	53108467    	54423489    	54369455       	54405445       	4         	0         	4              	DEL       
chr11       	53108467    	54423489    	54347148       	54409398       	10        	0         	10             	DUP       
chr11       	53108467    	54423489    	54374245       	54409220       	4         	0         	4              	DEL       
chr11       	53108467    	54423489    	54344917       	54409518       	4         	0         	4              	DEL       
chr11       	53108467    	54423489    	54369108       	54415838       	5         	0         	5              	DUP       
chr11       	53108467    	54423489    	54345321       	54419794       	5         	0         	5              	DUP       
chr11       	53108467    	54423489    	53108468       	54423489       	7         	0         	7              	DEL       
chr11       	53108467    	54423489    	54415670       	54549078       	10        	0         	10             	DUP       
chr11       	53108467    	54423489    	54384302       	54549176       	8         	0         	8              	DUP       
chr11       	53108467    	54423489    	54359866       	54549392       	8         	0         	8              	DUP       
chr11       	53193436    	53716806    	52211675       	53193821       	4         	0         	4              	DUP       
chr11       	53193436    	53716806    	52826759       	53622459       	7         	0         	7              	DEL       
chr11       	53193436    	53716806    	53559186       	53665628       	5         	0         	5              	DUP       
chr11       	53193436    	53716806    	51142481       	53716719       	33        	0         	33             	DUP       
chr11       	53193436    	53716806    	51124895       	53716747       	13        	0         	13             	DUP       
chr11       	53193436    	53716806    	53193647       	53716754       	7         	0         	7              	DUP       
chr11       	53193436    	53716806    	52308258       	53716836       	16        	0         	16             	DUP       
chr11       	53193436    	53716806    	53716340       	53742598       	9         	0         	9              	DUP       
chr11       	53193436    	53716806    	53193620       	54014281       	5         	0         	5              	DUP       
chr11       	53193436    	53716806    	53716293       	54014299       	15        	0         	15             	DUP       
chr11       	53193619    	54014281    	52211675       	53193821       	4         	0         	4              	DUP       
chr11       	53193619    	54014281    	52826759       	53622459       	7         	0         	7              	DEL       
chr11       	53193619    	54014281    	53559186       	53665628       	5         	0         	5              	DUP       
chr11       	53193619    	54014281    	51142481       	53716719       	33        	0         	33             	DUP       
chr11       	53193619    	54014281    	51124895       	53716747       	13        	0         	13             	DUP       
chr11       	53193619    	54014281    	53193647       	53716754       	7         	0         	7              	DUP       
chr11       	53193619    	54014281    	52308258       	53716836       	16        	0         	16             	DUP       
chr11       	53193619    	54014281    	53716340       	53742598       	9         	0         	9              	DUP       
chr11       	53193619    	54014281    	52304543       	53742372       	9         	0         	9              	DEL       
chr11       	53193619    	54014281    	53108426       	53900199       	5         	0         	5              	DEL       
chr11       	53193619    	54014281    	52304530       	54013868       	10        	0         	10             	DEL       
chr11       	53193619    	54014281    	53193620       	54014281       	5         	0         	5              	DUP       
chr11       	53193619    	54014281    	53716293       	54014299       	15        	0         	15             	DUP       
chr11       	53193619    	54014281    	53900489       	54369514       	5         	0         	5              	DEL       
chr11       	53559185    	53665628    	52826759       	53622459       	7         	0         	7              	DEL       
chr11       	53559185    	53665628    	53559186       	53665628       	5         	0         	5              	DUP       
chr11       	53716211    	53742800    	51142481       	53716719       	33        	0         	33             	DUP       
chr11       	53716211    	53742800    	51124895       	53716747       	13        	0         	13             	DUP       
chr11       	53716211    	53742800    	53193647       	53716754       	7         	0         	7              	DUP       
chr11       	53716211    	53742800    	52308258       	53716836       	16        	0         	16             	DUP       
chr11       	53716211    	53742800    	53716340       	53742598       	9         	0         	9              	DUP       
chr11       	53716211    	53742800    	52304543       	53742372       	9         	0         	9              	DEL       
chr11       	53716211    	53742800    	53716293       	54014299       	15        	0         	15             	DUP       
chr11       	53716273    	54014395    	51142481       	53716719       	33        	0         	33             	DUP       
chr11       	53716273    	54014395    	51124895       	53716747       	13        	0         	13             	DUP       
chr11       	53716273    	54014395    	53193647       	53716754       	7         	0         	7              	DUP       
chr11       	53716273    	54014395    	52308258       	53716836       	16        	0         	16             	DUP       
chr11       	53716273    	54014395    	53716340       	53742598       	9         	0         	9              	DUP       
chr11       	53716273    	54014395    	52304543       	53742372       	9         	0         	9              	DEL       
chr11       	53716273    	54014395    	53108426       	53900199       	5         	0         	5              	DEL       
chr11       	53716273    	54014395    	52304530       	54013868       	10        	0         	10             	DEL       
chr11       	53716273    	54014395    	53193620       	54014281       	5         	0         	5              	DUP       
chr11       	53716273    	54014395    	53716293       	54014299       	15        	0         	15             	DUP       
chr11       	53716273    	54014395    	53900489       	54369514       	5         	0         	5              	DEL       
chr11       	53900651    	54369342    	52304530       	54013868       	10        	0         	10             	DEL       
chr11       	53900651    	54369342    	53193620       	54014281       	5         	0         	5              	DUP       
chr11       	53900651    	54369342    	53716293       	54014299       	15        	0         	15             	DUP       
chr11       	53900651    	54369342    	52161850       	54227856       	4         	0         	4              	DUP       
chr11       	53900651    	54369342    	52211857       	54272665       	5         	0         	5              	DEL       
chr11       	53900651    	54369342    	54241776       	54311703       	4         	0         	4              	DUP       
chr11       	53900651    	54369342    	52730033       	54351091       	4         	0         	4              	DUP       
chr11       	53900651    	54369342    	54345323       	54372909       	6         	0         	6              	DUP       
chr11       	53900651    	54369342    	54346547       	54390784       	9         	0         	9              	DUP       
chr11       	53900651    	54369342    	54347409       	54403779       	5         	0         	5              	DEL       
chr11       	53900651    	54369342    	54347382       	54405634       	4         	0         	4              	DUP       
chr11       	53900651    	54369342    	54347148       	54409398       	10        	0         	10             	DUP       
chr11       	53900651    	54369342    	54344917       	54409518       	4         	0         	4              	DEL       
chr11       	53900651    	54369342    	54369108       	54415838       	5         	0         	5              	DUP       
chr11       	53900651    	54369342    	54345321       	54419794       	5         	0         	5              	DUP       
chr11       	53900651    	54369342    	54359866       	54549392       	8         	0         	8              	DUP       
chr11       	54241775    	54311703    	52211857       	54272665       	5         	0         	5              	DEL       
chr11       	54241775    	54311703    	54241776       	54311703       	4         	0         	4              	DUP       
chr11       	54345322    	54372909    	52730033       	54351091       	4         	0         	4              	DUP       
chr11       	54345322    	54372909    	53900489       	54369514       	5         	0         	5              	DEL       
chr11       	54345322    	54372909    	54345323       	54372909       	6         	0         	6              	DUP       
chr11       	54345322    	54372909    	54372653       	54376865       	9         	0         	9              	DEL       
chr11       	54345322    	54372909    	54371449       	54377382       	9         	0         	9              	DUP       
chr11       	54345322    	54372909    	54371716       	54380032       	5         	0         	5              	DEL       
chr11       	54345322    	54372909    	54346547       	54390784       	9         	0         	9              	DUP       
chr11       	54345322    	54372909    	54347409       	54403779       	5         	0         	5              	DEL       
chr11       	54345322    	54372909    	54347382       	54405634       	4         	0         	4              	DUP       
chr11       	54345322    	54372909    	54369455       	54405445       	4         	0         	4              	DEL       
chr11       	54345322    	54372909    	54347148       	54409398       	10        	0         	10             	DUP       
chr11       	54345322    	54372909    	54369108       	54415838       	5         	0         	5              	DUP       
chr11       	54345322    	54372909    	54345321       	54419794       	5         	0         	5              	DUP       
chr11       	54345322    	54372909    	54359866       	54549392       	8         	0         	8              	DUP       
chr11       	54345320    	54419794    	52730033       	54351091       	4         	0         	4              	DUP       
chr11       	54345320    	54419794    	53900489       	54369514       	5         	0         	5              	DEL       
chr11       	54345320    	54419794    	54345323       	54372909       	6         	0         	6              	DUP       
chr11       	54345320    	54419794    	54372653       	54376865       	9         	0         	9              	DEL       
chr11       	54345320    	54419794    	54371449       	54377382       	9         	0         	9              	DUP       
chr11       	54345320    	54419794    	54371716       	54380032       	5         	0         	5              	DEL       
chr11       	54345320    	54419794    	54346547       	54390784       	9         	0         	9              	DUP       
chr11       	54345320    	54419794    	54347409       	54403779       	5         	0         	5              	DEL       
chr11       	54345320    	54419794    	54347382       	54405634       	4         	0         	4              	DUP       
chr11       	54345320    	54419794    	54369455       	54405445       	4         	0         	4              	DEL       
chr11       	54345320    	54419794    	54347148       	54409398       	10        	0         	10             	DUP       
chr11       	54345320    	54419794    	54374245       	54409220       	4         	0         	4              	DEL       
chr11       	54345320    	54419794    	54344917       	54409518       	4         	0         	4              	DEL       
chr11       	54345320    	54419794    	54369108       	54415838       	5         	0         	5              	DUP       
chr11       	54345320    	54419794    	54345321       	54419794       	5         	0         	5              	DUP       
chr11       	54345320    	54419794    	54415670       	54549078       	10        	0         	10             	DUP       
chr11       	54345320    	54419794    	54384302       	54549176       	8         	0         	8              	DUP       
chr11       	54345320    	54419794    	54359866       	54549392       	8         	0         	8              	DUP       
chr11       	54346546    	54390784    	52730033       	54351091       	4         	0         	4              	DUP       
chr11       	54346546    	54390784    	53900489       	54369514       	5         	0         	5              	DEL       
chr11       	54346546    	54390784    	54345323       	54372909       	6         	0         	6              	DUP       
chr11       	54346546    	54390784    	54372653       	54376865       	9         	0         	9              	DEL       
chr11       	54346546    	54390784    	54371449       	54377382       	9         	0         	9              	DUP       
chr11       	54346546    	54390784    	54371716       	54380032       	5         	0         	5              	DEL       
chr11       	54346546    	54390784    	54346547       	54390784       	9         	0         	9              	DUP       
chr11       	54346546    	54390784    	54347409       	54403779       	5         	0         	5              	DEL       
chr11       	54346546    	54390784    	54347382       	54405634       	4         	0         	4              	DUP       
chr11       	54346546    	54390784    	54369455       	54405445       	4         	0         	4              	DEL       
chr11       	54346546    	54390784    	54347148       	54409398       	10        	0         	10             	DUP       
chr11       	54346546    	54390784    	54374245       	54409220       	4         	0         	4              	DEL       
chr11       	54346546    	54390784    	54369108       	54415838       	5         	0         	5              	DUP       
chr11       	54346546    	54390784    	54384302       	54549176       	8         	0         	8              	DUP       
chr11       	54346546    	54390784    	54359866       	54549392       	8         	0         	8              	DUP       
chr11       	54347408    	54403779    	52730033       	54351091       	4         	0         	4              	DUP       
chr11       	54347408    	54403779    	53900489       	54369514       	5         	0         	5              	DEL       
chr11       	54347408    	54403779    	54345323       	54372909       	6         	0         	6              	DUP       
chr11       	54347408    	54403779    	54372653       	54376865       	9         	0         	9              	DEL       
chr11       	54347408    	54403779    	54371449       	54377382       	9         	0         	9              	DUP       
chr11       	54347408    	54403779    	54371716       	54380032       	5         	0         	5              	DEL       
chr11       	54347408    	54403779    	54346547       	54390784       	9         	0         	9              	DUP       
chr11       	54347408    	54403779    	54347409       	54403779       	5         	0         	5              	DEL       
chr11       	54347408    	54403779    	54347382       	54405634       	4         	0         	4              	DUP       
chr11       	54347408    	54403779    	54369455       	54405445       	4         	0         	4              	DEL       
chr11       	54347408    	54403779    	54374245       	54409220       	4         	0         	4              	DEL       
chr11       	54347408    	54403779    	54369108       	54415838       	5         	0         	5              	DUP       
chr11       	54347408    	54403779    	54384302       	54549176       	8         	0         	8              	DUP       
chr11       	54347408    	54403779    	54359866       	54549392       	8         	0         	8              	DUP       
chr11       	54347381    	54405634    	52730033       	54351091       	4         	0         	4              	DUP       
chr11       	54347381    	54405634    	53900489       	54369514       	5         	0         	5              	DEL       
chr11       	54347381    	54405634    	54345323       	54372909       	6         	0         	6              	DUP       
chr11       	54347381    	54405634    	54372653       	54376865       	9         	0         	9              	DEL       
chr11       	54347381    	54405634    	54371449       	54377382       	9         	0         	9              	DUP       
chr11       	54347381    	54405634    	54371716       	54380032       	5         	0         	5              	DEL       
chr11       	54347381    	54405634    	54346547       	54390784       	9         	0         	9              	DUP       
chr11       	54347381    	54405634    	54347409       	54403779       	5         	0         	5              	DEL       
chr11       	54347381    	54405634    	54347382       	54405634       	4         	0         	4              	DUP       
chr11       	54347381    	54405634    	54369455       	54405445       	4         	0         	4              	DEL       
chr11       	54347381    	54405634    	54374245       	54409220       	4         	0         	4              	DEL       
chr11       	54347381    	54405634    	54369108       	54415838       	5         	0         	5              	DUP       
chr11       	54347381    	54405634    	54384302       	54549176       	8         	0         	8              	DUP       
chr11       	54347381    	54405634    	54359866       	54549392       	8         	0         	8              	DUP       
chr11       	54347147    	54409398    	52730033       	54351091       	4         	0         	4              	DUP       
chr11       	54347147    	54409398    	53900489       	54369514       	5         	0         	5              	DEL       
chr11       	54347147    	54409398    	54345323       	54372909       	6         	0         	6              	DUP       
chr11       	54347147    	54409398    	54372653       	54376865       	9         	0         	9              	DEL       
chr11       	54347147    	54409398    	54371449       	54377382       	9         	0         	9              	DUP       
chr11       	54347147    	54409398    	54371716       	54380032       	5         	0         	5              	DEL       
chr11       	54347147    	54409398    	54346547       	54390784       	9         	0         	9              	DUP       
chr11       	54347147    	54409398    	54347409       	54403779       	5         	0         	5              	DEL       
chr11       	54347147    	54409398    	54347382       	54405634       	4         	0         	4              	DUP       
chr11       	54347147    	54409398    	54369455       	54405445       	4         	0         	4              	DEL       
chr11       	54347147    	54409398    	54347148       	54409398       	10        	0         	10             	DUP       
chr11       	54347147    	54409398    	54374245       	54409220       	4         	0         	4              	DEL       
chr11       	54347147    	54409398    	54369108       	54415838       	5         	0         	5              	DUP       
chr11       	54347147    	54409398    	54384302       	54549176       	8         	0         	8              	DUP       
chr11       	54347147    	54409398    	54359866       	54549392       	8         	0         	8              	DUP       
chr11       	54359865    	54549392    	53900489       	54369514       	5         	0         	5              	DEL       
chr11       	54359865    	54549392    	54345323       	54372909       	6         	0         	6              	DUP       
chr11       	54359865    	54549392    	54372653       	54376865       	9         	0         	9              	DEL       
chr11       	54359865    	54549392    	54371449       	54377382       	9         	0         	9              	DUP       
chr11       	54359865    	54549392    	54371716       	54380032       	5         	0         	5              	DEL       
chr11       	54359865    	54549392    	54346547       	54390784       	9         	0         	9              	DUP       
chr11       	54359865    	54549392    	54347409       	54403779       	5         	0         	5              	DEL       
chr11       	54359865    	54549392    	54347382       	54405634       	4         	0         	4              	DUP       
chr11       	54359865    	54549392    	54369455       	54405445       	4         	0         	4              	DEL       
chr11       	54359865    	54549392    	54347148       	54409398       	10        	0         	10             	DUP       
chr11       	54359865    	54549392    	54374245       	54409220       	4         	0         	4              	DEL       
chr11       	54359865    	54549392    	54344917       	54409518       	4         	0         	4              	DEL       
chr11       	54359865    	54549392    	54369108       	54415838       	5         	0         	5              	DUP       
chr11       	54359865    	54549392    	54345321       	54419794       	5         	0         	5              	DUP       
chr11       	54359865    	54549392    	53108468       	54423489       	7         	0         	7              	DEL       
chr11       	54359865    	54549392    	54542731       	54543587       	27        	0         	27             	DEL       
chr11       	54359865    	54549392    	54544101       	54548200       	7         	0         	7              	DEL       
chr11       	54359865    	54549392    	54415670       	54549078       	10        	0         	10             	DUP       
chr11       	54359865    	54549392    	54384302       	54549176       	8         	0         	8              	DUP       
chr11       	54359865    	54549392    	54359866       	54549392       	8         	0         	8              	DUP       
chr11       	54369454    	54405445    	53900489       	54369514       	5         	0         	5              	DEL       
chr11       	54369454    	54405445    	54345323       	54372909       	6         	0         	6              	DUP       
chr11       	54369454    	54405445    	54372653       	54376865       	9         	0         	9              	DEL       
chr11       	54369454    	54405445    	54371449       	54377382       	9         	0         	9              	DUP       
chr11       	54369454    	54405445    	54371716       	54380032       	5         	0         	5              	DEL       
chr11       	54369454    	54405445    	54346547       	54390784       	9         	0         	9              	DUP       
chr11       	54369454    	54405445    	54347409       	54403779       	5         	0         	5              	DEL       
chr11       	54369454    	54405445    	54369455       	54405445       	4         	0         	4              	DEL       
chr11       	54369454    	54405445    	54374245       	54409220       	4         	0         	4              	DEL       
chr11       	54369454    	54405445    	54384302       	54549176       	8         	0         	8              	DUP       
chr11       	54369107    	54415838    	53900489       	54369514       	5         	0         	5              	DEL       
chr11       	54369107    	54415838    	54345323       	54372909       	6         	0         	6              	DUP       
chr11       	54369107    	54415838    	54372653       	54376865       	9         	0         	9              	DEL       
chr11       	54369107    	54415838    	54371449       	54377382       	9         	0         	9              	DUP       
chr11       	54369107    	54415838    	54371716       	54380032       	5         	0         	5              	DEL       
chr11       	54369107    	54415838    	54346547       	54390784       	9         	0         	9              	DUP       
chr11       	54369107    	54415838    	54347409       	54403779       	5         	0         	5              	DEL       
chr11       	54369107    	54415838    	54347382       	54405634       	4         	0         	4              	DUP       
chr11       	54369107    	54415838    	54369455       	54405445       	4         	0         	4              	DEL       
chr11       	54369107    	54415838    	54347148       	54409398       	10        	0         	10             	DUP       
chr11       	54369107    	54415838    	54374245       	54409220       	4         	0         	4              	DEL       
chr11       	54369107    	54415838    	54344917       	54409518       	4         	0         	4              	DEL       
chr11       	54369107    	54415838    	54369108       	54415838       	5         	0         	5              	DUP       
chr11       	54369107    	54415838    	54415670       	54549078       	10        	0         	10             	DUP       
chr11       	54369107    	54415838    	54384302       	54549176       	8         	0         	8              	DUP       
chr11       	54371267    	54377502    	54345323       	54372909       	6         	0         	6              	DUP       
chr11       	54371267    	54377502    	54372653       	54376865       	9         	0         	9              	DEL       
chr11       	54371267    	54377502    	54371449       	54377382       	9         	0         	9              	DUP       
chr11       	54371267    	54377502    	54371716       	54380032       	5         	0         	5              	DEL       
chr11       	54371267    	54377502    	54374245       	54409220       	4         	0         	4              	DEL       
chr11       	54372674    	54376814    	54345323       	54372909       	6         	0         	6              	DUP       
chr11       	54372674    	54376814    	54372653       	54376865       	9         	0         	9              	DEL       
chr11       	54372674    	54376814    	54374245       	54409220       	4         	0         	4              	DEL       
chr11       	54371715    	54380032    	54345323       	54372909       	6         	0         	6              	DUP       
chr11       	54371715    	54380032    	54372653       	54376865       	9         	0         	9              	DEL       
chr11       	54371715    	54380032    	54371449       	54377382       	9         	0         	9              	DUP       
chr11       	54371715    	54380032    	54371716       	54380032       	5         	0         	5              	DEL       
chr11       	54371715    	54380032    	54374245       	54409220       	4         	0         	4              	DEL       
chr11       	54374244    	54409220    	54372653       	54376865       	9         	0         	9              	DEL       
chr11       	54374244    	54409220    	54371449       	54377382       	9         	0         	9              	DUP       
chr11       	54374244    	54409220    	54371716       	54380032       	5         	0         	5              	DEL       
chr11       	54374244    	54409220    	54346547       	54390784       	9         	0         	9              	DUP       
chr11       	54374244    	54409220    	54347409       	54403779       	5         	0         	5              	DEL       
chr11       	54374244    	54409220    	54347382       	54405634       	4         	0         	4              	DUP       
chr11       	54374244    	54409220    	54369455       	54405445       	4         	0         	4              	DEL       
chr11       	54374244    	54409220    	54374245       	54409220       	4         	0         	4              	DEL       
chr11       	54374244    	54409220    	54384302       	54549176       	8         	0         	8              	DUP       
chr11       	54384301    	54549176    	54346547       	54390784       	9         	0         	9              	DUP       
chr11       	54384301    	54549176    	54347409       	54403779       	5         	0         	5              	DEL       
chr11       	54384301    	54549176    	54347382       	54405634       	4         	0         	4              	DUP       
chr11       	54384301    	54549176    	54369455       	54405445       	4         	0         	4              	DEL       
chr11       	54384301    	54549176    	54347148       	54409398       	10        	0         	10             	DUP       
chr11       	54384301    	54549176    	54374245       	54409220       	4         	0         	4              	DEL       
chr11       	54384301    	54549176    	54344917       	54409518       	4         	0         	4              	DEL       
chr11       	54384301    	54549176    	54369108       	54415838       	5         	0         	5              	DUP       
chr11       	54384301    	54549176    	54345321       	54419794       	5         	0         	5              	DUP       
chr11       	54384301    	54549176    	53108468       	54423489       	7         	0         	7              	DEL       
chr11       	54384301    	54549176    	54542731       	54543587       	27        	0         	27             	DEL       
chr11       	54384301    	54549176    	54544101       	54548200       	7         	0         	7              	DEL       
chr11       	54384301    	54549176    	54415670       	54549078       	10        	0         	10             	DUP       
chr11       	54384301    	54549176    	54384302       	54549176       	8         	0         	8              	DUP       
chr11       	54415470    	54549100    	54369108       	54415838       	5         	0         	5              	DUP       
chr11       	54415470    	54549100    	54345321       	54419794       	5         	0         	5              	DUP       
chr11       	54415470    	54549100    	53108468       	54423489       	7         	0         	7              	DEL       
chr11       	54415470    	54549100    	54542731       	54543587       	27        	0         	27             	DEL       
chr11       	54415470    	54549100    	54544101       	54548200       	7         	0         	7              	DEL       
chr11       	54415470    	54549100    	54415670       	54549078       	10        	0         	10             	DUP       
chr11       	54415470    	54549100    	54384302       	54549176       	8         	0         	8              	DUP       
chr11       	54542730    	54543587    	54542731       	54543587       	27        	0         	27             	DEL       
chr11       	54544137    	54548312    	54544101       	54548200       	7         	0         	7              	DEL       
chr11       	54756272    	54778076    	54756334       	54778069       	54        	0         	54             	DEL       
chr11       	54934937    	54937858    	54934922       	54937899       	51        	0         	51             	DUP       
chr11       	55057760    	55057929    	55057736       	55057935       	0         	13        	13             	DUP       
chr11       	55117849    	55124729    	55117879       	55124742       	20        	0         	20             	DEL       
chr11       	55117849    	55124729    	48726978       	55124774       	16        	0         	16             	DEL       
chr11       	55247396    	55249058    	55247405       	55249031       	48        	0         	48             	DUP       
chr11       	58399507    	58400676    	58399526       	58400676       	35        	17        	52             	DEL       
chr11       	61099466    	61100059    	61099466       	61100057       	8         	0         	8              	DUP       
chr11       	62009755    	62010563    	62009734       	62010566       	21        	0         	21             	DUP       
chr11       	62122831    	62122922    	62122849       	62122922       	0         	15        	15             	DEL       
chr11       	62177314    	62177613    	62177315       	62177613       	1         	12        	13             	DEL       
chr11       	62366672    	62385321    	62366672       	62385323       	8         	0         	8              	DUP       
chr11       	63931435    	63934181    	63931437       	63934181       	28        	12        	40             	DEL       
chr11       	63931435    	63934181    	63931434       	63934472       	22        	9         	31             	DUP       
chr11       	63931433    	63934472    	63931437       	63934181       	28        	12        	40             	DEL       
chr11       	63931433    	63934472    	63931434       	63934472       	22        	9         	31             	DUP       
chr11       	64199443    	64199614    	64199451       	64199614       	0         	4         	4              	DEL       
chr11       	64500966    	64501027    	64500969       	64501027       	0         	10        	10             	DEL       
chr11       	65874635    	65876048    	65874640       	65876048       	30        	10        	40             	DEL       
chr11       	66943944    	66946001    	66944033       	66945934       	11        	0         	11             	DEL       
chr11       	67717014    	67739784    	67717014       	67739782       	5         	0         	5              	DUP       
chr11       	68207057    	68208264    	68207045       	68208276       	24        	0         	24             	DUP       
chr11       	68515149    	68644092    	68515149       	68644090       	9         	0         	9              	DUP       
chr11       	69030153    	69030254    	69030155       	69030254       	0         	6         	6              	DEL       
chr11       	69586071    	69586634    	69586075       	69586634       	7         	3         	10             	DEL       
chr11       	72150552    	72150868    	72150565       	72150868       	1         	18        	19             	DEL       
chr11       	73998979    	73999168    	73998969       	73999180       	0         	7         	7              	DUP       
chr11       	74434011    	74434359    	74434026       	74434359       	1         	14        	15             	DEL       
chr11       	74821358    	74821678    	74821378       	74821678       	0         	9         	9              	DEL       
chr11       	81845128    	81845496    	81845141       	81845496       	5         	24        	29             	DEL       
chr11       	85906765    	85907002    	85906766       	85907002       	0         	7         	7              	DEL       
chr11       	87154811    	87154979    	87154812       	87154982       	0         	16        	16             	DUP       
chr11       	90199344    	90199684    	90199354       	90199684       	0         	6         	6              	DEL       
chr11       	90834904    	90837905    	90834908       	90837905       	24        	9         	33             	DEL       
chr11       	92076615    	92094525    	92076615       	92094523       	12        	0         	12             	DUP       
chr11       	92076615    	92094525    	92077210       	92095271       	8         	0         	8              	DEL       
chr11       	92077211    	92095272    	92076615       	92094523       	12        	0         	12             	DUP       
chr11       	92077211    	92095272    	92077210       	92095271       	8         	0         	8              	DEL       
chr11       	92512830    	92513135    	92512840       	92513135       	3         	14        	17             	DEL       
chr11       	93287972    	93288994    	93287973       	93288994       	16        	4         	20             	DEL       
chr11       	93369633    	93369952    	93369649       	93369952       	2         	25        	27             	DEL       
chr11       	93844837    	93845047    	93844838       	93845047       	0         	15        	15             	DEL       
chr11       	93946062    	93948257    	93946078       	93948257       	50        	25        	75             	DEL       
chr11       	95436214    	95442267    	95436216       	95442256       	22        	4         	26             	DEL       
chr11       	96566177    	96566364    	96566178       	96566364       	0         	8         	8              	DEL       
chr11       	96635179    	96635248    	96635191       	96635250       	0         	8         	8              	DEL       
chr11       	96743758    	96744086    	96743773       	96744086       	2         	11        	13             	DEL       
chr11       	98241288    	98241361    	98241292       	98241361       	0         	11        	11             	DEL       
chr11       	98393873    	98398133    	98393869       	98398258       	14        	0         	14             	DEL       
chr11       	98393873    	98398133    	98395806       	98398883       	10        	0         	10             	DUP       
chr11       	98393873    	98398133    	98396040       	98399203       	11        	0         	11             	DEL       
chr11       	98395806    	98398885    	98393869       	98398258       	14        	0         	14             	DEL       
chr11       	98395806    	98398885    	98395806       	98398883       	10        	0         	10             	DUP       
chr11       	98395806    	98398885    	98396040       	98399203       	11        	0         	11             	DEL       
chr11       	98396172    	98399330    	98393869       	98398258       	14        	0         	14             	DEL       
chr11       	98396172    	98399330    	98395806       	98398883       	10        	0         	10             	DUP       
chr11       	98396172    	98399330    	98396040       	98399203       	11        	0         	11             	DEL       
chr11       	99314726    	99315967    	99314726       	99315967       	24        	0         	24             	DEL       
chr11       	99314726    	99315967    	99314727       	99316041       	5         	11        	16             	INV       
chr11       	99314723    	99316041    	99314726       	99315967       	24        	0         	24             	DEL       
chr11       	99314723    	99316041    	99314727       	99316041       	5         	11        	16             	INV       
chr11       	99405590    	99405931    	99405607       	99405931       	5         	6         	11             	DEL       
chr11       	102601114   	102601431   	102601127      	102601431      	0         	12        	12             	DEL       
chr11       	102880373   	102882072   	102880400      	102882072      	9         	11        	20             	DEL       
chr11       	103217198   	103217355   	103217215      	103217355      	0         	19        	19             	DEL       
chr11       	103540092   	103540406   	103540103      	103540406      	2         	21        	23             	DEL       
chr11       	104045648   	104047741   	104045647      	104047740      	4         	0         	4              	DEL       
chr11       	104139754   	104140101   	104139755      	104140089      	3         	15        	18             	DEL       
chr11       	104309651   	104309996   	104309666      	104309995      	6         	18        	24             	DEL       
chr11       	105524325   	105524524   	105524331      	105524523      	0         	26        	26             	DUP       
chr11       	106443138   	106443279   	106443139      	106443279      	6         	0         	6              	INV       
chr11       	106725141   	106725440   	106725154      	106725440      	0         	10        	10             	DEL       
chr11       	106915511   	106918846   	106915512      	106918846      	22        	11        	33             	DEL       
chr11       	107281170   	107298560   	107281169      	107298558      	15        	0         	15             	INV       
chr11       	110060192   	110060268   	110060195      	110060268      	0         	11        	11             	DEL       
chr11       	110105973   	110106300   	110105987      	110106300      	2         	22        	24             	DEL       
chr11       	110156112   	110156166   	110156113      	110156169      	0         	17        	17             	DEL       
chr11       	111224000   	111224069   	111224001      	111224069      	0         	4         	4              	DEL       
chr11       	112747019   	112747425   	112747020      	112747425      	1         	9         	10             	DEL       
chr11       	114526437   	114526508   	114526440      	114526508      	0         	9         	9              	DEL       
chr11       	116812238   	116812539   	116812239      	116812539      	9         	0         	9              	INV       
chr11       	118421849   	118423215   	118421919      	118423110      	6         	0         	6              	DUP       
chr11       	120061466   	120061951   	120061467      	120061951      	1         	4         	5              	DUP       
chr11       	120061466   	120061951   	120061583      	120061947      	0         	6         	6              	DEL       
chr11       	122476867   	122478572   	122476876      	122478572      	27        	7         	34             	DEL       
chr11       	122724597   	122724652   	122724600      	122724652      	0         	8         	8              	DEL       
chr11       	124960241   	124960350   	124960255      	124960350      	1         	26        	27             	DEL       
chr11       	126320092   	126320603   	126320093      	126320603      	0         	4         	4              	DEL       
chr11       	127586402   	127586537   	127586405      	127586537      	1         	8         	9              	DEL       
chr11       	127879645   	127881689   	127879647      	127881689      	22        	7         	29             	DEL       
chr11       	128173069   	128173397   	128173078      	128173388      	0         	14        	14             	DEL       
chr11       	128812820   	128813515   	128812821      	128813515      	14        	7         	21             	DEL       
chr11       	129143071   	129145383   	129143072      	129145383      	26        	10        	36             	DUP       
chr11       	129143071   	129145383   	129143620      	129145387      	25        	9         	34             	DEL       
chr11       	129143619   	129145387   	129143072      	129145383      	26        	10        	36             	DUP       
chr11       	129143619   	129145387   	129143620      	129145387      	25        	9         	34             	DEL       
chr11       	130626501   	130626747   	130626502      	130626747      	1         	8         	9              	DEL       
chr11       	132213717   	132214032   	132213732      	132214032      	1         	16        	17             	DEL       
chr11       	134735292   	134735923   	134735293      	134735923      	11        	0         	11             	DEL       
chr11       	134934966   	134936116   	134934967      	134936116      	5         	0         	5              	DEL       
chr12       	183061      	188799      	183064         	188799         	13        	6         	19             	DEL       
chr12       	919663      	920425      	919664         	920425         	13        	0         	13             	DEL       
chr12       	1085066     	1090795     	1085065        	1090794        	5         	0         	5              	DEL       
chr12       	1121664     	1122547     	1121673        	1122603        	11        	0         	11             	DEL       
chr12       	1293119     	1293505     	1293120        	1293505        	9         	0         	9              	DEL       
chr12       	4732054     	4732131     	4732066        	4732131        	0         	15        	15             	DEL       
chr12       	4973091     	4973958     	4973092        	4973958        	17        	0         	17             	DEL       
chr12       	6132269     	6138911     	6132272        	6138911        	18        	12        	30             	DEL       
chr12       	6428990     	6429632     	6428991        	6429632        	4         	0         	4              	DEL       
chr12       	7083332     	7083650     	7083333        	7083650        	1         	3         	4              	DUP       
chr12       	7083332     	7083650     	7083649        	7084650        	34        	0         	34             	DEL       
chr12       	7083593     	7084898     	7083333        	7083650        	1         	3         	4              	DUP       
chr12       	7083593     	7084898     	7083649        	7084650        	34        	0         	34             	DEL       
chr12       	7670046     	7671725     	7670055        	7671854        	11        	0         	11             	DEL       
chr12       	7680229     	7680354     	7680234        	7680354        	0         	9         	9              	DEL       
chr12       	7798664     	7905579     	7816082        	7816403        	1         	8         	9              	DEL       
chr12       	7798664     	7905579     	7799074        	7905817        	10        	0         	10             	DUP       
chr12       	7798664     	7905579     	7798663        	7905578        	14        	0         	14             	DEL       
chr12       	7799074     	7905819     	7816082        	7816403        	1         	8         	9              	DEL       
chr12       	7799074     	7905819     	7799074        	7905817        	10        	0         	10             	DUP       
chr12       	7799074     	7905819     	7798663        	7905578        	14        	0         	14             	DEL       
chr12       	7816065     	7816403     	7816082        	7816403        	1         	8         	9              	DEL       
chr12       	7979721     	7980592     	7979722        	7980592        	4         	0         	4              	DEL       
chr12       	8423220     	8443873     	8423220        	8443871        	19        	0         	19             	DUP       
chr12       	8423220     	8443873     	8423462        	8444181        	11        	0         	11             	DEL       
chr12       	8423463     	8444182     	8423220        	8443871        	19        	0         	19             	DUP       
chr12       	8423463     	8444182     	8423462        	8444181        	11        	0         	11             	DEL       
chr12       	8472981     	8473293     	8472996        	8473293        	2         	5         	7              	DEL       
chr12       	8864243     	8865271     	8864256        	8865271        	35        	0         	35             	DEL       
chr12       	10423270    	10438600    	10423270       	10438598       	7         	0         	7              	DUP       
chr12       	10589054    	10589142    	10589058       	10589142       	0         	13        	13             	DEL       
chr12       	10660466    	10660640    	10660468       	10660639       	1         	8         	9              	DEL       
chr12       	10915446    	10915700    	10915447       	10915700       	0         	10        	10             	DEL       
chr12       	11055011    	11083411    	11055010       	11083410       	4         	0         	4              	DEL       
chr12       	12378535    	12389566    	12378539       	12389566       	16        	0         	16             	DEL       
chr12       	12391922    	12393687    	12391998       	12393687       	68        	0         	68             	INV       
chr12       	12864699    	12865014    	12864714       	12865014       	1         	5         	6              	DEL       
chr12       	13046133    	13046238    	13046153       	13046238       	0         	5         	5              	DEL       
chr12       	14105666    	14105998    	14105686       	14105998       	1         	7         	8              	DEL       
chr12       	15360702    	15361013    	15360723       	15361019       	0         	10        	10             	DEL       
chr12       	16267188    	16268349    	16267189       	16268349       	23        	6         	29             	DEL       
chr12       	17291890    	17293003    	17291893       	17293003       	38        	19        	57             	DEL       
chr12       	17741226    	17741454    	17741236       	17741454       	1         	26        	27             	DEL       
chr12       	20709584    	20709923    	20709600       	20709923       	1         	18        	19             	DEL       
chr12       	21894538    	21894641    	21894541       	21894641       	0         	11        	11             	DEL       
chr12       	25106654    	25107642    	25106655       	25107642       	14        	0         	14             	INV       
chr12       	25517085    	25517557    	25517052       	25517728       	4         	0         	4              	DEL       
chr12       	25590143    	25591138    	25590144       	25591139       	29        	6         	35             	DUP       
chr12       	26358086    	26358419    	26358104       	26358419       	1         	18        	19             	DEL       
chr12       	27281053    	27281385    	27281070       	27281385       	1         	8         	9              	DEL       
chr12       	28670562    	28670645    	28670565       	28670645       	0         	11        	11             	DEL       
chr12       	29420473    	29420815    	29420487       	29420815       	4         	15        	19             	DEL       
chr12       	30218383    	30218809    	30218384       	30218809       	4         	10        	14             	DEL       
chr12       	30347402    	30347492    	30347406       	30347492       	0         	7         	7              	DEL       
chr12       	30355253    	30355701    	30355254       	30355701       	3         	8         	11             	DEL       
chr12       	32717220    	32717640    	32717229       	32717971       	5         	0         	5              	DEL       
chr12       	32810664    	32810980    	32810681       	32810980       	1         	10        	11             	DEL       
chr12       	34019464    	38313730    	34384610       	34386999       	15        	4         	19             	DEL       
chr12       	34019464    	38313730    	34674081       	34674214       	0         	8         	8              	DEL       
chr12       	34019464    	38313730    	34680767       	34681323       	8         	0         	8              	DUP       
chr12       	34019464    	38313730    	34797581       	34804198       	4         	0         	4              	DEL       
chr12       	34019464    	38313730    	35345902       	35816590       	4         	0         	4              	DEL       
chr12       	34019464    	38313730    	35065484       	36036067       	15        	0         	15             	DEL       
chr12       	34019464    	38313730    	34817054       	36313067       	11        	0         	11             	DUP       
chr12       	34019464    	38313730    	35303238       	36318815       	7         	0         	7              	DEL       
chr12       	34019464    	38313730    	36441986       	36481079       	9         	0         	9              	DEL       
chr12       	34019464    	38313730    	34883852       	36481305       	4         	0         	4              	DUP       
chr12       	34019464    	38313730    	36319005       	36539072       	5         	0         	5              	DEL       
chr12       	34019464    	38313730    	36312713       	36625163       	20        	0         	20             	DUP       
chr12       	34019464    	38313730    	35981682       	36914969       	5         	0         	5              	DUP       
chr12       	34019464    	38313730    	35346165       	36940936       	8         	0         	8              	DEL       
chr12       	34019464    	38313730    	36713098       	37026327       	4         	0         	4              	DEL       
chr12       	34019464    	38313730    	36543302       	37026271       	4         	0         	4              	DEL       
chr12       	34019464    	38313730    	34832592       	37250785       	7         	0         	7              	DUP       
chr12       	34019464    	38313730    	37253918       	37255302       	27        	0         	27             	DUP       
chr12       	34019464    	38313730    	37254187       	37260209       	4         	0         	4              	DEL       
chr12       	34019464    	38313730    	37264661       	37266754       	19        	0         	19             	DUP       
chr12       	34019464    	38313730    	37324119       	37324957       	28        	2         	30             	DEL       
chr12       	34019464    	38313730    	37333222       	37334766       	20        	0         	20             	DEL       
chr12       	34019464    	38313730    	37361796       	37362716       	5         	0         	5              	DEL       
chr12       	34019464    	38313730    	37756988       	37758309       	30        	0         	30             	DEL       
chr12       	34019464    	38313730    	34019229       	38313250       	4         	0         	4              	DUP       
chr12       	34019464    	38313730    	34019463       	38313729       	8         	0         	8              	DEL       
chr12       	34384597    	34387011    	34384610       	34386999       	15        	4         	19             	DEL       
chr12       	34674077    	34674214    	34674081       	34674214       	0         	8         	8              	DEL       
chr12       	34680767    	34681340    	34680767       	34681323       	8         	0         	8              	DUP       
chr12       	34797580    	34804198    	34797581       	34804198       	4         	0         	4              	DEL       
chr12       	34817053    	36313067    	35345902       	35816590       	4         	0         	4              	DEL       
chr12       	34817053    	36313067    	35065484       	36036067       	15        	0         	15             	DEL       
chr12       	34817053    	36313067    	34817054       	36313067       	11        	0         	11             	DUP       
chr12       	34817053    	36313067    	35303238       	36318815       	7         	0         	7              	DEL       
chr12       	34817053    	36313067    	34883852       	36481305       	4         	0         	4              	DUP       
chr12       	34817053    	36313067    	36312713       	36625163       	20        	0         	20             	DUP       
chr12       	34817053    	36313067    	35981682       	36914969       	5         	0         	5              	DUP       
chr12       	34817053    	36313067    	35346165       	36940936       	8         	0         	8              	DEL       
chr12       	34817053    	36313067    	34832592       	37250785       	7         	0         	7              	DUP       
chr12       	34832591    	37250785    	35345902       	35816590       	4         	0         	4              	DEL       
chr12       	34832591    	37250785    	35065484       	36036067       	15        	0         	15             	DEL       
chr12       	34832591    	37250785    	34817054       	36313067       	11        	0         	11             	DUP       
chr12       	34832591    	37250785    	35303238       	36318815       	7         	0         	7              	DEL       
chr12       	34832591    	37250785    	36441986       	36481079       	9         	0         	9              	DEL       
chr12       	34832591    	37250785    	34883852       	36481305       	4         	0         	4              	DUP       
chr12       	34832591    	37250785    	36319005       	36539072       	5         	0         	5              	DEL       
chr12       	34832591    	37250785    	36312713       	36625163       	20        	0         	20             	DUP       
chr12       	34832591    	37250785    	35981682       	36914969       	5         	0         	5              	DUP       
chr12       	34832591    	37250785    	35346165       	36940936       	8         	0         	8              	DEL       
chr12       	34832591    	37250785    	36713098       	37026327       	4         	0         	4              	DEL       
chr12       	34832591    	37250785    	36543302       	37026271       	4         	0         	4              	DEL       
chr12       	34832591    	37250785    	34832592       	37250785       	7         	0         	7              	DUP       
chr12       	34883851    	36481305    	35345902       	35816590       	4         	0         	4              	DEL       
chr12       	34883851    	36481305    	35065484       	36036067       	15        	0         	15             	DEL       
chr12       	34883851    	36481305    	34817054       	36313067       	11        	0         	11             	DUP       
chr12       	34883851    	36481305    	35303238       	36318815       	7         	0         	7              	DEL       
chr12       	34883851    	36481305    	36441986       	36481079       	9         	0         	9              	DEL       
chr12       	34883851    	36481305    	34883852       	36481305       	4         	0         	4              	DUP       
chr12       	34883851    	36481305    	36319005       	36539072       	5         	0         	5              	DEL       
chr12       	34883851    	36481305    	36312713       	36625163       	20        	0         	20             	DUP       
chr12       	34883851    	36481305    	35981682       	36914969       	5         	0         	5              	DUP       
chr12       	34883851    	36481305    	35346165       	36940936       	8         	0         	8              	DEL       
chr12       	35065483    	36036067    	35345902       	35816590       	4         	0         	4              	DEL       
chr12       	35065483    	36036067    	35065484       	36036067       	15        	0         	15             	DEL       
chr12       	35065483    	36036067    	35303238       	36318815       	7         	0         	7              	DEL       
chr12       	35065483    	36036067    	35981682       	36914969       	5         	0         	5              	DUP       
chr12       	35065483    	36036067    	35346165       	36940936       	8         	0         	8              	DEL       
chr12       	35303237    	36318815    	35345902       	35816590       	4         	0         	4              	DEL       
chr12       	35303237    	36318815    	35065484       	36036067       	15        	0         	15             	DEL       
chr12       	35303237    	36318815    	34817054       	36313067       	11        	0         	11             	DUP       
chr12       	35303237    	36318815    	35303238       	36318815       	7         	0         	7              	DEL       
chr12       	35303237    	36318815    	36312713       	36625163       	20        	0         	20             	DUP       
chr12       	35303237    	36318815    	35981682       	36914969       	5         	0         	5              	DUP       
chr12       	35303237    	36318815    	35346165       	36940936       	8         	0         	8              	DEL       
chr12       	35345901    	35816590    	35345902       	35816590       	4         	0         	4              	DEL       
chr12       	35345901    	35816590    	35346165       	36940936       	8         	0         	8              	DEL       
chr12       	35346164    	36940936    	35345902       	35816590       	4         	0         	4              	DEL       
chr12       	35346164    	36940936    	35065484       	36036067       	15        	0         	15             	DEL       
chr12       	35346164    	36940936    	34817054       	36313067       	11        	0         	11             	DUP       
chr12       	35346164    	36940936    	35303238       	36318815       	7         	0         	7              	DEL       
chr12       	35346164    	36940936    	36441986       	36481079       	9         	0         	9              	DEL       
chr12       	35346164    	36940936    	34883852       	36481305       	4         	0         	4              	DUP       
chr12       	35346164    	36940936    	36319005       	36539072       	5         	0         	5              	DEL       
chr12       	35346164    	36940936    	36312713       	36625163       	20        	0         	20             	DUP       
chr12       	35346164    	36940936    	35981682       	36914969       	5         	0         	5              	DUP       
chr12       	35346164    	36940936    	35346165       	36940936       	8         	0         	8              	DEL       
chr12       	35346164    	36940936    	36713098       	37026327       	4         	0         	4              	DEL       
chr12       	35346164    	36940936    	36543302       	37026271       	4         	0         	4              	DEL       
chr12       	35981681    	36914969    	35065484       	36036067       	15        	0         	15             	DEL       
chr12       	35981681    	36914969    	34817054       	36313067       	11        	0         	11             	DUP       
chr12       	35981681    	36914969    	35303238       	36318815       	7         	0         	7              	DEL       
chr12       	35981681    	36914969    	36441986       	36481079       	9         	0         	9              	DEL       
chr12       	35981681    	36914969    	34883852       	36481305       	4         	0         	4              	DUP       
chr12       	35981681    	36914969    	36319005       	36539072       	5         	0         	5              	DEL       
chr12       	35981681    	36914969    	36312713       	36625163       	20        	0         	20             	DUP       
chr12       	35981681    	36914969    	35981682       	36914969       	5         	0         	5              	DUP       
chr12       	35981681    	36914969    	36713098       	37026327       	4         	0         	4              	DEL       
chr12       	35981681    	36914969    	36543302       	37026271       	4         	0         	4              	DEL       
chr12       	36312572    	36625266    	34817054       	36313067       	11        	0         	11             	DUP       
chr12       	36312572    	36625266    	35303238       	36318815       	7         	0         	7              	DEL       
chr12       	36312572    	36625266    	36441986       	36481079       	9         	0         	9              	DEL       
chr12       	36312572    	36625266    	34883852       	36481305       	4         	0         	4              	DUP       
chr12       	36312572    	36625266    	36319005       	36539072       	5         	0         	5              	DEL       
chr12       	36312572    	36625266    	36312713       	36625163       	20        	0         	20             	DUP       
chr12       	36312572    	36625266    	36543302       	37026271       	4         	0         	4              	DEL       
chr12       	36442055    	36480879    	36441986       	36481079       	9         	0         	9              	DEL       
chr12       	36543301    	37026271    	36312713       	36625163       	20        	0         	20             	DUP       
chr12       	36543301    	37026271    	35981682       	36914969       	5         	0         	5              	DUP       
chr12       	36543301    	37026271    	35346165       	36940936       	8         	0         	8              	DEL       
chr12       	36543301    	37026271    	36713098       	37026327       	4         	0         	4              	DEL       
chr12       	36543301    	37026271    	36543302       	37026271       	4         	0         	4              	DEL       
chr12       	36713097    	37026327    	35981682       	36914969       	5         	0         	5              	DUP       
chr12       	36713097    	37026327    	35346165       	36940936       	8         	0         	8              	DEL       
chr12       	36713097    	37026327    	36713098       	37026327       	4         	0         	4              	DEL       
chr12       	36713097    	37026327    	36543302       	37026271       	4         	0         	4              	DEL       
chr12       	37253973    	37255125    	37253918       	37255302       	27        	0         	27             	DUP       
chr12       	37253973    	37255125    	37254187       	37260209       	4         	0         	4              	DEL       
chr12       	37264661    	37266756    	37264661       	37266754       	19        	0         	19             	DUP       
chr12       	37324438    	37325628    	37324119       	37324957       	28        	2         	30             	DEL       
chr12       	37333293    	37334650    	37333222       	37334766       	20        	0         	20             	DEL       
chr12       	37756988    	37758351    	37756988       	37758309       	30        	0         	30             	DEL       
chr12       	39466249    	39466497    	39466253       	39466530       	26        	22        	48             	INV       
chr12       	39613086    	39613414    	39613103       	39613414       	1         	5         	6              	DEL       
chr12       	40471166    	40471289    	40471168       	40471289       	0         	16        	16             	DEL       
chr12       	40483641    	40486478    	40483642       	40486478       	5         	0         	5              	DEL       
chr12       	40789392    	40789699    	40789394       	40789699       	2         	24        	26             	DEL       
chr12       	41266013    	41266331    	41266029       	41266331       	2         	26        	28             	DEL       
chr12       	41363634    	41363723    	41363635       	41363723       	0         	14        	14             	DEL       
chr12       	41844250    	41845075    	41844268       	41845075       	52        	33        	85             	DEL       
chr12       	43583645    	43585746    	43583657       	43585746       	31        	15        	46             	DEL       
chr12       	45509369    	45516156    	45509370       	45516156       	25        	10        	35             	DEL       
chr12       	45554572    	45554661    	45554593       	45554661       	0         	9         	9              	DEL       
chr12       	46681566    	46681915    	46681583       	46681915       	4         	25        	29             	DEL       
chr12       	48314884    	48317083    	48314789       	48317113       	18        	0         	18             	DEL       
chr12       	48331682    	48334598    	48331698       	48334597       	48        	17        	65             	DEL       
chr12       	49076265    	49076837    	49076266       	49076837       	6         	0         	6              	DEL       
chr12       	49315391    	49316741    	49315460       	49316741       	17        	0         	17             	DEL       
chr12       	49788821    	49789141    	49788820       	49789148       	24        	0         	24             	INV       
chr12       	51403104    	51403157    	51403106       	51403157       	0         	9         	9              	DEL       
chr12       	52692551    	52693917    	52692555       	52693917       	27        	11        	38             	DEL       
chr12       	53851622    	53851912    	53851638       	53851912       	0         	18        	18             	DEL       
chr12       	58852611    	58859912    	58852225       	58859487       	4         	0         	4              	DEL       
chr12       	58852611    	58859912    	58852625       	58859751       	14        	0         	14             	DUP       
chr12       	59541995    	59552864    	59541994       	59552863       	7         	0         	7              	DEL       
chr12       	59541995    	59552864    	59542015       	59559078       	10        	5         	15             	DEL       
chr12       	59541995    	59552864    	59552851       	59559206       	5         	7         	12             	DUP       
chr12       	59542012    	59559078    	59541994       	59552863       	7         	0         	7              	DEL       
chr12       	59542012    	59559078    	59542015       	59559078       	10        	5         	15             	DEL       
chr12       	59542012    	59559078    	59552851       	59559206       	5         	7         	12             	DUP       
chr12       	59552850    	59559206    	59541994       	59552863       	7         	0         	7              	DEL       
chr12       	59552850    	59559206    	59542015       	59559078       	10        	5         	15             	DEL       
chr12       	59552850    	59559206    	59552851       	59559206       	5         	7         	12             	DUP       
chr12       	60018563    	60019727    	60018568       	60019727       	15        	6         	21             	DEL       
chr12       	60128057    	60131254    	60128064       	60131254       	21        	7         	28             	DEL       
chr12       	61213331    	61213448    	61213334       	61213448       	0         	7         	7              	DEL       
chr12       	61901249    	61901436    	61901264       	61901436       	0         	25        	25             	DEL       
chr12       	63545456    	63740215    	63552952       	63553176       	1         	10        	11             	DEL       
chr12       	63545456    	63740215    	63545051       	63739980       	4         	0         	4              	DUP       
chr12       	63552948    	63553176    	63552952       	63553176       	1         	10        	11             	DEL       
chr12       	64667145    	64669485    	64667149       	64669485       	21        	12        	33             	DEL       
chr12       	64741046    	64741223    	64741063       	64741223       	1         	9         	10             	DEL       
chr12       	65424999    	65425174    	65425000       	65425174       	30        	0         	30             	INV       
chr12       	66133854    	66136096    	66133871       	66136096       	24        	13        	37             	DEL       
chr12       	66284744    	66284821    	66284748       	66284821       	0         	10        	10             	DEL       
chr12       	69153640    	118295196   	80454425       	80461889       	15        	0         	15             	INV       
chr12       	69153640    	118295196   	70201084       	70203797       	36        	14        	50             	DEL       
chr12       	69153640    	118295196   	71208581       	71210693       	40        	21        	61             	DEL       
chr12       	69153640    	118295196   	71795379       	71796793       	19        	8         	27             	DEL       
chr12       	69153640    	118295196   	71962862       	71964332       	44        	0         	44             	DEL       
chr12       	69153640    	118295196   	72583926       	72584072       	2         	9         	11             	DEL       
chr12       	69153640    	118295196   	74178030       	74178241       	0         	5         	5              	DEL       
chr12       	69153640    	118295196   	74278451       	74278882       	0         	6         	6              	DEL       
chr12       	69153640    	118295196   	74278472       	74278903       	0         	5         	5              	DEL       
chr12       	69153640    	118295196   	74571146       	74571261       	0         	7         	7              	DEL       
chr12       	69153640    	118295196   	77690692       	77690763       	8         	7         	15             	INV       
chr12       	69153640    	118295196   	77982218       	77982403       	0         	4         	4              	DEL       
chr12       	69153640    	118295196   	78142680       	78142737       	0         	11        	11             	DEL       
chr12       	69153640    	118295196   	79761109       	79769028       	22        	5         	27             	DUP       
chr12       	69153640    	118295196   	80220581       	80220755       	0         	10        	10             	DEL       
chr12       	69153640    	118295196   	82365707       	82365814       	1         	6         	7              	DEL       
chr12       	69153640    	118295196   	83648505       	83648803       	1         	18        	19             	DEL       
chr12       	69153640    	118295196   	84090714       	84091021       	0         	30        	30             	DEL       
chr12       	69153640    	118295196   	84199335       	84202232       	35        	9         	44             	DEL       
chr12       	69153640    	118295196   	84221216       	84221327       	0         	9         	9              	DEL       
chr12       	69153640    	118295196   	84878784       	84879842       	27        	12        	39             	DEL       
chr12       	69153640    	118295196   	86129546       	86129857       	3         	11        	14             	DEL       
chr12       	69153640    	118295196   	86810991       	86811832       	23        	0         	23             	DEL       
chr12       	69153640    	118295196   	86811176       	86812162       	16        	0         	16             	DUP       
chr12       	69153640    	118295196   	90093237       	90097917       	12        	0         	12             	DEL       
chr12       	69153640    	118295196   	90238492       	90238549       	0         	9         	9              	DEL       
chr12       	69153640    	118295196   	90452612       	90452799       	1         	24        	25             	DEL       
chr12       	69153640    	118295196   	90831753       	90833460       	14        	8         	22             	DUP       
chr12       	69153640    	118295196   	93451001       	93452846       	36        	6         	42             	DUP       
chr12       	69153640    	118295196   	93964568       	93964864       	1         	19        	20             	DEL       
chr12       	69153640    	118295196   	94850250       	94850671       	8         	18        	26             	DEL       
chr12       	69153640    	118295196   	94950292       	94950590       	1         	27        	28             	DEL       
chr12       	69153640    	118295196   	95194632       	95195843       	6         	0         	6              	DEL       
chr12       	69153640    	118295196   	95616680       	95618638       	23        	10        	33             	DEL       
chr12       	69153640    	118295196   	95839814       	95842549       	41        	28        	69             	DEL       
chr12       	69153640    	118295196   	95946577       	95949176       	18        	8         	26             	DEL       
chr12       	69153640    	118295196   	97160963       	97161277       	1         	15        	16             	DEL       
chr12       	69153640    	118295196   	97308022       	97308089       	0         	7         	7              	DEL       
chr12       	69153640    	118295196   	103899629      	103899945      	2         	19        	21             	DEL       
chr12       	69153640    	118295196   	25803811       	103980011      	4         	0         	4              	DUP       
chr12       	69153640    	118295196   	105379747      	105380060      	1         	7         	8              	DEL       
chr12       	69153640    	118295196   	113091444      	113091610      	0         	9         	9              	DUP       
chr12       	69153640    	118295196   	113245316      	113245625      	0         	4         	4              	DEL       
chr12       	69153640    	118295196   	113450589      	113451467      	10        	0         	10             	DEL       
chr12       	69153640    	118295196   	114290527      	114290593      	0         	20        	20             	DEL       
chr12       	69153640    	118295196   	114585963      	114586023      	0         	8         	8              	DEL       
chr12       	69153640    	118295196   	115639640      	115642096      	8         	7         	15             	DUP       
chr12       	69153640    	118295196   	115639720      	115642100      	10        	14        	24             	DEL       
chr12       	69153640    	118295196   	69153621       	118295134      	4         	0         	4              	DUP       
chr12       	70201065    	70203797    	70201084       	70203797       	36        	14        	50             	DEL       
chr12       	71208576    	71210693    	71208581       	71210693       	40        	21        	61             	DEL       
chr12       	71795377    	71796793    	71795379       	71796793       	19        	8         	27             	DEL       
chr12       	71962795    	71964360    	71962862       	71964332       	44        	0         	44             	DEL       
chr12       	72583916    	72584080    	72583926       	72584072       	2         	9         	11             	DEL       
chr12       	74178027    	74178241    	74178030       	74178241       	0         	5         	5              	DEL       
chr12       	74278441    	74278883    	74278451       	74278882       	0         	6         	6              	DEL       
chr12       	74278441    	74278883    	74278472       	74278903       	0         	5         	5              	DEL       
chr12       	74571145    	74571261    	74571146       	74571261       	0         	7         	7              	DEL       
chr12       	77690691    	77690763    	77690692       	77690763       	8         	7         	15             	INV       
chr12       	77982217    	77982403    	77982218       	77982403       	0         	4         	4              	DEL       
chr12       	78142676    	78142737    	78142680       	78142737       	0         	11        	11             	DEL       
chr12       	79761108    	79768989    	79761109       	79769028       	22        	5         	27             	DUP       
chr12       	80220578    	80220755    	80220581       	80220755       	0         	10        	10             	DEL       
chr12       	80454415    	80461888    	80454425       	80461889       	15        	0         	15             	INV       
chr12       	82365703    	82365814    	82365707       	82365814       	1         	6         	7              	DEL       
chr12       	83648489    	83648803    	83648505       	83648803       	1         	18        	19             	DEL       
chr12       	84090704    	84091021    	84090714       	84091021       	0         	30        	30             	DEL       
chr12       	84199328    	84202232    	84199335       	84202232       	35        	9         	44             	DEL       
chr12       	84221197    	84221326    	84221216       	84221327       	0         	9         	9              	DEL       
chr12       	84878779    	84879842    	84878784       	84879842       	27        	12        	39             	DEL       
chr12       	86129536    	86129857    	86129546       	86129857       	3         	11        	14             	DEL       
chr12       	86810668    	86811728    	86810991       	86811832       	23        	0         	23             	DEL       
chr12       	86810668    	86811728    	86811176       	86812162       	16        	0         	16             	DUP       
chr12       	86811198    	86812291    	86810991       	86811832       	23        	0         	23             	DEL       
chr12       	86811198    	86812291    	86811176       	86812162       	16        	0         	16             	DUP       
chr12       	90093274    	90097918    	90093237       	90097917       	12        	0         	12             	DEL       
chr12       	90238491    	90238549    	90238492       	90238549       	0         	9         	9              	DEL       
chr12       	90452594    	90452800    	90452612       	90452799       	1         	24        	25             	DEL       
chr12       	90831752    	90833460    	90831753       	90833460       	14        	8         	22             	DUP       
chr12       	93451019    	93452830    	93451001       	93452846       	36        	6         	42             	DUP       
chr12       	93964551    	93964864    	93964568       	93964864       	1         	19        	20             	DEL       
chr12       	94850247    	94850671    	94850250       	94850671       	8         	18        	26             	DEL       
chr12       	94950279    	94950590    	94950292       	94950590       	1         	27        	28             	DEL       
chr12       	95616676    	95618638    	95616680       	95618638       	23        	10        	33             	DEL       
chr12       	95839802    	95842550    	95839814       	95842549       	41        	28        	69             	DEL       
chr12       	95946566    	95949177    	95946577       	95949176       	18        	8         	26             	DEL       
chr12       	97160948    	97161277    	97160963       	97161277       	1         	15        	16             	DEL       
chr12       	97308020    	97308089    	97308022       	97308089       	0         	7         	7              	DEL       
chr12       	103899616   	103899946   	103899629      	103899945      	2         	19        	21             	DEL       
chr12       	105379735   	105380060   	105379747      	105380060      	1         	7         	8              	DEL       
chr12       	113091443   	113091602   	113091444      	113091610      	0         	9         	9              	DUP       
chr12       	113245305   	113245625   	113245316      	113245625      	0         	4         	4              	DEL       
chr12       	113450588   	113451467   	113450589      	113451467      	10        	0         	10             	DEL       
chr12       	114290526   	114290593   	114290527      	114290593      	0         	20        	20             	DEL       
chr12       	114585959   	114586023   	114585963      	114586023      	0         	8         	8              	DEL       
chr12       	115639640   	115642092   	115639640      	115642096      	8         	7         	15             	DUP       
chr12       	115639640   	115642092   	115639720      	115642100      	10        	14        	24             	DEL       
chr12       	115639720   	115642214   	115639640      	115642096      	8         	7         	15             	DUP       
chr12       	115639720   	115642214   	115639720      	115642100      	10        	14        	24             	DEL       
chr12       	120442145   	121624040   	120442145      	121624038      	7         	0         	7              	DUP       
chr12       	121851676   	121852023   	121851690      	121852022      	2         	7         	9              	DEL       
chr12       	122525790   	122526120   	122525799      	122526120      	4         	21        	25             	DEL       
chr12       	123973304   	124011551   	124011442      	124011543      	0         	5         	5              	DEL       
chr12       	123973304   	124011551   	123974020      	124011377      	8         	1         	9              	DEL       
chr12       	124011438   	124011543   	124011442      	124011543      	0         	5         	5              	DEL       
chr12       	124011438   	124011543   	123974020      	124011377      	8         	1         	9              	DEL       
chr12       	124311269   	124311390   	124311274      	124311390      	0         	5         	5              	DEL       
chr12       	124948785   	124948868   	124948788      	124948868      	0         	9         	9              	DEL       
chr12       	125204245   	125205099   	125204246      	125205099      	4         	0         	4              	DEL       
chr12       	125307655   	125308030   	125307656      	125308030      	9         	0         	9              	INV       
chr12       	126298956   	126305051   	126298971      	126305051      	18        	8         	26             	DEL       
chr12       	126340854   	126340946   	126340858      	126340946      	0         	5         	5              	DEL       
chr12       	126420554   	126420869   	126420570      	126420869      	1         	8         	9              	DEL       
chr12       	126715401   	126715741   	126715417      	126715741      	1         	10        	11             	DEL       
chr12       	127018091   	127018323   	127018092      	127018307      	1         	6         	7              	DEL       
chr12       	127175880   	127176207   	127175897      	127176207      	1         	20        	21             	DEL       
chr12       	127462720   	127462773   	127462723      	127462773      	0         	4         	4              	DEL       
chr12       	127553431   	127553749   	127553449      	127553749      	4         	24        	28             	DEL       
chr12       	129356142   	129356456   	129356152      	129356456      	1         	4         	5              	DEL       
chr12       	129388334   	129389080   	129388335      	129389080      	12        	0         	12             	DEL       
chr12       	129575741   	129576073   	129575758      	129576073      	3         	14        	17             	DEL       
chr12       	129638479   	129638620   	129638480      	129638620      	0         	14        	14             	DEL       
chr12       	130043303   	130043458   	130043304      	130043472      	0         	13        	13             	DUP       
chr12       	130882132   	130882861   	130882133      	130882861      	4         	0         	4              	DEL       
chr12       	131293705   	131666758   	131331371      	131331421      	0         	5         	5              	DEL       
chr12       	131293705   	131666758   	131443940      	131444042      	1         	11        	12             	DEL       
chr12       	131293705   	131666758   	131576438      	131577253      	4         	0         	4              	DUP       
chr12       	131293705   	131666758   	131332613      	131630046      	12        	0         	12             	INV       
chr12       	131293705   	131666758   	131293757      	131666819      	7         	0         	7              	INV       
chr12       	131331357   	131331438   	131331371      	131331421      	0         	5         	5              	DEL       
chr12       	131332612   	131630046   	131443940      	131444042      	1         	11        	12             	DEL       
chr12       	131332612   	131630046   	131576438      	131577253      	4         	0         	4              	DUP       
chr12       	131332612   	131630046   	131332613      	131630046      	12        	0         	12             	INV       
chr12       	131443934   	131444043   	131443940      	131444042      	1         	11        	12             	DEL       
chr12       	131576491   	131577436   	131576438      	131577253      	4         	0         	4              	DUP       
chr12       	132148995   	132150688   	132148999      	132150677      	7         	0         	7              	DEL       
chr12       	132304691   	132305600   	132304692      	132305600      	7         	0         	7              	DEL       
chr12       	132377646   	132378513   	132377647      	132378513      	5         	0         	5              	DEL       
chr13       	16000572    	16006280    	16000573       	16006280       	9         	0         	9              	DEL       
chr13       	16000572    	16006280    	16002567       	16014352       	10        	0         	10             	DUP       
chr13       	16000572    	16006280    	16005110       	16016348       	6         	0         	6              	DEL       
chr13       	16000572    	16006280    	16000587       	16017667       	6         	0         	6              	DEL       
chr13       	16000572    	16006280    	16003531       	16018512       	8         	0         	8              	DUP       
chr13       	16000572    	16006280    	16003960       	16020953       	10        	0         	10             	DEL       
chr13       	16000249    	16017011    	16000573       	16006280       	9         	0         	9              	DEL       
chr13       	16000249    	16017011    	16006450       	16012173       	6         	0         	6              	DEL       
chr13       	16000249    	16017011    	16002567       	16014352       	10        	0         	10             	DUP       
chr13       	16000249    	16017011    	16008212       	16013903       	11        	0         	11             	DEL       
chr13       	16000249    	16017011    	16010196       	16015875       	5         	0         	5              	DUP       
chr13       	16000249    	16017011    	16005110       	16016348       	6         	0         	6              	DEL       
chr13       	16000249    	16017011    	16010735       	16016366       	5         	0         	5              	DEL       
chr13       	16000249    	16017011    	16000250       	16017011       	20        	0         	20             	DUP       
chr13       	16000249    	16017011    	16000587       	16017667       	6         	0         	6              	DEL       
chr13       	16000249    	16017011    	16012464       	16018232       	10        	0         	10             	DEL       
chr13       	16000249    	16017011    	16003531       	16018512       	8         	0         	8              	DUP       
chr13       	16000249    	16017011    	16016553       	16018832       	4         	0         	4              	DEL       
chr13       	16000249    	16017011    	16013771       	16019080       	13        	0         	13             	DUP       
chr13       	16000249    	16017011    	16015003       	16020634       	8         	0         	8              	DUP       
chr13       	16000249    	16017011    	16009047       	16019470       	4         	0         	4              	DEL       
chr13       	16000249    	16017011    	16003960       	16020953       	10        	0         	10             	DEL       
chr13       	16000249    	16017011    	16010558       	16021683       	8         	0         	8              	DUP       
chr13       	16000249    	16017011    	16016342       	16021922       	11        	0         	11             	DUP       
chr13       	16000249    	16017011    	16016564       	16022280       	9         	0         	9              	DEL       
chr13       	16000249    	16017011    	16010821       	16021686       	12        	0         	12             	DEL       
chr13       	16002566    	16014352    	16000573       	16006280       	9         	0         	9              	DEL       
chr13       	16002566    	16014352    	16006450       	16012173       	6         	0         	6              	DEL       
chr13       	16002566    	16014352    	16002567       	16014352       	10        	0         	10             	DUP       
chr13       	16002566    	16014352    	16008212       	16013903       	11        	0         	11             	DEL       
chr13       	16002566    	16014352    	16010196       	16015875       	5         	0         	5              	DUP       
chr13       	16002566    	16014352    	16005110       	16016348       	6         	0         	6              	DEL       
chr13       	16002566    	16014352    	16010735       	16016366       	5         	0         	5              	DEL       
chr13       	16002566    	16014352    	16012464       	16018232       	10        	0         	10             	DEL       
chr13       	16002566    	16014352    	16003531       	16018512       	8         	0         	8              	DUP       
chr13       	16002566    	16014352    	16013771       	16019080       	13        	0         	13             	DUP       
chr13       	16002566    	16014352    	16009047       	16019470       	4         	0         	4              	DEL       
chr13       	16002566    	16014352    	16003960       	16020953       	10        	0         	10             	DEL       
chr13       	16002566    	16014352    	16010558       	16021683       	8         	0         	8              	DUP       
chr13       	16002566    	16014352    	16010821       	16021686       	12        	0         	12             	DEL       
chr13       	16003530    	16018512    	16000573       	16006280       	9         	0         	9              	DEL       
chr13       	16003530    	16018512    	16006450       	16012173       	6         	0         	6              	DEL       
chr13       	16003530    	16018512    	16002567       	16014352       	10        	0         	10             	DUP       
chr13       	16003530    	16018512    	16008212       	16013903       	11        	0         	11             	DEL       
chr13       	16003530    	16018512    	16010196       	16015875       	5         	0         	5              	DUP       
chr13       	16003530    	16018512    	16005110       	16016348       	6         	0         	6              	DEL       
chr13       	16003530    	16018512    	16010735       	16016366       	5         	0         	5              	DEL       
chr13       	16003530    	16018512    	16000250       	16017011       	20        	0         	20             	DUP       
chr13       	16003530    	16018512    	16000587       	16017667       	6         	0         	6              	DEL       
chr13       	16003530    	16018512    	16012464       	16018232       	10        	0         	10             	DEL       
chr13       	16003530    	16018512    	16003531       	16018512       	8         	0         	8              	DUP       
chr13       	16003530    	16018512    	16016553       	16018832       	4         	0         	4              	DEL       
chr13       	16003530    	16018512    	16013771       	16019080       	13        	0         	13             	DUP       
chr13       	16003530    	16018512    	16015003       	16020634       	8         	0         	8              	DUP       
chr13       	16003530    	16018512    	16009047       	16019470       	4         	0         	4              	DEL       
chr13       	16003530    	16018512    	16003960       	16020953       	10        	0         	10             	DEL       
chr13       	16003530    	16018512    	16010558       	16021683       	8         	0         	8              	DUP       
chr13       	16003530    	16018512    	16016342       	16021922       	11        	0         	11             	DUP       
chr13       	16003530    	16018512    	16016564       	16022280       	9         	0         	9              	DEL       
chr13       	16003530    	16018512    	16010821       	16021686       	12        	0         	12             	DEL       
chr13       	16003959    	16020953    	16000573       	16006280       	9         	0         	9              	DEL       
chr13       	16003959    	16020953    	16006450       	16012173       	6         	0         	6              	DEL       
chr13       	16003959    	16020953    	16002567       	16014352       	10        	0         	10             	DUP       
chr13       	16003959    	16020953    	16008212       	16013903       	11        	0         	11             	DEL       
chr13       	16003959    	16020953    	16010196       	16015875       	5         	0         	5              	DUP       
chr13       	16003959    	16020953    	16005110       	16016348       	6         	0         	6              	DEL       
chr13       	16003959    	16020953    	16010735       	16016366       	5         	0         	5              	DEL       
chr13       	16003959    	16020953    	16000250       	16017011       	20        	0         	20             	DUP       
chr13       	16003959    	16020953    	16000587       	16017667       	6         	0         	6              	DEL       
chr13       	16003959    	16020953    	16012464       	16018232       	10        	0         	10             	DEL       
chr13       	16003959    	16020953    	16003531       	16018512       	8         	0         	8              	DUP       
chr13       	16003959    	16020953    	16016553       	16018832       	4         	0         	4              	DEL       
chr13       	16003959    	16020953    	16013771       	16019080       	13        	0         	13             	DUP       
chr13       	16003959    	16020953    	16015003       	16020634       	8         	0         	8              	DUP       
chr13       	16003959    	16020953    	16009047       	16019470       	4         	0         	4              	DEL       
chr13       	16003959    	16020953    	16003960       	16020953       	10        	0         	10             	DEL       
chr13       	16003959    	16020953    	16010558       	16021683       	8         	0         	8              	DUP       
chr13       	16003959    	16020953    	16016342       	16021922       	11        	0         	11             	DUP       
chr13       	16003959    	16020953    	16016564       	16022280       	9         	0         	9              	DEL       
chr13       	16003959    	16020953    	16010821       	16021686       	12        	0         	12             	DEL       
chr13       	16005109    	16016348    	16000573       	16006280       	9         	0         	9              	DEL       
chr13       	16005109    	16016348    	16006450       	16012173       	6         	0         	6              	DEL       
chr13       	16005109    	16016348    	16002567       	16014352       	10        	0         	10             	DUP       
chr13       	16005109    	16016348    	16008212       	16013903       	11        	0         	11             	DEL       
chr13       	16005109    	16016348    	16010196       	16015875       	5         	0         	5              	DUP       
chr13       	16005109    	16016348    	16005110       	16016348       	6         	0         	6              	DEL       
chr13       	16005109    	16016348    	16010735       	16016366       	5         	0         	5              	DEL       
chr13       	16005109    	16016348    	16012464       	16018232       	10        	0         	10             	DEL       
chr13       	16005109    	16016348    	16013771       	16019080       	13        	0         	13             	DUP       
chr13       	16005109    	16016348    	16015003       	16020634       	8         	0         	8              	DUP       
chr13       	16005109    	16016348    	16009047       	16019470       	4         	0         	4              	DEL       
chr13       	16005109    	16016348    	16010558       	16021683       	8         	0         	8              	DUP       
chr13       	16005109    	16016348    	16016342       	16021922       	11        	0         	11             	DUP       
chr13       	16005109    	16016348    	16010821       	16021686       	12        	0         	12             	DEL       
chr13       	16006449    	16012173    	16006450       	16012173       	6         	0         	6              	DEL       
chr13       	16006449    	16012173    	16008212       	16013903       	11        	0         	11             	DEL       
chr13       	16006449    	16012173    	16010196       	16015875       	5         	0         	5              	DUP       
chr13       	16006449    	16012173    	16010735       	16016366       	5         	0         	5              	DEL       
chr13       	16006449    	16012173    	16009047       	16019470       	4         	0         	4              	DEL       
chr13       	16006449    	16012173    	16010558       	16021683       	8         	0         	8              	DUP       
chr13       	16006449    	16012173    	16010821       	16021686       	12        	0         	12             	DEL       
chr13       	16010734    	16016366    	16006450       	16012173       	6         	0         	6              	DEL       
chr13       	16010734    	16016366    	16002567       	16014352       	10        	0         	10             	DUP       
chr13       	16010734    	16016366    	16008212       	16013903       	11        	0         	11             	DEL       
chr13       	16010734    	16016366    	16010196       	16015875       	5         	0         	5              	DUP       
chr13       	16010734    	16016366    	16005110       	16016348       	6         	0         	6              	DEL       
chr13       	16010734    	16016366    	16010735       	16016366       	5         	0         	5              	DEL       
chr13       	16010734    	16016366    	16012464       	16018232       	10        	0         	10             	DEL       
chr13       	16010734    	16016366    	16013771       	16019080       	13        	0         	13             	DUP       
chr13       	16010734    	16016366    	16015003       	16020634       	8         	0         	8              	DUP       
chr13       	16010734    	16016366    	16016342       	16021922       	11        	0         	11             	DUP       
chr13       	16010734    	16016366    	16010821       	16021686       	12        	0         	12             	DEL       
chr13       	16010557    	16021683    	16006450       	16012173       	6         	0         	6              	DEL       
chr13       	16010557    	16021683    	16002567       	16014352       	10        	0         	10             	DUP       
chr13       	16010557    	16021683    	16008212       	16013903       	11        	0         	11             	DEL       
chr13       	16010557    	16021683    	16010196       	16015875       	5         	0         	5              	DUP       
chr13       	16010557    	16021683    	16005110       	16016348       	6         	0         	6              	DEL       
chr13       	16010557    	16021683    	16010735       	16016366       	5         	0         	5              	DEL       
chr13       	16010557    	16021683    	16000250       	16017011       	20        	0         	20             	DUP       
chr13       	16010557    	16021683    	16000587       	16017667       	6         	0         	6              	DEL       
chr13       	16010557    	16021683    	16012464       	16018232       	10        	0         	10             	DEL       
chr13       	16010557    	16021683    	16003531       	16018512       	8         	0         	8              	DUP       
chr13       	16010557    	16021683    	16016553       	16018832       	4         	0         	4              	DEL       
chr13       	16010557    	16021683    	16013771       	16019080       	13        	0         	13             	DUP       
chr13       	16010557    	16021683    	16015003       	16020634       	8         	0         	8              	DUP       
chr13       	16010557    	16021683    	16009047       	16019470       	4         	0         	4              	DEL       
chr13       	16010557    	16021683    	16003960       	16020953       	10        	0         	10             	DEL       
chr13       	16010557    	16021683    	16010558       	16021683       	8         	0         	8              	DUP       
chr13       	16010557    	16021683    	16016342       	16021922       	11        	0         	11             	DUP       
chr13       	16010557    	16021683    	16016564       	16022280       	9         	0         	9              	DEL       
chr13       	16010557    	16021683    	16010821       	16021686       	12        	0         	12             	DEL       
chr13       	16013770    	16019080    	16002567       	16014352       	10        	0         	10             	DUP       
chr13       	16013770    	16019080    	16008212       	16013903       	11        	0         	11             	DEL       
chr13       	16013770    	16019080    	16010196       	16015875       	5         	0         	5              	DUP       
chr13       	16013770    	16019080    	16005110       	16016348       	6         	0         	6              	DEL       
chr13       	16013770    	16019080    	16010735       	16016366       	5         	0         	5              	DEL       
chr13       	16013770    	16019080    	16000250       	16017011       	20        	0         	20             	DUP       
chr13       	16013770    	16019080    	16000587       	16017667       	6         	0         	6              	DEL       
chr13       	16013770    	16019080    	16012464       	16018232       	10        	0         	10             	DEL       
chr13       	16013770    	16019080    	16003531       	16018512       	8         	0         	8              	DUP       
chr13       	16013770    	16019080    	16016553       	16018832       	4         	0         	4              	DEL       
chr13       	16013770    	16019080    	16013771       	16019080       	13        	0         	13             	DUP       
chr13       	16013770    	16019080    	16015003       	16020634       	8         	0         	8              	DUP       
chr13       	16013770    	16019080    	16016342       	16021922       	11        	0         	11             	DUP       
chr13       	16013770    	16019080    	16016564       	16022280       	9         	0         	9              	DEL       
chr13       	16015002    	16020634    	16010196       	16015875       	5         	0         	5              	DUP       
chr13       	16015002    	16020634    	16005110       	16016348       	6         	0         	6              	DEL       
chr13       	16015002    	16020634    	16010735       	16016366       	5         	0         	5              	DEL       
chr13       	16015002    	16020634    	16000250       	16017011       	20        	0         	20             	DUP       
chr13       	16015002    	16020634    	16000587       	16017667       	6         	0         	6              	DEL       
chr13       	16015002    	16020634    	16012464       	16018232       	10        	0         	10             	DEL       
chr13       	16015002    	16020634    	16003531       	16018512       	8         	0         	8              	DUP       
chr13       	16015002    	16020634    	16016553       	16018832       	4         	0         	4              	DEL       
chr13       	16015002    	16020634    	16013771       	16019080       	13        	0         	13             	DUP       
chr13       	16015002    	16020634    	16015003       	16020634       	8         	0         	8              	DUP       
chr13       	16015002    	16020634    	16009047       	16019470       	4         	0         	4              	DEL       
chr13       	16015002    	16020634    	16016342       	16021922       	11        	0         	11             	DUP       
chr13       	16015002    	16020634    	16016564       	16022280       	9         	0         	9              	DEL       
chr13       	16016552    	16018832    	16000250       	16017011       	20        	0         	20             	DUP       
chr13       	16016552    	16018832    	16000587       	16017667       	6         	0         	6              	DEL       
chr13       	16016552    	16018832    	16012464       	16018232       	10        	0         	10             	DEL       
chr13       	16016552    	16018832    	16003531       	16018512       	8         	0         	8              	DUP       
chr13       	16016552    	16018832    	16016553       	16018832       	4         	0         	4              	DEL       
chr13       	16016552    	16018832    	16016564       	16022280       	9         	0         	9              	DEL       
chr13       	16016341    	16021922    	16005110       	16016348       	6         	0         	6              	DEL       
chr13       	16016341    	16021922    	16010735       	16016366       	5         	0         	5              	DEL       
chr13       	16016341    	16021922    	16000250       	16017011       	20        	0         	20             	DUP       
chr13       	16016341    	16021922    	16000587       	16017667       	6         	0         	6              	DEL       
chr13       	16016341    	16021922    	16012464       	16018232       	10        	0         	10             	DEL       
chr13       	16016341    	16021922    	16003531       	16018512       	8         	0         	8              	DUP       
chr13       	16016341    	16021922    	16016553       	16018832       	4         	0         	4              	DEL       
chr13       	16016341    	16021922    	16013771       	16019080       	13        	0         	13             	DUP       
chr13       	16016341    	16021922    	16015003       	16020634       	8         	0         	8              	DUP       
chr13       	16016341    	16021922    	16009047       	16019470       	4         	0         	4              	DEL       
chr13       	16016341    	16021922    	16003960       	16020953       	10        	0         	10             	DEL       
chr13       	16016341    	16021922    	16010558       	16021683       	8         	0         	8              	DUP       
chr13       	16016341    	16021922    	16016342       	16021922       	11        	0         	11             	DUP       
chr13       	16016341    	16021922    	16016564       	16022280       	9         	0         	9              	DEL       
chr13       	16016341    	16021922    	16010821       	16021686       	12        	0         	12             	DEL       
chr13       	16031320    	16056983    	16031321       	16056983       	9         	0         	9              	DUP       
chr13       	16031320    	16056983    	16048157       	16067216       	5         	0         	5              	DUP       
chr13       	16031320    	16056983    	16048218       	16090238       	9         	0         	9              	DUP       
chr13       	16048156    	16067216    	16067207       	16090032       	4         	0         	4              	DEL       
chr13       	16048156    	16067216    	16031321       	16056983       	9         	0         	9              	DUP       
chr13       	16048156    	16067216    	16048157       	16067216       	5         	0         	5              	DUP       
chr13       	16048156    	16067216    	16048218       	16090238       	9         	0         	9              	DUP       
chr13       	16048217    	16090238    	16067207       	16090032       	4         	0         	4              	DEL       
chr13       	16048217    	16090238    	16031321       	16056983       	9         	0         	9              	DUP       
chr13       	16048217    	16090238    	16048157       	16067216       	5         	0         	5              	DUP       
chr13       	16048217    	16090238    	16048218       	16090238       	9         	0         	9              	DUP       
chr13       	16048217    	16090238    	16078791       	16094234       	6         	0         	6              	DEL       
chr13       	16067206    	16090032    	16067207       	16090032       	4         	0         	4              	DEL       
chr13       	16067206    	16090032    	16048157       	16067216       	5         	0         	5              	DUP       
chr13       	16067206    	16090032    	16078791       	16094234       	6         	0         	6              	DEL       
chr13       	16078790    	16094234    	16067207       	16090032       	4         	0         	4              	DEL       
chr13       	16078790    	16094234    	16048218       	16090238       	9         	0         	9              	DUP       
chr13       	16078790    	16094234    	16078791       	16094234       	6         	0         	6              	DEL       
chr13       	16113395    	16150768    	16113661       	16117256       	9         	0         	9              	DEL       
chr13       	16113395    	16150768    	16113723       	16127813       	15        	0         	15             	DEL       
chr13       	16113395    	16150768    	16125727       	16129400       	4         	0         	4              	DEL       
chr13       	16113395    	16150768    	16127791       	16130992       	24        	0         	24             	DUP       
chr13       	16113395    	16150768    	16111282       	16132064       	6         	0         	6              	DEL       
chr13       	16113395    	16150768    	16115797       	16136431       	6         	0         	6              	DEL       
chr13       	16113395    	16150768    	16127249       	16137144       	5         	0         	5              	DUP       
chr13       	16113395    	16150768    	16115907       	16140327       	4         	0         	4              	DEL       
chr13       	16113395    	16150768    	16130584       	16140584       	4         	0         	4              	DUP       
chr13       	16113395    	16150768    	16140020       	16143803       	4         	0         	4              	DEL       
chr13       	16113395    	16150768    	16128047       	16145013       	14        	0         	14             	DUP       
chr13       	16113395    	16150768    	16130965       	16144768       	18        	0         	18             	DEL       
chr13       	16113395    	16150768    	16113718       	16144805       	34        	0         	34             	DEL       
chr13       	16113395    	16150768    	16113396       	16150768       	29        	0         	29             	DUP       
chr13       	16113395    	16150768    	16141474       	16151382       	4         	0         	4              	DUP       
chr13       	16113395    	16150768    	16131431       	16151806       	5         	0         	5              	DUP       
chr13       	16113395    	16150768    	16115619       	16153168       	4         	0         	4              	DUP       
chr13       	16113395    	16150768    	16146300       	16156246       	8         	0         	8              	DUP       
chr13       	16113395    	16150768    	16114013       	16158372       	12        	0         	12             	DEL       
chr13       	16127790    	16130992    	16113723       	16127813       	15        	0         	15             	DEL       
chr13       	16127790    	16130992    	16125727       	16129400       	4         	0         	4              	DEL       
chr13       	16127790    	16130992    	16127791       	16130992       	24        	0         	24             	DUP       
chr13       	16127790    	16130992    	16130584       	16140584       	4         	0         	4              	DUP       
chr13       	16127790    	16130992    	16128047       	16145013       	14        	0         	14             	DUP       
chr13       	16127790    	16130992    	16130965       	16144768       	18        	0         	18             	DEL       
chr13       	16130583    	16140584    	16127791       	16130992       	24        	0         	24             	DUP       
chr13       	16130583    	16140584    	16111282       	16132064       	6         	0         	6              	DEL       
chr13       	16130583    	16140584    	16115797       	16136431       	6         	0         	6              	DEL       
chr13       	16130583    	16140584    	16127249       	16137144       	5         	0         	5              	DUP       
chr13       	16130583    	16140584    	16115907       	16140327       	4         	0         	4              	DEL       
chr13       	16130583    	16140584    	16130584       	16140584       	4         	0         	4              	DUP       
chr13       	16130583    	16140584    	16140020       	16143803       	4         	0         	4              	DEL       
chr13       	16130583    	16140584    	16130965       	16144768       	18        	0         	18             	DEL       
chr13       	16130583    	16140584    	16131431       	16151806       	5         	0         	5              	DUP       
chr13       	16146299    	16156246    	16113396       	16150768       	29        	0         	29             	DUP       
chr13       	16146299    	16156246    	16141474       	16151382       	4         	0         	4              	DUP       
chr13       	16146299    	16156246    	16131431       	16151806       	5         	0         	5              	DUP       
chr13       	16146299    	16156246    	16115619       	16153168       	4         	0         	4              	DUP       
chr13       	16146299    	16156246    	16146300       	16156246       	8         	0         	8              	DUP       
chr13       	16171517    	16193934    	16171518       	16193934       	10        	0         	10             	DEL       
chr13       	16171517    	16193934    	16177873       	16201273       	14        	0         	14             	DEL       
chr13       	16171517    	16193934    	16190327       	16208008       	6         	0         	6              	DUP       
chr13       	16171517    	16193934    	16187050       	16208292       	4         	0         	4              	DUP       
chr13       	16171517    	16193934    	16185372       	16212243       	4         	0         	4              	DEL       
chr13       	16171517    	16193934    	16177657       	16212436       	11        	0         	11             	DUP       
chr13       	16171517    	16193934    	16175116       	16215847       	7         	0         	7              	DEL       
chr13       	16171517    	16193934    	16187105       	16226111       	5         	0         	5              	DUP       
chr13       	16170783    	16224906    	16171518       	16193934       	10        	0         	10             	DEL       
chr13       	16170783    	16224906    	16197357       	16201479       	10        	0         	10             	DUP       
chr13       	16170783    	16224906    	16177873       	16201273       	14        	0         	14             	DEL       
chr13       	16170783    	16224906    	16190327       	16208008       	6         	0         	6              	DUP       
chr13       	16170783    	16224906    	16187050       	16208292       	4         	0         	4              	DUP       
chr13       	16170783    	16224906    	16201447       	16208815       	6         	0         	6              	DUP       
chr13       	16170783    	16224906    	16208124       	16208817       	4         	0         	4              	DUP       
chr13       	16170783    	16224906    	16185372       	16212243       	4         	0         	4              	DEL       
chr13       	16170783    	16224906    	16201273       	16212435       	8         	0         	8              	DUP       
chr13       	16170783    	16224906    	16177657       	16212436       	11        	0         	11             	DUP       
chr13       	16170783    	16224906    	16208124       	16215334       	0         	4         	4              	DUP       
chr13       	16170783    	16224906    	16195820       	16215199       	10        	0         	10             	DEL       
chr13       	16170783    	16224906    	16175116       	16215847       	7         	0         	7              	DEL       
chr13       	16170783    	16224906    	16211779       	16217911       	6         	0         	6              	DEL       
chr13       	16170783    	16224906    	16170784       	16224906       	8         	0         	8              	DEL       
chr13       	16170783    	16224906    	16219109       	16225588       	0         	4         	4              	DEL       
chr13       	16170783    	16224906    	16208124       	16225794       	16        	0         	16             	DUP       
chr13       	16170783    	16224906    	16208819       	16225588       	4         	0         	4              	DEL       
chr13       	16170783    	16224906    	16187105       	16226111       	5         	0         	5              	DUP       
chr13       	16170783    	16224906    	16211720       	16226123       	6         	0         	6              	DUP       
chr13       	16175115    	16215847    	16171518       	16193934       	10        	0         	10             	DEL       
chr13       	16175115    	16215847    	16197357       	16201479       	10        	0         	10             	DUP       
chr13       	16175115    	16215847    	16177873       	16201273       	14        	0         	14             	DEL       
chr13       	16175115    	16215847    	16190327       	16208008       	6         	0         	6              	DUP       
chr13       	16175115    	16215847    	16187050       	16208292       	4         	0         	4              	DUP       
chr13       	16175115    	16215847    	16201447       	16208815       	6         	0         	6              	DUP       
chr13       	16175115    	16215847    	16208124       	16208817       	4         	0         	4              	DUP       
chr13       	16175115    	16215847    	16185372       	16212243       	4         	0         	4              	DEL       
chr13       	16175115    	16215847    	16201273       	16212435       	8         	0         	8              	DUP       
chr13       	16175115    	16215847    	16177657       	16212436       	11        	0         	11             	DUP       
chr13       	16175115    	16215847    	16208124       	16215334       	0         	4         	4              	DUP       
chr13       	16175115    	16215847    	16195820       	16215199       	10        	0         	10             	DEL       
chr13       	16175115    	16215847    	16175116       	16215847       	7         	0         	7              	DEL       
chr13       	16175115    	16215847    	16211779       	16217911       	6         	0         	6              	DEL       
chr13       	16175115    	16215847    	16208124       	16225794       	16        	0         	16             	DUP       
chr13       	16175115    	16215847    	16208819       	16225588       	4         	0         	4              	DEL       
chr13       	16175115    	16215847    	16187105       	16226111       	5         	0         	5              	DUP       
chr13       	16175115    	16215847    	16211720       	16226123       	6         	0         	6              	DUP       
chr13       	16177872    	16201273    	16171518       	16193934       	10        	0         	10             	DEL       
chr13       	16177872    	16201273    	16197357       	16201479       	10        	0         	10             	DUP       
chr13       	16177872    	16201273    	16177873       	16201273       	14        	0         	14             	DEL       
chr13       	16177872    	16201273    	16190327       	16208008       	6         	0         	6              	DUP       
chr13       	16177872    	16201273    	16187050       	16208292       	4         	0         	4              	DUP       
chr13       	16177872    	16201273    	16185372       	16212243       	4         	0         	4              	DEL       
chr13       	16177872    	16201273    	16201273       	16212435       	8         	0         	8              	DUP       
chr13       	16177872    	16201273    	16195820       	16215199       	10        	0         	10             	DEL       
chr13       	16177872    	16201273    	16187105       	16226111       	5         	0         	5              	DUP       
chr13       	16177656    	16212436    	16171518       	16193934       	10        	0         	10             	DEL       
chr13       	16177656    	16212436    	16197357       	16201479       	10        	0         	10             	DUP       
chr13       	16177656    	16212436    	16177873       	16201273       	14        	0         	14             	DEL       
chr13       	16177656    	16212436    	16190327       	16208008       	6         	0         	6              	DUP       
chr13       	16177656    	16212436    	16187050       	16208292       	4         	0         	4              	DUP       
chr13       	16177656    	16212436    	16201447       	16208815       	6         	0         	6              	DUP       
chr13       	16177656    	16212436    	16208124       	16208817       	4         	0         	4              	DUP       
chr13       	16177656    	16212436    	16185372       	16212243       	4         	0         	4              	DEL       
chr13       	16177656    	16212436    	16201273       	16212435       	8         	0         	8              	DUP       
chr13       	16177656    	16212436    	16177657       	16212436       	11        	0         	11             	DUP       
chr13       	16177656    	16212436    	16208124       	16215334       	0         	4         	4              	DUP       
chr13       	16177656    	16212436    	16195820       	16215199       	10        	0         	10             	DEL       
chr13       	16177656    	16212436    	16211779       	16217911       	6         	0         	6              	DEL       
chr13       	16177656    	16212436    	16208124       	16225794       	16        	0         	16             	DUP       
chr13       	16177656    	16212436    	16208819       	16225588       	4         	0         	4              	DEL       
chr13       	16177656    	16212436    	16187105       	16226111       	5         	0         	5              	DUP       
chr13       	16177656    	16212436    	16211720       	16226123       	6         	0         	6              	DUP       
chr13       	16185371    	16212243    	16171518       	16193934       	10        	0         	10             	DEL       
chr13       	16185371    	16212243    	16197357       	16201479       	10        	0         	10             	DUP       
chr13       	16185371    	16212243    	16177873       	16201273       	14        	0         	14             	DEL       
chr13       	16185371    	16212243    	16190327       	16208008       	6         	0         	6              	DUP       
chr13       	16185371    	16212243    	16187050       	16208292       	4         	0         	4              	DUP       
chr13       	16185371    	16212243    	16201447       	16208815       	6         	0         	6              	DUP       
chr13       	16185371    	16212243    	16208124       	16208817       	4         	0         	4              	DUP       
chr13       	16185371    	16212243    	16185372       	16212243       	4         	0         	4              	DEL       
chr13       	16185371    	16212243    	16201273       	16212435       	8         	0         	8              	DUP       
chr13       	16185371    	16212243    	16208124       	16215334       	0         	4         	4              	DUP       
chr13       	16185371    	16212243    	16195820       	16215199       	10        	0         	10             	DEL       
chr13       	16185371    	16212243    	16211779       	16217911       	6         	0         	6              	DEL       
chr13       	16185371    	16212243    	16208124       	16225794       	16        	0         	16             	DUP       
chr13       	16185371    	16212243    	16208819       	16225588       	4         	0         	4              	DEL       
chr13       	16185371    	16212243    	16187105       	16226111       	5         	0         	5              	DUP       
chr13       	16185371    	16212243    	16211720       	16226123       	6         	0         	6              	DUP       
chr13       	16187049    	16208292    	16171518       	16193934       	10        	0         	10             	DEL       
chr13       	16187049    	16208292    	16197357       	16201479       	10        	0         	10             	DUP       
chr13       	16187049    	16208292    	16177873       	16201273       	14        	0         	14             	DEL       
chr13       	16187049    	16208292    	16190327       	16208008       	6         	0         	6              	DUP       
chr13       	16187049    	16208292    	16187050       	16208292       	4         	0         	4              	DUP       
chr13       	16187049    	16208292    	16201447       	16208815       	6         	0         	6              	DUP       
chr13       	16187049    	16208292    	16208124       	16208817       	4         	0         	4              	DUP       
chr13       	16187049    	16208292    	16201273       	16212435       	8         	0         	8              	DUP       
chr13       	16187049    	16208292    	16208124       	16215334       	0         	4         	4              	DUP       
chr13       	16187049    	16208292    	16195820       	16215199       	10        	0         	10             	DEL       
chr13       	16187049    	16208292    	16208124       	16225794       	16        	0         	16             	DUP       
chr13       	16187049    	16208292    	16187105       	16226111       	5         	0         	5              	DUP       
chr13       	16187104    	16226111    	16171518       	16193934       	10        	0         	10             	DEL       
chr13       	16187104    	16226111    	16197357       	16201479       	10        	0         	10             	DUP       
chr13       	16187104    	16226111    	16177873       	16201273       	14        	0         	14             	DEL       
chr13       	16187104    	16226111    	16190327       	16208008       	6         	0         	6              	DUP       
chr13       	16187104    	16226111    	16187050       	16208292       	4         	0         	4              	DUP       
chr13       	16187104    	16226111    	16201447       	16208815       	6         	0         	6              	DUP       
chr13       	16187104    	16226111    	16208124       	16208817       	4         	0         	4              	DUP       
chr13       	16187104    	16226111    	16185372       	16212243       	4         	0         	4              	DEL       
chr13       	16187104    	16226111    	16201273       	16212435       	8         	0         	8              	DUP       
chr13       	16187104    	16226111    	16177657       	16212436       	11        	0         	11             	DUP       
chr13       	16187104    	16226111    	16208124       	16215334       	0         	4         	4              	DUP       
chr13       	16187104    	16226111    	16195820       	16215199       	10        	0         	10             	DEL       
chr13       	16187104    	16226111    	16175116       	16215847       	7         	0         	7              	DEL       
chr13       	16187104    	16226111    	16211779       	16217911       	6         	0         	6              	DEL       
chr13       	16187104    	16226111    	16170784       	16224906       	8         	0         	8              	DEL       
chr13       	16187104    	16226111    	16219109       	16225588       	0         	4         	4              	DEL       
chr13       	16187104    	16226111    	16208124       	16225794       	16        	0         	16             	DUP       
chr13       	16187104    	16226111    	16208819       	16225588       	4         	0         	4              	DEL       
chr13       	16187104    	16226111    	16187105       	16226111       	5         	0         	5              	DUP       
chr13       	16187104    	16226111    	16211720       	16226123       	6         	0         	6              	DUP       
chr13       	16190326    	16208008    	16171518       	16193934       	10        	0         	10             	DEL       
chr13       	16190326    	16208008    	16197357       	16201479       	10        	0         	10             	DUP       
chr13       	16190326    	16208008    	16177873       	16201273       	14        	0         	14             	DEL       
chr13       	16190326    	16208008    	16190327       	16208008       	6         	0         	6              	DUP       
chr13       	16190326    	16208008    	16201447       	16208815       	6         	0         	6              	DUP       
chr13       	16190326    	16208008    	16201273       	16212435       	8         	0         	8              	DUP       
chr13       	16190326    	16208008    	16195820       	16215199       	10        	0         	10             	DEL       
chr13       	16195819    	16215199    	16197357       	16201479       	10        	0         	10             	DUP       
chr13       	16195819    	16215199    	16177873       	16201273       	14        	0         	14             	DEL       
chr13       	16195819    	16215199    	16190327       	16208008       	6         	0         	6              	DUP       
chr13       	16195819    	16215199    	16187050       	16208292       	4         	0         	4              	DUP       
chr13       	16195819    	16215199    	16201447       	16208815       	6         	0         	6              	DUP       
chr13       	16195819    	16215199    	16208124       	16208817       	4         	0         	4              	DUP       
chr13       	16195819    	16215199    	16185372       	16212243       	4         	0         	4              	DEL       
chr13       	16195819    	16215199    	16201273       	16212435       	8         	0         	8              	DUP       
chr13       	16195819    	16215199    	16177657       	16212436       	11        	0         	11             	DUP       
chr13       	16195819    	16215199    	16208124       	16215334       	0         	4         	4              	DUP       
chr13       	16195819    	16215199    	16195820       	16215199       	10        	0         	10             	DEL       
chr13       	16195819    	16215199    	16211779       	16217911       	6         	0         	6              	DEL       
chr13       	16195819    	16215199    	16208124       	16225794       	16        	0         	16             	DUP       
chr13       	16195819    	16215199    	16208819       	16225588       	4         	0         	4              	DEL       
chr13       	16195819    	16215199    	16211720       	16226123       	6         	0         	6              	DUP       
chr13       	16197356    	16201479    	16197357       	16201479       	10        	0         	10             	DUP       
chr13       	16197356    	16201479    	16177873       	16201273       	14        	0         	14             	DEL       
chr13       	16197356    	16201479    	16201447       	16208815       	6         	0         	6              	DUP       
chr13       	16197356    	16201479    	16201273       	16212435       	8         	0         	8              	DUP       
chr13       	16201446    	16208815    	16197357       	16201479       	10        	0         	10             	DUP       
chr13       	16201446    	16208815    	16190327       	16208008       	6         	0         	6              	DUP       
chr13       	16201446    	16208815    	16187050       	16208292       	4         	0         	4              	DUP       
chr13       	16201446    	16208815    	16201447       	16208815       	6         	0         	6              	DUP       
chr13       	16201446    	16208815    	16208124       	16208817       	4         	0         	4              	DUP       
chr13       	16201446    	16208815    	16208124       	16215334       	0         	4         	4              	DUP       
chr13       	16201446    	16208815    	16208124       	16225794       	16        	0         	16             	DUP       
chr13       	16201446    	16208815    	16208819       	16225588       	4         	0         	4              	DEL       
chr13       	16201272    	16212435    	16197357       	16201479       	10        	0         	10             	DUP       
chr13       	16201272    	16212435    	16177873       	16201273       	14        	0         	14             	DEL       
chr13       	16201272    	16212435    	16190327       	16208008       	6         	0         	6              	DUP       
chr13       	16201272    	16212435    	16187050       	16208292       	4         	0         	4              	DUP       
chr13       	16201272    	16212435    	16201447       	16208815       	6         	0         	6              	DUP       
chr13       	16201272    	16212435    	16208124       	16208817       	4         	0         	4              	DUP       
chr13       	16201272    	16212435    	16185372       	16212243       	4         	0         	4              	DEL       
chr13       	16201272    	16212435    	16201273       	16212435       	8         	0         	8              	DUP       
chr13       	16201272    	16212435    	16177657       	16212436       	11        	0         	11             	DUP       
chr13       	16201272    	16212435    	16208124       	16215334       	0         	4         	4              	DUP       
chr13       	16201272    	16212435    	16211779       	16217911       	6         	0         	6              	DEL       
chr13       	16201272    	16212435    	16208124       	16225794       	16        	0         	16             	DUP       
chr13       	16201272    	16212435    	16208819       	16225588       	4         	0         	4              	DEL       
chr13       	16201272    	16212435    	16211720       	16226123       	6         	0         	6              	DUP       
chr13       	16208123    	16208817    	16187050       	16208292       	4         	0         	4              	DUP       
chr13       	16208123    	16208817    	16201447       	16208815       	6         	0         	6              	DUP       
chr13       	16208123    	16208817    	16208124       	16208817       	4         	0         	4              	DUP       
chr13       	16208123    	16208817    	16208124       	16215334       	0         	4         	4              	DUP       
chr13       	16208123    	16208817    	16208124       	16225794       	16        	0         	16             	DUP       
chr13       	16208123    	16208817    	16208819       	16225588       	4         	0         	4              	DEL       
chr13       	16208123    	16215334    	16187050       	16208292       	4         	0         	4              	DUP       
chr13       	16208123    	16215334    	16201447       	16208815       	6         	0         	6              	DUP       
chr13       	16208123    	16215334    	16208124       	16208817       	4         	0         	4              	DUP       
chr13       	16208123    	16215334    	16185372       	16212243       	4         	0         	4              	DEL       
chr13       	16208123    	16215334    	16201273       	16212435       	8         	0         	8              	DUP       
chr13       	16208123    	16215334    	16177657       	16212436       	11        	0         	11             	DUP       
chr13       	16208123    	16215334    	16208124       	16215334       	0         	4         	4              	DUP       
chr13       	16208123    	16215334    	16195820       	16215199       	10        	0         	10             	DEL       
chr13       	16208123    	16215334    	16211779       	16217911       	6         	0         	6              	DEL       
chr13       	16208123    	16215334    	16208124       	16225794       	16        	0         	16             	DUP       
chr13       	16208123    	16215334    	16208819       	16225588       	4         	0         	4              	DEL       
chr13       	16208123    	16215334    	16211720       	16226123       	6         	0         	6              	DUP       
chr13       	16208818    	16225588    	16201447       	16208815       	6         	0         	6              	DUP       
chr13       	16208818    	16225588    	16208124       	16208817       	4         	0         	4              	DUP       
chr13       	16208818    	16225588    	16185372       	16212243       	4         	0         	4              	DEL       
chr13       	16208818    	16225588    	16201273       	16212435       	8         	0         	8              	DUP       
chr13       	16208818    	16225588    	16177657       	16212436       	11        	0         	11             	DUP       
chr13       	16208818    	16225588    	16208124       	16215334       	0         	4         	4              	DUP       
chr13       	16208818    	16225588    	16195820       	16215199       	10        	0         	10             	DEL       
chr13       	16208818    	16225588    	16175116       	16215847       	7         	0         	7              	DEL       
chr13       	16208818    	16225588    	16211779       	16217911       	6         	0         	6              	DEL       
chr13       	16208818    	16225588    	16170784       	16224906       	8         	0         	8              	DEL       
chr13       	16208818    	16225588    	16219109       	16225588       	0         	4         	4              	DEL       
chr13       	16208818    	16225588    	16208819       	16225588       	4         	0         	4              	DEL       
chr13       	16208818    	16225588    	16211720       	16226123       	6         	0         	6              	DUP       
chr13       	16208123    	16225794    	16187050       	16208292       	4         	0         	4              	DUP       
chr13       	16208123    	16225794    	16201447       	16208815       	6         	0         	6              	DUP       
chr13       	16208123    	16225794    	16208124       	16208817       	4         	0         	4              	DUP       
chr13       	16208123    	16225794    	16185372       	16212243       	4         	0         	4              	DEL       
chr13       	16208123    	16225794    	16201273       	16212435       	8         	0         	8              	DUP       
chr13       	16208123    	16225794    	16177657       	16212436       	11        	0         	11             	DUP       
chr13       	16208123    	16225794    	16208124       	16215334       	0         	4         	4              	DUP       
chr13       	16208123    	16225794    	16195820       	16215199       	10        	0         	10             	DEL       
chr13       	16208123    	16225794    	16175116       	16215847       	7         	0         	7              	DEL       
chr13       	16208123    	16225794    	16211779       	16217911       	6         	0         	6              	DEL       
chr13       	16208123    	16225794    	16170784       	16224906       	8         	0         	8              	DEL       
chr13       	16208123    	16225794    	16219109       	16225588       	0         	4         	4              	DEL       
chr13       	16208123    	16225794    	16208124       	16225794       	16        	0         	16             	DUP       
chr13       	16208123    	16225794    	16208819       	16225588       	4         	0         	4              	DEL       
chr13       	16208123    	16225794    	16211720       	16226123       	6         	0         	6              	DUP       
chr13       	16211778    	16217911    	16185372       	16212243       	4         	0         	4              	DEL       
chr13       	16211778    	16217911    	16201273       	16212435       	8         	0         	8              	DUP       
chr13       	16211778    	16217911    	16177657       	16212436       	11        	0         	11             	DUP       
chr13       	16211778    	16217911    	16208124       	16215334       	0         	4         	4              	DUP       
chr13       	16211778    	16217911    	16195820       	16215199       	10        	0         	10             	DEL       
chr13       	16211778    	16217911    	16175116       	16215847       	7         	0         	7              	DEL       
chr13       	16211778    	16217911    	16211779       	16217911       	6         	0         	6              	DEL       
chr13       	16211778    	16217911    	16211720       	16226123       	6         	0         	6              	DUP       
chr13       	16211719    	16226123    	16185372       	16212243       	4         	0         	4              	DEL       
chr13       	16211719    	16226123    	16201273       	16212435       	8         	0         	8              	DUP       
chr13       	16211719    	16226123    	16177657       	16212436       	11        	0         	11             	DUP       
chr13       	16211719    	16226123    	16208124       	16215334       	0         	4         	4              	DUP       
chr13       	16211719    	16226123    	16195820       	16215199       	10        	0         	10             	DEL       
chr13       	16211719    	16226123    	16175116       	16215847       	7         	0         	7              	DEL       
chr13       	16211719    	16226123    	16211779       	16217911       	6         	0         	6              	DEL       
chr13       	16211719    	16226123    	16170784       	16224906       	8         	0         	8              	DEL       
chr13       	16211719    	16226123    	16219109       	16225588       	0         	4         	4              	DEL       
chr13       	16211719    	16226123    	16208124       	16225794       	16        	0         	16             	DUP       
chr13       	16211719    	16226123    	16208819       	16225588       	4         	0         	4              	DEL       
chr13       	16211719    	16226123    	16187105       	16226111       	5         	0         	5              	DUP       
chr13       	16211719    	16226123    	16211720       	16226123       	6         	0         	6              	DUP       
chr13       	16219108    	16225588    	16170784       	16224906       	8         	0         	8              	DEL       
chr13       	16219108    	16225588    	16219109       	16225588       	0         	4         	4              	DEL       
chr13       	16219108    	16225588    	16208819       	16225588       	4         	0         	4              	DEL       
chr13       	16257224    	16257927    	16257225       	16257927       	24        	0         	24             	DUP       
chr13       	16256776    	16258136    	16257225       	16257927       	24        	0         	24             	DUP       
chr13       	16256776    	16258136    	16258104       	16259383       	35        	0         	35             	DUP       
chr13       	16256776    	16258136    	16256777       	16258136       	30        	0         	30             	DEL       
chr13       	16256590    	16259411    	16257225       	16257927       	24        	0         	24             	DUP       
chr13       	16256590    	16259411    	16258104       	16259383       	35        	0         	35             	DUP       
chr13       	16256590    	16259411    	16256777       	16258136       	30        	0         	30             	DEL       
chr13       	16256590    	16259411    	16256591       	16259411       	31        	0         	31             	DUP       
chr13       	16258103    	16259383    	16258104       	16259383       	35        	0         	35             	DUP       
chr13       	16258103    	16259383    	16256777       	16258136       	30        	0         	30             	DEL       
chr13       	16258103    	16259383    	16256591       	16259411       	31        	0         	31             	DUP       
chr13       	16263735    	16271173    	16263736       	16271173       	4         	0         	4              	DEL       
chr13       	16263735    	16271173    	16264894       	16277627       	9         	0         	9              	DUP       
chr13       	16263735    	16271173    	16264422       	16277412       	6         	0         	6              	DEL       
chr13       	16264421    	16277412    	16263736       	16271173       	4         	0         	4              	DEL       
chr13       	16264421    	16277412    	16264894       	16277627       	9         	0         	9              	DUP       
chr13       	16264421    	16277412    	16264422       	16277412       	6         	0         	6              	DEL       
chr13       	16264893    	16277627    	16263736       	16271173       	4         	0         	4              	DEL       
chr13       	16264893    	16277627    	16264894       	16277627       	9         	0         	9              	DUP       
chr13       	16264893    	16277627    	16264422       	16277412       	6         	0         	6              	DEL       
chr13       	16279198    	16280700    	16279199       	16280700       	5         	0         	5              	DUP       
chr13       	16298532    	16385637    	16326913       	16344784       	11        	0         	11             	DEL       
chr13       	16298532    	16385637    	16344855       	16358473       	5         	0         	5              	DUP       
chr13       	16298532    	16385637    	16298533       	16385637       	4         	0         	4              	DUP       
chr13       	16298532    	16385637    	16385646       	16426979       	4         	0         	4              	DEL       
chr13       	16298532    	16385637    	16345081       	16624283       	16        	0         	16             	DEL       
chr13       	16298532    	16385637    	16326652       	16653511       	6         	0         	6              	DUP       
chr13       	16298532    	16385637    	16358206       	16653525       	9         	0         	9              	DUP       
chr13       	16298532    	16385637    	16316243       	16795881       	6         	0         	6              	DEL       
chr13       	16298532    	16385637    	16335056       	16871402       	5         	0         	5              	DUP       
chr13       	16298532    	16385637    	16326634       	17149130       	25        	0         	25             	DUP       
chr13       	16298532    	16385637    	16358190       	17149133       	21        	0         	21             	DUP       
chr13       	16298532    	16385637    	16326891       	17234013       	6         	0         	6              	DEL       
chr13       	16298532    	16385637    	16350419       	17308037       	6         	0         	6              	DEL       
chr13       	16298532    	16385637    	16334420       	17384617       	8         	0         	8              	DUP       
chr13       	16316242    	16795881    	16421724       	17186516       	4         	0         	4              	DUP       
chr13       	16316242    	16795881    	16441597       	17384290       	5         	0         	5              	DEL       
chr13       	16316242    	16795881    	16326913       	16344784       	11        	0         	11             	DEL       
chr13       	16316242    	16795881    	16344855       	16358473       	5         	0         	5              	DUP       
chr13       	16316242    	16795881    	16298533       	16385637       	4         	0         	4              	DUP       
chr13       	16316242    	16795881    	16385646       	16426979       	4         	0         	4              	DEL       
chr13       	16316242    	16795881    	16447112       	16607356       	5         	0         	5              	DUP       
chr13       	16316242    	16795881    	16345081       	16624283       	16        	0         	16             	DEL       
chr13       	16316242    	16795881    	16326652       	16653511       	6         	0         	6              	DUP       
chr13       	16316242    	16795881    	16358206       	16653525       	9         	0         	9              	DUP       
chr13       	16316242    	16795881    	16316243       	16795881       	6         	0         	6              	DEL       
chr13       	16316242    	16795881    	16335056       	16871402       	5         	0         	5              	DUP       
chr13       	16316242    	16795881    	16545807       	16871215       	10        	0         	10             	DEL       
chr13       	16316242    	16795881    	16527018       	16906946       	14        	0         	14             	DEL       
chr13       	16316242    	16795881    	16426040       	16940868       	8         	0         	8              	DEL       
chr13       	16316242    	16795881    	16423786       	16988277       	5         	0         	5              	DUP       
chr13       	16316242    	16795881    	16758343       	16988288       	7         	0         	7              	DUP       
chr13       	16316242    	16795881    	16660100       	16995462       	4         	0         	4              	DEL       
chr13       	16316242    	16795881    	16662346       	16995675       	6         	0         	6              	DUP       
chr13       	16316242    	16795881    	16526728       	17086624       	7         	0         	7              	DUP       
chr13       	16316242    	16795881    	16697712       	17148621       	28        	0         	28             	DEL       
chr13       	16316242    	16795881    	16653275       	17149091       	21        	0         	21             	DUP       
chr13       	16316242    	16795881    	16326634       	17149130       	25        	0         	25             	DUP       
chr13       	16316242    	16795881    	16358190       	17149133       	21        	0         	21             	DUP       
chr13       	16316242    	16795881    	16424005       	17173188       	8         	0         	8              	DEL       
chr13       	16316242    	16795881    	16758779       	17172966       	20        	0         	20             	DEL       
chr13       	16316242    	16795881    	16326891       	17234013       	6         	0         	6              	DEL       
chr13       	16316242    	16795881    	16718018       	17307939       	5         	0         	5              	DEL       
chr13       	16316242    	16795881    	16545501       	17308424       	10        	0         	10             	DUP       
chr13       	16316242    	16795881    	16350419       	17308037       	6         	0         	6              	DEL       
chr13       	16316242    	16795881    	16624662       	17327973       	9         	0         	9              	DEL       
chr13       	16316242    	16795881    	16653266       	17361473       	6         	0         	6              	DUP       
chr13       	16316242    	16795881    	16697709       	17361190       	11        	0         	11             	DEL       
chr13       	16316242    	16795881    	16334420       	17384617       	8         	0         	8              	DUP       
chr13       	16316242    	16795881    	16624630       	17396078       	10        	0         	10             	DEL       
chr13       	16327070    	16344667    	16335056       	16871402       	5         	0         	5              	DUP       
chr13       	16327070    	16344667    	16334420       	17384617       	8         	0         	8              	DUP       
chr13       	16326651    	16653511    	16421724       	17186516       	4         	0         	4              	DUP       
chr13       	16326651    	16653511    	16441597       	17384290       	5         	0         	5              	DEL       
chr13       	16326651    	16653511    	16326913       	16344784       	11        	0         	11             	DEL       
chr13       	16326651    	16653511    	16344855       	16358473       	5         	0         	5              	DUP       
chr13       	16326651    	16653511    	16298533       	16385637       	4         	0         	4              	DUP       
chr13       	16326651    	16653511    	16385646       	16426979       	4         	0         	4              	DEL       
chr13       	16326651    	16653511    	16447112       	16607356       	5         	0         	5              	DUP       
chr13       	16326651    	16653511    	16345081       	16624283       	16        	0         	16             	DEL       
chr13       	16326651    	16653511    	16326652       	16653511       	6         	0         	6              	DUP       
chr13       	16326651    	16653511    	16358206       	16653525       	9         	0         	9              	DUP       
chr13       	16326651    	16653511    	16335056       	16871402       	5         	0         	5              	DUP       
chr13       	16326651    	16653511    	16545807       	16871215       	10        	0         	10             	DEL       
chr13       	16326651    	16653511    	16527018       	16906946       	14        	0         	14             	DEL       
chr13       	16326651    	16653511    	16426040       	16940868       	8         	0         	8              	DEL       
chr13       	16326651    	16653511    	16423786       	16988277       	5         	0         	5              	DUP       
chr13       	16326651    	16653511    	16526728       	17086624       	7         	0         	7              	DUP       
chr13       	16326651    	16653511    	16653275       	17149091       	21        	0         	21             	DUP       
chr13       	16326651    	16653511    	16326634       	17149130       	25        	0         	25             	DUP       
chr13       	16326651    	16653511    	16358190       	17149133       	21        	0         	21             	DUP       
chr13       	16326651    	16653511    	16424005       	17173188       	8         	0         	8              	DEL       
chr13       	16326651    	16653511    	16326891       	17234013       	6         	0         	6              	DEL       
chr13       	16326651    	16653511    	16545501       	17308424       	10        	0         	10             	DUP       
chr13       	16326651    	16653511    	16350419       	17308037       	6         	0         	6              	DEL       
chr13       	16326651    	16653511    	16624662       	17327973       	9         	0         	9              	DEL       
chr13       	16326651    	16653511    	16653266       	17361473       	6         	0         	6              	DUP       
chr13       	16326651    	16653511    	16334420       	17384617       	8         	0         	8              	DUP       
chr13       	16326651    	16653511    	16624630       	17396078       	10        	0         	10             	DEL       
chr13       	16326633    	17149130    	16421724       	17186516       	4         	0         	4              	DUP       
chr13       	16326633    	17149130    	17039759       	17268359       	6         	0         	6              	DUP       
chr13       	16326633    	17149130    	16441597       	17384290       	5         	0         	5              	DEL       
chr13       	16326633    	17149130    	16992912       	17384297       	10        	0         	10             	DEL       
chr13       	16326633    	17149130    	16326913       	16344784       	11        	0         	11             	DEL       
chr13       	16326633    	17149130    	16344855       	16358473       	5         	0         	5              	DUP       
chr13       	16326633    	17149130    	16298533       	16385637       	4         	0         	4              	DUP       
chr13       	16326633    	17149130    	16385646       	16426979       	4         	0         	4              	DEL       
chr13       	16326633    	17149130    	16447112       	16607356       	5         	0         	5              	DUP       
chr13       	16326633    	17149130    	16345081       	16624283       	16        	0         	16             	DEL       
chr13       	16326633    	17149130    	16326652       	16653511       	6         	0         	6              	DUP       
chr13       	16326633    	17149130    	16358206       	16653525       	9         	0         	9              	DUP       
chr13       	16326633    	17149130    	16316243       	16795881       	6         	0         	6              	DEL       
chr13       	16326633    	17149130    	16845048       	16857406       	11        	0         	11             	DEL       
chr13       	16326633    	17149130    	16335056       	16871402       	5         	0         	5              	DUP       
chr13       	16326633    	17149130    	16545807       	16871215       	10        	0         	10             	DEL       
chr13       	16326633    	17149130    	16857691       	16894606       	8         	0         	8              	DEL       
chr13       	16326633    	17149130    	16871420       	16894588       	6         	0         	6              	DEL       
chr13       	16326633    	17149130    	16527018       	16906946       	14        	0         	14             	DEL       
chr13       	16326633    	17149130    	16426040       	16940868       	8         	0         	8              	DEL       
chr13       	16326633    	17149130    	16423786       	16988277       	5         	0         	5              	DUP       
chr13       	16326633    	17149130    	16758343       	16988288       	7         	0         	7              	DUP       
chr13       	16326633    	17149130    	16660100       	16995462       	4         	0         	4              	DEL       
chr13       	16326633    	17149130    	16662346       	16995675       	6         	0         	6              	DUP       
chr13       	16326633    	17149130    	16526728       	17086624       	7         	0         	7              	DUP       
chr13       	16326633    	17149130    	16907030       	17146929       	7         	0         	7              	DUP       
chr13       	16326633    	17149130    	17086703       	17146669       	9         	0         	9              	DEL       
chr13       	16326633    	17149130    	16697712       	17148621       	28        	0         	28             	DEL       
chr13       	16326633    	17149130    	16653275       	17149091       	21        	0         	21             	DUP       
chr13       	16326633    	17149130    	16326634       	17149130       	25        	0         	25             	DUP       
chr13       	16326633    	17149130    	16358190       	17149133       	21        	0         	21             	DUP       
chr13       	16326633    	17149130    	16424005       	17173188       	8         	0         	8              	DEL       
chr13       	16326633    	17149130    	16758779       	17172966       	20        	0         	20             	DEL       
chr13       	16326633    	17149130    	16326891       	17234013       	6         	0         	6              	DEL       
chr13       	16326633    	17149130    	16857428       	17287609       	9         	0         	9              	DUP       
chr13       	16326633    	17149130    	16844815       	17287618       	5         	0         	5              	DUP       
chr13       	16326633    	17149130    	16962335       	17287626       	5         	0         	5              	DUP       
chr13       	16326633    	17149130    	16718018       	17307939       	5         	0         	5              	DEL       
chr13       	16326633    	17149130    	16545501       	17308424       	10        	0         	10             	DUP       
chr13       	16326633    	17149130    	16350419       	17308037       	6         	0         	6              	DEL       
chr13       	16326633    	17149130    	16624662       	17327973       	9         	0         	9              	DEL       
chr13       	16326633    	17149130    	17148658       	17361465       	28        	0         	28             	DUP       
chr13       	16326633    	17149130    	16653266       	17361473       	6         	0         	6              	DUP       
chr13       	16326633    	17149130    	16697709       	17361190       	11        	0         	11             	DEL       
chr13       	16326633    	17149130    	16894614       	17366001       	5         	0         	5              	DUP       
chr13       	16326633    	17149130    	16871215       	17366002       	6         	0         	6              	DUP       
chr13       	16326633    	17149130    	16334420       	17384617       	8         	0         	8              	DUP       
chr13       	16326633    	17149130    	16624630       	17396078       	10        	0         	10             	DEL       
chr13       	16326633    	17149130    	16857655       	17412405       	5         	0         	5              	DEL       
chr13       	16326890    	17234013    	16421724       	17186516       	4         	0         	4              	DUP       
chr13       	16326890    	17234013    	17039759       	17268359       	6         	0         	6              	DUP       
chr13       	16326890    	17234013    	16441597       	17384290       	5         	0         	5              	DEL       
chr13       	16326890    	17234013    	16992912       	17384297       	10        	0         	10             	DEL       
chr13       	16326890    	17234013    	16326913       	16344784       	11        	0         	11             	DEL       
chr13       	16326890    	17234013    	16344855       	16358473       	5         	0         	5              	DUP       
chr13       	16326890    	17234013    	16298533       	16385637       	4         	0         	4              	DUP       
chr13       	16326890    	17234013    	16385646       	16426979       	4         	0         	4              	DEL       
chr13       	16326890    	17234013    	16447112       	16607356       	5         	0         	5              	DUP       
chr13       	16326890    	17234013    	16345081       	16624283       	16        	0         	16             	DEL       
chr13       	16326890    	17234013    	16326652       	16653511       	6         	0         	6              	DUP       
chr13       	16326890    	17234013    	16358206       	16653525       	9         	0         	9              	DUP       
chr13       	16326890    	17234013    	16316243       	16795881       	6         	0         	6              	DEL       
chr13       	16326890    	17234013    	16845048       	16857406       	11        	0         	11             	DEL       
chr13       	16326890    	17234013    	16335056       	16871402       	5         	0         	5              	DUP       
chr13       	16326890    	17234013    	16545807       	16871215       	10        	0         	10             	DEL       
chr13       	16326890    	17234013    	16857691       	16894606       	8         	0         	8              	DEL       
chr13       	16326890    	17234013    	16871420       	16894588       	6         	0         	6              	DEL       
chr13       	16326890    	17234013    	16527018       	16906946       	14        	0         	14             	DEL       
chr13       	16326890    	17234013    	16426040       	16940868       	8         	0         	8              	DEL       
chr13       	16326890    	17234013    	16423786       	16988277       	5         	0         	5              	DUP       
chr13       	16326890    	17234013    	16758343       	16988288       	7         	0         	7              	DUP       
chr13       	16326890    	17234013    	16660100       	16995462       	4         	0         	4              	DEL       
chr13       	16326890    	17234013    	16662346       	16995675       	6         	0         	6              	DUP       
chr13       	16326890    	17234013    	16526728       	17086624       	7         	0         	7              	DUP       
chr13       	16326890    	17234013    	16907030       	17146929       	7         	0         	7              	DUP       
chr13       	16326890    	17234013    	17086703       	17146669       	9         	0         	9              	DEL       
chr13       	16326890    	17234013    	16697712       	17148621       	28        	0         	28             	DEL       
chr13       	16326890    	17234013    	16653275       	17149091       	21        	0         	21             	DUP       
chr13       	16326890    	17234013    	16326634       	17149130       	25        	0         	25             	DUP       
chr13       	16326890    	17234013    	16358190       	17149133       	21        	0         	21             	DUP       
chr13       	16326890    	17234013    	16424005       	17173188       	8         	0         	8              	DEL       
chr13       	16326890    	17234013    	16758779       	17172966       	20        	0         	20             	DEL       
chr13       	16326890    	17234013    	16326891       	17234013       	6         	0         	6              	DEL       
chr13       	16326890    	17234013    	16857428       	17287609       	9         	0         	9              	DUP       
chr13       	16326890    	17234013    	16844815       	17287618       	5         	0         	5              	DUP       
chr13       	16326890    	17234013    	16962335       	17287626       	5         	0         	5              	DUP       
chr13       	16326890    	17234013    	17225277       	17291012       	4         	0         	4              	DEL       
chr13       	16326890    	17234013    	16718018       	17307939       	5         	0         	5              	DEL       
chr13       	16326890    	17234013    	16545501       	17308424       	10        	0         	10             	DUP       
chr13       	16326890    	17234013    	16350419       	17308037       	6         	0         	6              	DEL       
chr13       	16326890    	17234013    	16624662       	17327973       	9         	0         	9              	DEL       
chr13       	16326890    	17234013    	17148658       	17361465       	28        	0         	28             	DUP       
chr13       	16326890    	17234013    	16653266       	17361473       	6         	0         	6              	DUP       
chr13       	16326890    	17234013    	16697709       	17361190       	11        	0         	11             	DEL       
chr13       	16326890    	17234013    	16894614       	17366001       	5         	0         	5              	DUP       
chr13       	16326890    	17234013    	16871215       	17366002       	6         	0         	6              	DUP       
chr13       	16326890    	17234013    	16334420       	17384617       	8         	0         	8              	DUP       
chr13       	16326890    	17234013    	16624630       	17396078       	10        	0         	10             	DEL       
chr13       	16326890    	17234013    	16857655       	17412405       	5         	0         	5              	DEL       
chr13       	16335055    	16871402    	16421724       	17186516       	4         	0         	4              	DUP       
chr13       	16335055    	16871402    	16441597       	17384290       	5         	0         	5              	DEL       
chr13       	16335055    	16871402    	16326913       	16344784       	11        	0         	11             	DEL       
chr13       	16335055    	16871402    	16344855       	16358473       	5         	0         	5              	DUP       
chr13       	16335055    	16871402    	16298533       	16385637       	4         	0         	4              	DUP       
chr13       	16335055    	16871402    	16385646       	16426979       	4         	0         	4              	DEL       
chr13       	16335055    	16871402    	16447112       	16607356       	5         	0         	5              	DUP       
chr13       	16335055    	16871402    	16345081       	16624283       	16        	0         	16             	DEL       
chr13       	16335055    	16871402    	16326652       	16653511       	6         	0         	6              	DUP       
chr13       	16335055    	16871402    	16358206       	16653525       	9         	0         	9              	DUP       
chr13       	16335055    	16871402    	16316243       	16795881       	6         	0         	6              	DEL       
chr13       	16335055    	16871402    	16845048       	16857406       	11        	0         	11             	DEL       
chr13       	16335055    	16871402    	16335056       	16871402       	5         	0         	5              	DUP       
chr13       	16335055    	16871402    	16545807       	16871215       	10        	0         	10             	DEL       
chr13       	16335055    	16871402    	16857691       	16894606       	8         	0         	8              	DEL       
chr13       	16335055    	16871402    	16871420       	16894588       	6         	0         	6              	DEL       
chr13       	16335055    	16871402    	16527018       	16906946       	14        	0         	14             	DEL       
chr13       	16335055    	16871402    	16426040       	16940868       	8         	0         	8              	DEL       
chr13       	16335055    	16871402    	16423786       	16988277       	5         	0         	5              	DUP       
chr13       	16335055    	16871402    	16758343       	16988288       	7         	0         	7              	DUP       
chr13       	16335055    	16871402    	16660100       	16995462       	4         	0         	4              	DEL       
chr13       	16335055    	16871402    	16662346       	16995675       	6         	0         	6              	DUP       
chr13       	16335055    	16871402    	16526728       	17086624       	7         	0         	7              	DUP       
chr13       	16335055    	16871402    	16697712       	17148621       	28        	0         	28             	DEL       
chr13       	16335055    	16871402    	16653275       	17149091       	21        	0         	21             	DUP       
chr13       	16335055    	16871402    	16358190       	17149133       	21        	0         	21             	DUP       
chr13       	16335055    	16871402    	16424005       	17173188       	8         	0         	8              	DEL       
chr13       	16335055    	16871402    	16758779       	17172966       	20        	0         	20             	DEL       
chr13       	16335055    	16871402    	16857428       	17287609       	9         	0         	9              	DUP       
chr13       	16335055    	16871402    	16844815       	17287618       	5         	0         	5              	DUP       
chr13       	16335055    	16871402    	16718018       	17307939       	5         	0         	5              	DEL       
chr13       	16335055    	16871402    	16545501       	17308424       	10        	0         	10             	DUP       
chr13       	16335055    	16871402    	16350419       	17308037       	6         	0         	6              	DEL       
chr13       	16335055    	16871402    	16624662       	17327973       	9         	0         	9              	DEL       
chr13       	16335055    	16871402    	16653266       	17361473       	6         	0         	6              	DUP       
chr13       	16335055    	16871402    	16697709       	17361190       	11        	0         	11             	DEL       
chr13       	16335055    	16871402    	16871215       	17366002       	6         	0         	6              	DUP       
chr13       	16335055    	16871402    	16624630       	17396078       	10        	0         	10             	DEL       
chr13       	16335055    	16871402    	16857655       	17412405       	5         	0         	5              	DEL       
chr13       	16334282    	17384739    	16421724       	17186516       	4         	0         	4              	DUP       
chr13       	16334282    	17384739    	17039759       	17268359       	6         	0         	6              	DUP       
chr13       	16334282    	17384739    	16441597       	17384290       	5         	0         	5              	DEL       
chr13       	16334282    	17384739    	16992912       	17384297       	10        	0         	10             	DEL       
chr13       	16334282    	17384739    	16326913       	16344784       	11        	0         	11             	DEL       
chr13       	16334282    	17384739    	16344855       	16358473       	5         	0         	5              	DUP       
chr13       	16334282    	17384739    	16298533       	16385637       	4         	0         	4              	DUP       
chr13       	16334282    	17384739    	16385646       	16426979       	4         	0         	4              	DEL       
chr13       	16334282    	17384739    	16447112       	16607356       	5         	0         	5              	DUP       
chr13       	16334282    	17384739    	16345081       	16624283       	16        	0         	16             	DEL       
chr13       	16334282    	17384739    	16326652       	16653511       	6         	0         	6              	DUP       
chr13       	16334282    	17384739    	16358206       	16653525       	9         	0         	9              	DUP       
chr13       	16334282    	17384739    	16316243       	16795881       	6         	0         	6              	DEL       
chr13       	16334282    	17384739    	16845048       	16857406       	11        	0         	11             	DEL       
chr13       	16334282    	17384739    	16335056       	16871402       	5         	0         	5              	DUP       
chr13       	16334282    	17384739    	16545807       	16871215       	10        	0         	10             	DEL       
chr13       	16334282    	17384739    	16857691       	16894606       	8         	0         	8              	DEL       
chr13       	16334282    	17384739    	16871420       	16894588       	6         	0         	6              	DEL       
chr13       	16334282    	17384739    	16527018       	16906946       	14        	0         	14             	DEL       
chr13       	16334282    	17384739    	16426040       	16940868       	8         	0         	8              	DEL       
chr13       	16334282    	17384739    	16423786       	16988277       	5         	0         	5              	DUP       
chr13       	16334282    	17384739    	16758343       	16988288       	7         	0         	7              	DUP       
chr13       	16334282    	17384739    	16660100       	16995462       	4         	0         	4              	DEL       
chr13       	16334282    	17384739    	16662346       	16995675       	6         	0         	6              	DUP       
chr13       	16334282    	17384739    	16526728       	17086624       	7         	0         	7              	DUP       
chr13       	16334282    	17384739    	16907030       	17146929       	7         	0         	7              	DUP       
chr13       	16334282    	17384739    	17086703       	17146669       	9         	0         	9              	DEL       
chr13       	16334282    	17384739    	16697712       	17148621       	28        	0         	28             	DEL       
chr13       	16334282    	17384739    	16653275       	17149091       	21        	0         	21             	DUP       
chr13       	16334282    	17384739    	16326634       	17149130       	25        	0         	25             	DUP       
chr13       	16334282    	17384739    	16358190       	17149133       	21        	0         	21             	DUP       
chr13       	16334282    	17384739    	16424005       	17173188       	8         	0         	8              	DEL       
chr13       	16334282    	17384739    	16758779       	17172966       	20        	0         	20             	DEL       
chr13       	16334282    	17384739    	16326891       	17234013       	6         	0         	6              	DEL       
chr13       	16334282    	17384739    	16857428       	17287609       	9         	0         	9              	DUP       
chr13       	16334282    	17384739    	16844815       	17287618       	5         	0         	5              	DUP       
chr13       	16334282    	17384739    	16962335       	17287626       	5         	0         	5              	DUP       
chr13       	16334282    	17384739    	17225277       	17291012       	4         	0         	4              	DEL       
chr13       	16334282    	17384739    	16718018       	17307939       	5         	0         	5              	DEL       
chr13       	16334282    	17384739    	16545501       	17308424       	10        	0         	10             	DUP       
chr13       	16334282    	17384739    	16350419       	17308037       	6         	0         	6              	DEL       
chr13       	16334282    	17384739    	17287337       	17328210       	6         	0         	6              	DUP       
chr13       	16334282    	17384739    	16624662       	17327973       	9         	0         	9              	DEL       
chr13       	16334282    	17384739    	17235839       	17331249       	11        	0         	11             	DUP       
chr13       	16334282    	17384739    	17148658       	17361465       	28        	0         	28             	DUP       
chr13       	16334282    	17384739    	16653266       	17361473       	6         	0         	6              	DUP       
chr13       	16334282    	17384739    	16697709       	17361190       	11        	0         	11             	DEL       
chr13       	16334282    	17384739    	17308432       	17365778       	6         	0         	6              	DEL       
chr13       	16334282    	17384739    	16894614       	17366001       	5         	0         	5              	DUP       
chr13       	16334282    	17384739    	16871215       	17366002       	6         	0         	6              	DUP       
chr13       	16334282    	17384739    	16334420       	17384617       	8         	0         	8              	DUP       
chr13       	16334282    	17384739    	16624630       	17396078       	10        	0         	10             	DEL       
chr13       	16334282    	17384739    	17287341       	17396324       	8         	0         	8              	DUP       
chr13       	16334282    	17384739    	16857655       	17412405       	5         	0         	5              	DEL       
chr13       	16344783    	16358429    	16326913       	16344784       	11        	0         	11             	DEL       
chr13       	16344783    	16358429    	16344855       	16358473       	5         	0         	5              	DUP       
chr13       	16344783    	16358429    	16345081       	16624283       	16        	0         	16             	DEL       
chr13       	16344783    	16358429    	16358206       	16653525       	9         	0         	9              	DUP       
chr13       	16344783    	16358429    	16358190       	17149133       	21        	0         	21             	DUP       
chr13       	16344783    	16358429    	16350419       	17308037       	6         	0         	6              	DEL       
chr13       	16345080    	16624283    	16421724       	17186516       	4         	0         	4              	DUP       
chr13       	16345080    	16624283    	16441597       	17384290       	5         	0         	5              	DEL       
chr13       	16345080    	16624283    	16344855       	16358473       	5         	0         	5              	DUP       
chr13       	16345080    	16624283    	16298533       	16385637       	4         	0         	4              	DUP       
chr13       	16345080    	16624283    	16385646       	16426979       	4         	0         	4              	DEL       
chr13       	16345080    	16624283    	16447112       	16607356       	5         	0         	5              	DUP       
chr13       	16345080    	16624283    	16345081       	16624283       	16        	0         	16             	DEL       
chr13       	16345080    	16624283    	16358206       	16653525       	9         	0         	9              	DUP       
chr13       	16345080    	16624283    	16545807       	16871215       	10        	0         	10             	DEL       
chr13       	16345080    	16624283    	16527018       	16906946       	14        	0         	14             	DEL       
chr13       	16345080    	16624283    	16426040       	16940868       	8         	0         	8              	DEL       
chr13       	16345080    	16624283    	16423786       	16988277       	5         	0         	5              	DUP       
chr13       	16345080    	16624283    	16526728       	17086624       	7         	0         	7              	DUP       
chr13       	16345080    	16624283    	16358190       	17149133       	21        	0         	21             	DUP       
chr13       	16345080    	16624283    	16424005       	17173188       	8         	0         	8              	DEL       
chr13       	16345080    	16624283    	16545501       	17308424       	10        	0         	10             	DUP       
chr13       	16345080    	16624283    	16350419       	17308037       	6         	0         	6              	DEL       
chr13       	16350418    	17308037    	16421724       	17186516       	4         	0         	4              	DUP       
chr13       	16350418    	17308037    	17039759       	17268359       	6         	0         	6              	DUP       
chr13       	16350418    	17308037    	16441597       	17384290       	5         	0         	5              	DEL       
chr13       	16350418    	17308037    	16992912       	17384297       	10        	0         	10             	DEL       
chr13       	16350418    	17308037    	16344855       	16358473       	5         	0         	5              	DUP       
chr13       	16350418    	17308037    	16298533       	16385637       	4         	0         	4              	DUP       
chr13       	16350418    	17308037    	16385646       	16426979       	4         	0         	4              	DEL       
chr13       	16350418    	17308037    	16447112       	16607356       	5         	0         	5              	DUP       
chr13       	16350418    	17308037    	16345081       	16624283       	16        	0         	16             	DEL       
chr13       	16350418    	17308037    	16326652       	16653511       	6         	0         	6              	DUP       
chr13       	16350418    	17308037    	16358206       	16653525       	9         	0         	9              	DUP       
chr13       	16350418    	17308037    	16316243       	16795881       	6         	0         	6              	DEL       
chr13       	16350418    	17308037    	16845048       	16857406       	11        	0         	11             	DEL       
chr13       	16350418    	17308037    	16335056       	16871402       	5         	0         	5              	DUP       
chr13       	16350418    	17308037    	16545807       	16871215       	10        	0         	10             	DEL       
chr13       	16350418    	17308037    	16857691       	16894606       	8         	0         	8              	DEL       
chr13       	16350418    	17308037    	16871420       	16894588       	6         	0         	6              	DEL       
chr13       	16350418    	17308037    	16527018       	16906946       	14        	0         	14             	DEL       
chr13       	16350418    	17308037    	16426040       	16940868       	8         	0         	8              	DEL       
chr13       	16350418    	17308037    	16423786       	16988277       	5         	0         	5              	DUP       
chr13       	16350418    	17308037    	16758343       	16988288       	7         	0         	7              	DUP       
chr13       	16350418    	17308037    	16660100       	16995462       	4         	0         	4              	DEL       
chr13       	16350418    	17308037    	16662346       	16995675       	6         	0         	6              	DUP       
chr13       	16350418    	17308037    	16526728       	17086624       	7         	0         	7              	DUP       
chr13       	16350418    	17308037    	16907030       	17146929       	7         	0         	7              	DUP       
chr13       	16350418    	17308037    	17086703       	17146669       	9         	0         	9              	DEL       
chr13       	16350418    	17308037    	16697712       	17148621       	28        	0         	28             	DEL       
chr13       	16350418    	17308037    	16653275       	17149091       	21        	0         	21             	DUP       
chr13       	16350418    	17308037    	16326634       	17149130       	25        	0         	25             	DUP       
chr13       	16350418    	17308037    	16358190       	17149133       	21        	0         	21             	DUP       
chr13       	16350418    	17308037    	16424005       	17173188       	8         	0         	8              	DEL       
chr13       	16350418    	17308037    	16758779       	17172966       	20        	0         	20             	DEL       
chr13       	16350418    	17308037    	16326891       	17234013       	6         	0         	6              	DEL       
chr13       	16350418    	17308037    	16857428       	17287609       	9         	0         	9              	DUP       
chr13       	16350418    	17308037    	16844815       	17287618       	5         	0         	5              	DUP       
chr13       	16350418    	17308037    	16962335       	17287626       	5         	0         	5              	DUP       
chr13       	16350418    	17308037    	17225277       	17291012       	4         	0         	4              	DEL       
chr13       	16350418    	17308037    	16718018       	17307939       	5         	0         	5              	DEL       
chr13       	16350418    	17308037    	16545501       	17308424       	10        	0         	10             	DUP       
chr13       	16350418    	17308037    	16350419       	17308037       	6         	0         	6              	DEL       
chr13       	16350418    	17308037    	17287337       	17328210       	6         	0         	6              	DUP       
chr13       	16350418    	17308037    	16624662       	17327973       	9         	0         	9              	DEL       
chr13       	16350418    	17308037    	17235839       	17331249       	11        	0         	11             	DUP       
chr13       	16350418    	17308037    	17148658       	17361465       	28        	0         	28             	DUP       
chr13       	16350418    	17308037    	16653266       	17361473       	6         	0         	6              	DUP       
chr13       	16350418    	17308037    	16697709       	17361190       	11        	0         	11             	DEL       
chr13       	16350418    	17308037    	16894614       	17366001       	5         	0         	5              	DUP       
chr13       	16350418    	17308037    	16871215       	17366002       	6         	0         	6              	DUP       
chr13       	16350418    	17308037    	16624630       	17396078       	10        	0         	10             	DEL       
chr13       	16350418    	17308037    	17287341       	17396324       	8         	0         	8              	DUP       
chr13       	16350418    	17308037    	16857655       	17412405       	5         	0         	5              	DEL       
chr13       	16358205    	16653525    	16421724       	17186516       	4         	0         	4              	DUP       
chr13       	16358205    	16653525    	16441597       	17384290       	5         	0         	5              	DEL       
chr13       	16358205    	16653525    	16344855       	16358473       	5         	0         	5              	DUP       
chr13       	16358205    	16653525    	16298533       	16385637       	4         	0         	4              	DUP       
chr13       	16358205    	16653525    	16385646       	16426979       	4         	0         	4              	DEL       
chr13       	16358205    	16653525    	16447112       	16607356       	5         	0         	5              	DUP       
chr13       	16358205    	16653525    	16345081       	16624283       	16        	0         	16             	DEL       
chr13       	16358205    	16653525    	16326652       	16653511       	6         	0         	6              	DUP       
chr13       	16358205    	16653525    	16358206       	16653525       	9         	0         	9              	DUP       
chr13       	16358205    	16653525    	16545807       	16871215       	10        	0         	10             	DEL       
chr13       	16358205    	16653525    	16527018       	16906946       	14        	0         	14             	DEL       
chr13       	16358205    	16653525    	16426040       	16940868       	8         	0         	8              	DEL       
chr13       	16358205    	16653525    	16423786       	16988277       	5         	0         	5              	DUP       
chr13       	16358205    	16653525    	16526728       	17086624       	7         	0         	7              	DUP       
chr13       	16358205    	16653525    	16653275       	17149091       	21        	0         	21             	DUP       
chr13       	16358205    	16653525    	16358190       	17149133       	21        	0         	21             	DUP       
chr13       	16358205    	16653525    	16424005       	17173188       	8         	0         	8              	DEL       
chr13       	16358205    	16653525    	16545501       	17308424       	10        	0         	10             	DUP       
chr13       	16358205    	16653525    	16624662       	17327973       	9         	0         	9              	DEL       
chr13       	16358205    	16653525    	16653266       	17361473       	6         	0         	6              	DUP       
chr13       	16358205    	16653525    	16624630       	17396078       	10        	0         	10             	DEL       
chr13       	16358189    	17149133    	16421724       	17186516       	4         	0         	4              	DUP       
chr13       	16358189    	17149133    	17039759       	17268359       	6         	0         	6              	DUP       
chr13       	16358189    	17149133    	16441597       	17384290       	5         	0         	5              	DEL       
chr13       	16358189    	17149133    	16992912       	17384297       	10        	0         	10             	DEL       
chr13       	16358189    	17149133    	16344855       	16358473       	5         	0         	5              	DUP       
chr13       	16358189    	17149133    	16298533       	16385637       	4         	0         	4              	DUP       
chr13       	16358189    	17149133    	16385646       	16426979       	4         	0         	4              	DEL       
chr13       	16358189    	17149133    	16447112       	16607356       	5         	0         	5              	DUP       
chr13       	16358189    	17149133    	16345081       	16624283       	16        	0         	16             	DEL       
chr13       	16358189    	17149133    	16326652       	16653511       	6         	0         	6              	DUP       
chr13       	16358189    	17149133    	16358206       	16653525       	9         	0         	9              	DUP       
chr13       	16358189    	17149133    	16316243       	16795881       	6         	0         	6              	DEL       
chr13       	16358189    	17149133    	16845048       	16857406       	11        	0         	11             	DEL       
chr13       	16358189    	17149133    	16335056       	16871402       	5         	0         	5              	DUP       
chr13       	16358189    	17149133    	16545807       	16871215       	10        	0         	10             	DEL       
chr13       	16358189    	17149133    	16857691       	16894606       	8         	0         	8              	DEL       
chr13       	16358189    	17149133    	16871420       	16894588       	6         	0         	6              	DEL       
chr13       	16358189    	17149133    	16527018       	16906946       	14        	0         	14             	DEL       
chr13       	16358189    	17149133    	16426040       	16940868       	8         	0         	8              	DEL       
chr13       	16358189    	17149133    	16423786       	16988277       	5         	0         	5              	DUP       
chr13       	16358189    	17149133    	16758343       	16988288       	7         	0         	7              	DUP       
chr13       	16358189    	17149133    	16660100       	16995462       	4         	0         	4              	DEL       
chr13       	16358189    	17149133    	16662346       	16995675       	6         	0         	6              	DUP       
chr13       	16358189    	17149133    	16526728       	17086624       	7         	0         	7              	DUP       
chr13       	16358189    	17149133    	16907030       	17146929       	7         	0         	7              	DUP       
chr13       	16358189    	17149133    	17086703       	17146669       	9         	0         	9              	DEL       
chr13       	16358189    	17149133    	16697712       	17148621       	28        	0         	28             	DEL       
chr13       	16358189    	17149133    	16653275       	17149091       	21        	0         	21             	DUP       
chr13       	16358189    	17149133    	16326634       	17149130       	25        	0         	25             	DUP       
chr13       	16358189    	17149133    	16358190       	17149133       	21        	0         	21             	DUP       
chr13       	16358189    	17149133    	16424005       	17173188       	8         	0         	8              	DEL       
chr13       	16358189    	17149133    	16758779       	17172966       	20        	0         	20             	DEL       
chr13       	16358189    	17149133    	16857428       	17287609       	9         	0         	9              	DUP       
chr13       	16358189    	17149133    	16844815       	17287618       	5         	0         	5              	DUP       
chr13       	16358189    	17149133    	16962335       	17287626       	5         	0         	5              	DUP       
chr13       	16358189    	17149133    	16718018       	17307939       	5         	0         	5              	DEL       
chr13       	16358189    	17149133    	16545501       	17308424       	10        	0         	10             	DUP       
chr13       	16358189    	17149133    	16624662       	17327973       	9         	0         	9              	DEL       
chr13       	16358189    	17149133    	17148658       	17361465       	28        	0         	28             	DUP       
chr13       	16358189    	17149133    	16653266       	17361473       	6         	0         	6              	DUP       
chr13       	16358189    	17149133    	16697709       	17361190       	11        	0         	11             	DEL       
chr13       	16358189    	17149133    	16894614       	17366001       	5         	0         	5              	DUP       
chr13       	16358189    	17149133    	16871215       	17366002       	6         	0         	6              	DUP       
chr13       	16358189    	17149133    	16624630       	17396078       	10        	0         	10             	DEL       
chr13       	16358189    	17149133    	16857655       	17412405       	5         	0         	5              	DEL       
chr13       	16385645    	16426979    	16421724       	17186516       	4         	0         	4              	DUP       
chr13       	16385645    	16426979    	16298533       	16385637       	4         	0         	4              	DUP       
chr13       	16385645    	16426979    	16385646       	16426979       	4         	0         	4              	DEL       
chr13       	16385645    	16426979    	16426040       	16940868       	8         	0         	8              	DEL       
chr13       	16385645    	16426979    	16423786       	16988277       	5         	0         	5              	DUP       
chr13       	16385645    	16426979    	16424005       	17173188       	8         	0         	8              	DEL       
chr13       	16421723    	17186516    	16421724       	17186516       	4         	0         	4              	DUP       
chr13       	16421723    	17186516    	17039759       	17268359       	6         	0         	6              	DUP       
chr13       	16421723    	17186516    	16441597       	17384290       	5         	0         	5              	DEL       
chr13       	16421723    	17186516    	16992912       	17384297       	10        	0         	10             	DEL       
chr13       	16421723    	17186516    	16385646       	16426979       	4         	0         	4              	DEL       
chr13       	16421723    	17186516    	16447112       	16607356       	5         	0         	5              	DUP       
chr13       	16421723    	17186516    	16345081       	16624283       	16        	0         	16             	DEL       
chr13       	16421723    	17186516    	16326652       	16653511       	6         	0         	6              	DUP       
chr13       	16421723    	17186516    	16358206       	16653525       	9         	0         	9              	DUP       
chr13       	16421723    	17186516    	16316243       	16795881       	6         	0         	6              	DEL       
chr13       	16421723    	17186516    	16845048       	16857406       	11        	0         	11             	DEL       
chr13       	16421723    	17186516    	16335056       	16871402       	5         	0         	5              	DUP       
chr13       	16421723    	17186516    	16545807       	16871215       	10        	0         	10             	DEL       
chr13       	16421723    	17186516    	16857691       	16894606       	8         	0         	8              	DEL       
chr13       	16421723    	17186516    	16871420       	16894588       	6         	0         	6              	DEL       
chr13       	16421723    	17186516    	16527018       	16906946       	14        	0         	14             	DEL       
chr13       	16421723    	17186516    	16426040       	16940868       	8         	0         	8              	DEL       
chr13       	16421723    	17186516    	16423786       	16988277       	5         	0         	5              	DUP       
chr13       	16421723    	17186516    	16758343       	16988288       	7         	0         	7              	DUP       
chr13       	16421723    	17186516    	16660100       	16995462       	4         	0         	4              	DEL       
chr13       	16421723    	17186516    	16662346       	16995675       	6         	0         	6              	DUP       
chr13       	16421723    	17186516    	16526728       	17086624       	7         	0         	7              	DUP       
chr13       	16421723    	17186516    	16907030       	17146929       	7         	0         	7              	DUP       
chr13       	16421723    	17186516    	17086703       	17146669       	9         	0         	9              	DEL       
chr13       	16421723    	17186516    	16697712       	17148621       	28        	0         	28             	DEL       
chr13       	16421723    	17186516    	16653275       	17149091       	21        	0         	21             	DUP       
chr13       	16421723    	17186516    	16326634       	17149130       	25        	0         	25             	DUP       
chr13       	16421723    	17186516    	16358190       	17149133       	21        	0         	21             	DUP       
chr13       	16421723    	17186516    	16424005       	17173188       	8         	0         	8              	DEL       
chr13       	16421723    	17186516    	16758779       	17172966       	20        	0         	20             	DEL       
chr13       	16421723    	17186516    	16857428       	17287609       	9         	0         	9              	DUP       
chr13       	16421723    	17186516    	16844815       	17287618       	5         	0         	5              	DUP       
chr13       	16421723    	17186516    	16962335       	17287626       	5         	0         	5              	DUP       
chr13       	16421723    	17186516    	16718018       	17307939       	5         	0         	5              	DEL       
chr13       	16421723    	17186516    	16545501       	17308424       	10        	0         	10             	DUP       
chr13       	16421723    	17186516    	16624662       	17327973       	9         	0         	9              	DEL       
chr13       	16421723    	17186516    	17148658       	17361465       	28        	0         	28             	DUP       
chr13       	16421723    	17186516    	16653266       	17361473       	6         	0         	6              	DUP       
chr13       	16421723    	17186516    	16697709       	17361190       	11        	0         	11             	DEL       
chr13       	16421723    	17186516    	16894614       	17366001       	5         	0         	5              	DUP       
chr13       	16421723    	17186516    	16871215       	17366002       	6         	0         	6              	DUP       
chr13       	16421723    	17186516    	16624630       	17396078       	10        	0         	10             	DEL       
chr13       	16421723    	17186516    	16857655       	17412405       	5         	0         	5              	DEL       
chr13       	16423785    	16988277    	16441597       	17384290       	5         	0         	5              	DEL       
chr13       	16423785    	16988277    	16385646       	16426979       	4         	0         	4              	DEL       
chr13       	16423785    	16988277    	16447112       	16607356       	5         	0         	5              	DUP       
chr13       	16423785    	16988277    	16345081       	16624283       	16        	0         	16             	DEL       
chr13       	16423785    	16988277    	16326652       	16653511       	6         	0         	6              	DUP       
chr13       	16423785    	16988277    	16358206       	16653525       	9         	0         	9              	DUP       
chr13       	16423785    	16988277    	16316243       	16795881       	6         	0         	6              	DEL       
chr13       	16423785    	16988277    	16845048       	16857406       	11        	0         	11             	DEL       
chr13       	16423785    	16988277    	16335056       	16871402       	5         	0         	5              	DUP       
chr13       	16423785    	16988277    	16545807       	16871215       	10        	0         	10             	DEL       
chr13       	16423785    	16988277    	16857691       	16894606       	8         	0         	8              	DEL       
chr13       	16423785    	16988277    	16871420       	16894588       	6         	0         	6              	DEL       
chr13       	16423785    	16988277    	16527018       	16906946       	14        	0         	14             	DEL       
chr13       	16423785    	16988277    	16426040       	16940868       	8         	0         	8              	DEL       
chr13       	16423785    	16988277    	16423786       	16988277       	5         	0         	5              	DUP       
chr13       	16423785    	16988277    	16758343       	16988288       	7         	0         	7              	DUP       
chr13       	16423785    	16988277    	16660100       	16995462       	4         	0         	4              	DEL       
chr13       	16423785    	16988277    	16662346       	16995675       	6         	0         	6              	DUP       
chr13       	16423785    	16988277    	16526728       	17086624       	7         	0         	7              	DUP       
chr13       	16423785    	16988277    	16907030       	17146929       	7         	0         	7              	DUP       
chr13       	16423785    	16988277    	16697712       	17148621       	28        	0         	28             	DEL       
chr13       	16423785    	16988277    	16653275       	17149091       	21        	0         	21             	DUP       
chr13       	16423785    	16988277    	16424005       	17173188       	8         	0         	8              	DEL       
chr13       	16423785    	16988277    	16758779       	17172966       	20        	0         	20             	DEL       
chr13       	16423785    	16988277    	16857428       	17287609       	9         	0         	9              	DUP       
chr13       	16423785    	16988277    	16844815       	17287618       	5         	0         	5              	DUP       
chr13       	16423785    	16988277    	16962335       	17287626       	5         	0         	5              	DUP       
chr13       	16423785    	16988277    	16718018       	17307939       	5         	0         	5              	DEL       
chr13       	16423785    	16988277    	16545501       	17308424       	10        	0         	10             	DUP       
chr13       	16423785    	16988277    	16624662       	17327973       	9         	0         	9              	DEL       
chr13       	16423785    	16988277    	16653266       	17361473       	6         	0         	6              	DUP       
chr13       	16423785    	16988277    	16697709       	17361190       	11        	0         	11             	DEL       
chr13       	16423785    	16988277    	16894614       	17366001       	5         	0         	5              	DUP       
chr13       	16423785    	16988277    	16871215       	17366002       	6         	0         	6              	DUP       
chr13       	16423785    	16988277    	16624630       	17396078       	10        	0         	10             	DEL       
chr13       	16423785    	16988277    	16857655       	17412405       	5         	0         	5              	DEL       
chr13       	16426039    	16940868    	16441597       	17384290       	5         	0         	5              	DEL       
chr13       	16426039    	16940868    	16385646       	16426979       	4         	0         	4              	DEL       
chr13       	16426039    	16940868    	16447112       	16607356       	5         	0         	5              	DUP       
chr13       	16426039    	16940868    	16345081       	16624283       	16        	0         	16             	DEL       
chr13       	16426039    	16940868    	16326652       	16653511       	6         	0         	6              	DUP       
chr13       	16426039    	16940868    	16358206       	16653525       	9         	0         	9              	DUP       
chr13       	16426039    	16940868    	16316243       	16795881       	6         	0         	6              	DEL       
chr13       	16426039    	16940868    	16845048       	16857406       	11        	0         	11             	DEL       
chr13       	16426039    	16940868    	16335056       	16871402       	5         	0         	5              	DUP       
chr13       	16426039    	16940868    	16545807       	16871215       	10        	0         	10             	DEL       
chr13       	16426039    	16940868    	16857691       	16894606       	8         	0         	8              	DEL       
chr13       	16426039    	16940868    	16871420       	16894588       	6         	0         	6              	DEL       
chr13       	16426039    	16940868    	16527018       	16906946       	14        	0         	14             	DEL       
chr13       	16426039    	16940868    	16426040       	16940868       	8         	0         	8              	DEL       
chr13       	16426039    	16940868    	16758343       	16988288       	7         	0         	7              	DUP       
chr13       	16426039    	16940868    	16660100       	16995462       	4         	0         	4              	DEL       
chr13       	16426039    	16940868    	16662346       	16995675       	6         	0         	6              	DUP       
chr13       	16426039    	16940868    	16526728       	17086624       	7         	0         	7              	DUP       
chr13       	16426039    	16940868    	16907030       	17146929       	7         	0         	7              	DUP       
chr13       	16426039    	16940868    	16697712       	17148621       	28        	0         	28             	DEL       
chr13       	16426039    	16940868    	16653275       	17149091       	21        	0         	21             	DUP       
chr13       	16426039    	16940868    	16758779       	17172966       	20        	0         	20             	DEL       
chr13       	16426039    	16940868    	16857428       	17287609       	9         	0         	9              	DUP       
chr13       	16426039    	16940868    	16844815       	17287618       	5         	0         	5              	DUP       
chr13       	16426039    	16940868    	16718018       	17307939       	5         	0         	5              	DEL       
chr13       	16426039    	16940868    	16545501       	17308424       	10        	0         	10             	DUP       
chr13       	16426039    	16940868    	16624662       	17327973       	9         	0         	9              	DEL       
chr13       	16426039    	16940868    	16653266       	17361473       	6         	0         	6              	DUP       
chr13       	16426039    	16940868    	16697709       	17361190       	11        	0         	11             	DEL       
chr13       	16426039    	16940868    	16894614       	17366001       	5         	0         	5              	DUP       
chr13       	16426039    	16940868    	16871215       	17366002       	6         	0         	6              	DUP       
chr13       	16426039    	16940868    	16624630       	17396078       	10        	0         	10             	DEL       
chr13       	16426039    	16940868    	16857655       	17412405       	5         	0         	5              	DEL       
chr13       	16441596    	17384290    	16421724       	17186516       	4         	0         	4              	DUP       
chr13       	16441596    	17384290    	17039759       	17268359       	6         	0         	6              	DUP       
chr13       	16441596    	17384290    	16441597       	17384290       	5         	0         	5              	DEL       
chr13       	16441596    	17384290    	16992912       	17384297       	10        	0         	10             	DEL       
chr13       	16441596    	17384290    	16447112       	16607356       	5         	0         	5              	DUP       
chr13       	16441596    	17384290    	16345081       	16624283       	16        	0         	16             	DEL       
chr13       	16441596    	17384290    	16326652       	16653511       	6         	0         	6              	DUP       
chr13       	16441596    	17384290    	16358206       	16653525       	9         	0         	9              	DUP       
chr13       	16441596    	17384290    	16316243       	16795881       	6         	0         	6              	DEL       
chr13       	16441596    	17384290    	16845048       	16857406       	11        	0         	11             	DEL       
chr13       	16441596    	17384290    	16335056       	16871402       	5         	0         	5              	DUP       
chr13       	16441596    	17384290    	16545807       	16871215       	10        	0         	10             	DEL       
chr13       	16441596    	17384290    	16857691       	16894606       	8         	0         	8              	DEL       
chr13       	16441596    	17384290    	16871420       	16894588       	6         	0         	6              	DEL       
chr13       	16441596    	17384290    	16527018       	16906946       	14        	0         	14             	DEL       
chr13       	16441596    	17384290    	16426040       	16940868       	8         	0         	8              	DEL       
chr13       	16441596    	17384290    	16423786       	16988277       	5         	0         	5              	DUP       
chr13       	16441596    	17384290    	16758343       	16988288       	7         	0         	7              	DUP       
chr13       	16441596    	17384290    	16660100       	16995462       	4         	0         	4              	DEL       
chr13       	16441596    	17384290    	16662346       	16995675       	6         	0         	6              	DUP       
chr13       	16441596    	17384290    	16526728       	17086624       	7         	0         	7              	DUP       
chr13       	16441596    	17384290    	16907030       	17146929       	7         	0         	7              	DUP       
chr13       	16441596    	17384290    	17086703       	17146669       	9         	0         	9              	DEL       
chr13       	16441596    	17384290    	16697712       	17148621       	28        	0         	28             	DEL       
chr13       	16441596    	17384290    	16653275       	17149091       	21        	0         	21             	DUP       
chr13       	16441596    	17384290    	16326634       	17149130       	25        	0         	25             	DUP       
chr13       	16441596    	17384290    	16358190       	17149133       	21        	0         	21             	DUP       
chr13       	16441596    	17384290    	16424005       	17173188       	8         	0         	8              	DEL       
chr13       	16441596    	17384290    	16758779       	17172966       	20        	0         	20             	DEL       
chr13       	16441596    	17384290    	16326891       	17234013       	6         	0         	6              	DEL       
chr13       	16441596    	17384290    	16857428       	17287609       	9         	0         	9              	DUP       
chr13       	16441596    	17384290    	16844815       	17287618       	5         	0         	5              	DUP       
chr13       	16441596    	17384290    	16962335       	17287626       	5         	0         	5              	DUP       
chr13       	16441596    	17384290    	17225277       	17291012       	4         	0         	4              	DEL       
chr13       	16441596    	17384290    	16718018       	17307939       	5         	0         	5              	DEL       
chr13       	16441596    	17384290    	16545501       	17308424       	10        	0         	10             	DUP       
chr13       	16441596    	17384290    	16350419       	17308037       	6         	0         	6              	DEL       
chr13       	16441596    	17384290    	17287337       	17328210       	6         	0         	6              	DUP       
chr13       	16441596    	17384290    	16624662       	17327973       	9         	0         	9              	DEL       
chr13       	16441596    	17384290    	17235839       	17331249       	11        	0         	11             	DUP       
chr13       	16441596    	17384290    	17148658       	17361465       	28        	0         	28             	DUP       
chr13       	16441596    	17384290    	16653266       	17361473       	6         	0         	6              	DUP       
chr13       	16441596    	17384290    	16697709       	17361190       	11        	0         	11             	DEL       
chr13       	16441596    	17384290    	17308432       	17365778       	6         	0         	6              	DEL       
chr13       	16441596    	17384290    	16894614       	17366001       	5         	0         	5              	DUP       
chr13       	16441596    	17384290    	16871215       	17366002       	6         	0         	6              	DUP       
chr13       	16441596    	17384290    	16624630       	17396078       	10        	0         	10             	DEL       
chr13       	16441596    	17384290    	17287341       	17396324       	8         	0         	8              	DUP       
chr13       	16441596    	17384290    	16857655       	17412405       	5         	0         	5              	DEL       
chr13       	16447111    	16607356    	16447112       	16607356       	5         	0         	5              	DUP       
chr13       	16447111    	16607356    	16545807       	16871215       	10        	0         	10             	DEL       
chr13       	16447111    	16607356    	16527018       	16906946       	14        	0         	14             	DEL       
chr13       	16447111    	16607356    	16526728       	17086624       	7         	0         	7              	DUP       
chr13       	16447111    	16607356    	16545501       	17308424       	10        	0         	10             	DUP       
chr13       	16527017    	16906946    	16447112       	16607356       	5         	0         	5              	DUP       
chr13       	16527017    	16906946    	16345081       	16624283       	16        	0         	16             	DEL       
chr13       	16527017    	16906946    	16326652       	16653511       	6         	0         	6              	DUP       
chr13       	16527017    	16906946    	16358206       	16653525       	9         	0         	9              	DUP       
chr13       	16527017    	16906946    	16316243       	16795881       	6         	0         	6              	DEL       
chr13       	16527017    	16906946    	16845048       	16857406       	11        	0         	11             	DEL       
chr13       	16527017    	16906946    	16335056       	16871402       	5         	0         	5              	DUP       
chr13       	16527017    	16906946    	16545807       	16871215       	10        	0         	10             	DEL       
chr13       	16527017    	16906946    	16857691       	16894606       	8         	0         	8              	DEL       
chr13       	16527017    	16906946    	16871420       	16894588       	6         	0         	6              	DEL       
chr13       	16527017    	16906946    	16527018       	16906946       	14        	0         	14             	DEL       
chr13       	16527017    	16906946    	16758343       	16988288       	7         	0         	7              	DUP       
chr13       	16527017    	16906946    	16660100       	16995462       	4         	0         	4              	DEL       
chr13       	16527017    	16906946    	16662346       	16995675       	6         	0         	6              	DUP       
chr13       	16527017    	16906946    	16907030       	17146929       	7         	0         	7              	DUP       
chr13       	16527017    	16906946    	16697712       	17148621       	28        	0         	28             	DEL       
chr13       	16527017    	16906946    	16653275       	17149091       	21        	0         	21             	DUP       
chr13       	16527017    	16906946    	16758779       	17172966       	20        	0         	20             	DEL       
chr13       	16527017    	16906946    	16857428       	17287609       	9         	0         	9              	DUP       
chr13       	16527017    	16906946    	16844815       	17287618       	5         	0         	5              	DUP       
chr13       	16527017    	16906946    	16718018       	17307939       	5         	0         	5              	DEL       
chr13       	16527017    	16906946    	16545501       	17308424       	10        	0         	10             	DUP       
chr13       	16527017    	16906946    	16624662       	17327973       	9         	0         	9              	DEL       
chr13       	16527017    	16906946    	16653266       	17361473       	6         	0         	6              	DUP       
chr13       	16527017    	16906946    	16697709       	17361190       	11        	0         	11             	DEL       
chr13       	16527017    	16906946    	16894614       	17366001       	5         	0         	5              	DUP       
chr13       	16527017    	16906946    	16871215       	17366002       	6         	0         	6              	DUP       
chr13       	16527017    	16906946    	16624630       	17396078       	10        	0         	10             	DEL       
chr13       	16527017    	16906946    	16857655       	17412405       	5         	0         	5              	DEL       
chr13       	16526727    	17086624    	17039759       	17268359       	6         	0         	6              	DUP       
chr13       	16526727    	17086624    	16992912       	17384297       	10        	0         	10             	DEL       
chr13       	16526727    	17086624    	16447112       	16607356       	5         	0         	5              	DUP       
chr13       	16526727    	17086624    	16345081       	16624283       	16        	0         	16             	DEL       
chr13       	16526727    	17086624    	16326652       	16653511       	6         	0         	6              	DUP       
chr13       	16526727    	17086624    	16358206       	16653525       	9         	0         	9              	DUP       
chr13       	16526727    	17086624    	16316243       	16795881       	6         	0         	6              	DEL       
chr13       	16526727    	17086624    	16845048       	16857406       	11        	0         	11             	DEL       
chr13       	16526727    	17086624    	16335056       	16871402       	5         	0         	5              	DUP       
chr13       	16526727    	17086624    	16545807       	16871215       	10        	0         	10             	DEL       
chr13       	16526727    	17086624    	16857691       	16894606       	8         	0         	8              	DEL       
chr13       	16526727    	17086624    	16871420       	16894588       	6         	0         	6              	DEL       
chr13       	16526727    	17086624    	16527018       	16906946       	14        	0         	14             	DEL       
chr13       	16526727    	17086624    	16426040       	16940868       	8         	0         	8              	DEL       
chr13       	16526727    	17086624    	16423786       	16988277       	5         	0         	5              	DUP       
chr13       	16526727    	17086624    	16758343       	16988288       	7         	0         	7              	DUP       
chr13       	16526727    	17086624    	16660100       	16995462       	4         	0         	4              	DEL       
chr13       	16526727    	17086624    	16662346       	16995675       	6         	0         	6              	DUP       
chr13       	16526727    	17086624    	16526728       	17086624       	7         	0         	7              	DUP       
chr13       	16526727    	17086624    	16907030       	17146929       	7         	0         	7              	DUP       
chr13       	16526727    	17086624    	17086703       	17146669       	9         	0         	9              	DEL       
chr13       	16526727    	17086624    	16697712       	17148621       	28        	0         	28             	DEL       
chr13       	16526727    	17086624    	16653275       	17149091       	21        	0         	21             	DUP       
chr13       	16526727    	17086624    	16758779       	17172966       	20        	0         	20             	DEL       
chr13       	16526727    	17086624    	16857428       	17287609       	9         	0         	9              	DUP       
chr13       	16526727    	17086624    	16844815       	17287618       	5         	0         	5              	DUP       
chr13       	16526727    	17086624    	16962335       	17287626       	5         	0         	5              	DUP       
chr13       	16526727    	17086624    	16718018       	17307939       	5         	0         	5              	DEL       
chr13       	16526727    	17086624    	16545501       	17308424       	10        	0         	10             	DUP       
chr13       	16526727    	17086624    	16624662       	17327973       	9         	0         	9              	DEL       
chr13       	16526727    	17086624    	16653266       	17361473       	6         	0         	6              	DUP       
chr13       	16526727    	17086624    	16697709       	17361190       	11        	0         	11             	DEL       
chr13       	16526727    	17086624    	16894614       	17366001       	5         	0         	5              	DUP       
chr13       	16526727    	17086624    	16871215       	17366002       	6         	0         	6              	DUP       
chr13       	16526727    	17086624    	16624630       	17396078       	10        	0         	10             	DEL       
chr13       	16526727    	17086624    	16857655       	17412405       	5         	0         	5              	DEL       
chr13       	16545806    	16871215    	16447112       	16607356       	5         	0         	5              	DUP       
chr13       	16545806    	16871215    	16345081       	16624283       	16        	0         	16             	DEL       
chr13       	16545806    	16871215    	16326652       	16653511       	6         	0         	6              	DUP       
chr13       	16545806    	16871215    	16358206       	16653525       	9         	0         	9              	DUP       
chr13       	16545806    	16871215    	16316243       	16795881       	6         	0         	6              	DEL       
chr13       	16545806    	16871215    	16845048       	16857406       	11        	0         	11             	DEL       
chr13       	16545806    	16871215    	16545807       	16871215       	10        	0         	10             	DEL       
chr13       	16545806    	16871215    	16857691       	16894606       	8         	0         	8              	DEL       
chr13       	16545806    	16871215    	16758343       	16988288       	7         	0         	7              	DUP       
chr13       	16545806    	16871215    	16660100       	16995462       	4         	0         	4              	DEL       
chr13       	16545806    	16871215    	16662346       	16995675       	6         	0         	6              	DUP       
chr13       	16545806    	16871215    	16697712       	17148621       	28        	0         	28             	DEL       
chr13       	16545806    	16871215    	16653275       	17149091       	21        	0         	21             	DUP       
chr13       	16545806    	16871215    	16758779       	17172966       	20        	0         	20             	DEL       
chr13       	16545806    	16871215    	16857428       	17287609       	9         	0         	9              	DUP       
chr13       	16545806    	16871215    	16844815       	17287618       	5         	0         	5              	DUP       
chr13       	16545806    	16871215    	16718018       	17307939       	5         	0         	5              	DEL       
chr13       	16545806    	16871215    	16624662       	17327973       	9         	0         	9              	DEL       
chr13       	16545806    	16871215    	16653266       	17361473       	6         	0         	6              	DUP       
chr13       	16545806    	16871215    	16697709       	17361190       	11        	0         	11             	DEL       
chr13       	16545806    	16871215    	16871215       	17366002       	6         	0         	6              	DUP       
chr13       	16545806    	16871215    	16624630       	17396078       	10        	0         	10             	DEL       
chr13       	16545806    	16871215    	16857655       	17412405       	5         	0         	5              	DEL       
chr13       	16545500    	17308424    	16421724       	17186516       	4         	0         	4              	DUP       
chr13       	16545500    	17308424    	17039759       	17268359       	6         	0         	6              	DUP       
chr13       	16545500    	17308424    	16992912       	17384297       	10        	0         	10             	DEL       
chr13       	16545500    	17308424    	16447112       	16607356       	5         	0         	5              	DUP       
chr13       	16545500    	17308424    	16345081       	16624283       	16        	0         	16             	DEL       
chr13       	16545500    	17308424    	16326652       	16653511       	6         	0         	6              	DUP       
chr13       	16545500    	17308424    	16358206       	16653525       	9         	0         	9              	DUP       
chr13       	16545500    	17308424    	16316243       	16795881       	6         	0         	6              	DEL       
chr13       	16545500    	17308424    	16845048       	16857406       	11        	0         	11             	DEL       
chr13       	16545500    	17308424    	16335056       	16871402       	5         	0         	5              	DUP       
chr13       	16545500    	17308424    	16545807       	16871215       	10        	0         	10             	DEL       
chr13       	16545500    	17308424    	16857691       	16894606       	8         	0         	8              	DEL       
chr13       	16545500    	17308424    	16871420       	16894588       	6         	0         	6              	DEL       
chr13       	16545500    	17308424    	16527018       	16906946       	14        	0         	14             	DEL       
chr13       	16545500    	17308424    	16426040       	16940868       	8         	0         	8              	DEL       
chr13       	16545500    	17308424    	16423786       	16988277       	5         	0         	5              	DUP       
chr13       	16545500    	17308424    	16758343       	16988288       	7         	0         	7              	DUP       
chr13       	16545500    	17308424    	16660100       	16995462       	4         	0         	4              	DEL       
chr13       	16545500    	17308424    	16662346       	16995675       	6         	0         	6              	DUP       
chr13       	16545500    	17308424    	16526728       	17086624       	7         	0         	7              	DUP       
chr13       	16545500    	17308424    	16907030       	17146929       	7         	0         	7              	DUP       
chr13       	16545500    	17308424    	17086703       	17146669       	9         	0         	9              	DEL       
chr13       	16545500    	17308424    	16697712       	17148621       	28        	0         	28             	DEL       
chr13       	16545500    	17308424    	16653275       	17149091       	21        	0         	21             	DUP       
chr13       	16545500    	17308424    	16326634       	17149130       	25        	0         	25             	DUP       
chr13       	16545500    	17308424    	16358190       	17149133       	21        	0         	21             	DUP       
chr13       	16545500    	17308424    	16424005       	17173188       	8         	0         	8              	DEL       
chr13       	16545500    	17308424    	16758779       	17172966       	20        	0         	20             	DEL       
chr13       	16545500    	17308424    	16326891       	17234013       	6         	0         	6              	DEL       
chr13       	16545500    	17308424    	16857428       	17287609       	9         	0         	9              	DUP       
chr13       	16545500    	17308424    	16844815       	17287618       	5         	0         	5              	DUP       
chr13       	16545500    	17308424    	16962335       	17287626       	5         	0         	5              	DUP       
chr13       	16545500    	17308424    	17225277       	17291012       	4         	0         	4              	DEL       
chr13       	16545500    	17308424    	16718018       	17307939       	5         	0         	5              	DEL       
chr13       	16545500    	17308424    	16545501       	17308424       	10        	0         	10             	DUP       
chr13       	16545500    	17308424    	16350419       	17308037       	6         	0         	6              	DEL       
chr13       	16545500    	17308424    	17287337       	17328210       	6         	0         	6              	DUP       
chr13       	16545500    	17308424    	16624662       	17327973       	9         	0         	9              	DEL       
chr13       	16545500    	17308424    	17235839       	17331249       	11        	0         	11             	DUP       
chr13       	16545500    	17308424    	17148658       	17361465       	28        	0         	28             	DUP       
chr13       	16545500    	17308424    	16653266       	17361473       	6         	0         	6              	DUP       
chr13       	16545500    	17308424    	16697709       	17361190       	11        	0         	11             	DEL       
chr13       	16545500    	17308424    	17308432       	17365778       	6         	0         	6              	DEL       
chr13       	16545500    	17308424    	16894614       	17366001       	5         	0         	5              	DUP       
chr13       	16545500    	17308424    	16871215       	17366002       	6         	0         	6              	DUP       
chr13       	16545500    	17308424    	16624630       	17396078       	10        	0         	10             	DEL       
chr13       	16545500    	17308424    	17287341       	17396324       	8         	0         	8              	DUP       
chr13       	16545500    	17308424    	16857655       	17412405       	5         	0         	5              	DEL       
chr13       	16624661    	17327973    	16421724       	17186516       	4         	0         	4              	DUP       
chr13       	16624661    	17327973    	17039759       	17268359       	6         	0         	6              	DUP       
chr13       	16624661    	17327973    	16992912       	17384297       	10        	0         	10             	DEL       
chr13       	16624661    	17327973    	16326652       	16653511       	6         	0         	6              	DUP       
chr13       	16624661    	17327973    	16358206       	16653525       	9         	0         	9              	DUP       
chr13       	16624661    	17327973    	16316243       	16795881       	6         	0         	6              	DEL       
chr13       	16624661    	17327973    	16845048       	16857406       	11        	0         	11             	DEL       
chr13       	16624661    	17327973    	16335056       	16871402       	5         	0         	5              	DUP       
chr13       	16624661    	17327973    	16545807       	16871215       	10        	0         	10             	DEL       
chr13       	16624661    	17327973    	16857691       	16894606       	8         	0         	8              	DEL       
chr13       	16624661    	17327973    	16871420       	16894588       	6         	0         	6              	DEL       
chr13       	16624661    	17327973    	16527018       	16906946       	14        	0         	14             	DEL       
chr13       	16624661    	17327973    	16426040       	16940868       	8         	0         	8              	DEL       
chr13       	16624661    	17327973    	16423786       	16988277       	5         	0         	5              	DUP       
chr13       	16624661    	17327973    	16758343       	16988288       	7         	0         	7              	DUP       
chr13       	16624661    	17327973    	16660100       	16995462       	4         	0         	4              	DEL       
chr13       	16624661    	17327973    	16662346       	16995675       	6         	0         	6              	DUP       
chr13       	16624661    	17327973    	16526728       	17086624       	7         	0         	7              	DUP       
chr13       	16624661    	17327973    	16907030       	17146929       	7         	0         	7              	DUP       
chr13       	16624661    	17327973    	17086703       	17146669       	9         	0         	9              	DEL       
chr13       	16624661    	17327973    	16697712       	17148621       	28        	0         	28             	DEL       
chr13       	16624661    	17327973    	16653275       	17149091       	21        	0         	21             	DUP       
chr13       	16624661    	17327973    	16326634       	17149130       	25        	0         	25             	DUP       
chr13       	16624661    	17327973    	16358190       	17149133       	21        	0         	21             	DUP       
chr13       	16624661    	17327973    	16424005       	17173188       	8         	0         	8              	DEL       
chr13       	16624661    	17327973    	16758779       	17172966       	20        	0         	20             	DEL       
chr13       	16624661    	17327973    	16326891       	17234013       	6         	0         	6              	DEL       
chr13       	16624661    	17327973    	16857428       	17287609       	9         	0         	9              	DUP       
chr13       	16624661    	17327973    	16844815       	17287618       	5         	0         	5              	DUP       
chr13       	16624661    	17327973    	16962335       	17287626       	5         	0         	5              	DUP       
chr13       	16624661    	17327973    	17225277       	17291012       	4         	0         	4              	DEL       
chr13       	16624661    	17327973    	16718018       	17307939       	5         	0         	5              	DEL       
chr13       	16624661    	17327973    	16545501       	17308424       	10        	0         	10             	DUP       
chr13       	16624661    	17327973    	16350419       	17308037       	6         	0         	6              	DEL       
chr13       	16624661    	17327973    	17287337       	17328210       	6         	0         	6              	DUP       
chr13       	16624661    	17327973    	16624662       	17327973       	9         	0         	9              	DEL       
chr13       	16624661    	17327973    	17235839       	17331249       	11        	0         	11             	DUP       
chr13       	16624661    	17327973    	17148658       	17361465       	28        	0         	28             	DUP       
chr13       	16624661    	17327973    	16653266       	17361473       	6         	0         	6              	DUP       
chr13       	16624661    	17327973    	16697709       	17361190       	11        	0         	11             	DEL       
chr13       	16624661    	17327973    	17308432       	17365778       	6         	0         	6              	DEL       
chr13       	16624661    	17327973    	16894614       	17366001       	5         	0         	5              	DUP       
chr13       	16624661    	17327973    	16871215       	17366002       	6         	0         	6              	DUP       
chr13       	16624661    	17327973    	16624630       	17396078       	10        	0         	10             	DEL       
chr13       	16624661    	17327973    	17287341       	17396324       	8         	0         	8              	DUP       
chr13       	16624661    	17327973    	16857655       	17412405       	5         	0         	5              	DEL       
chr13       	16624629    	17396078    	16421724       	17186516       	4         	0         	4              	DUP       
chr13       	16624629    	17396078    	17039759       	17268359       	6         	0         	6              	DUP       
chr13       	16624629    	17396078    	16441597       	17384290       	5         	0         	5              	DEL       
chr13       	16624629    	17396078    	16992912       	17384297       	10        	0         	10             	DEL       
chr13       	16624629    	17396078    	16326652       	16653511       	6         	0         	6              	DUP       
chr13       	16624629    	17396078    	16358206       	16653525       	9         	0         	9              	DUP       
chr13       	16624629    	17396078    	16316243       	16795881       	6         	0         	6              	DEL       
chr13       	16624629    	17396078    	16845048       	16857406       	11        	0         	11             	DEL       
chr13       	16624629    	17396078    	16335056       	16871402       	5         	0         	5              	DUP       
chr13       	16624629    	17396078    	16545807       	16871215       	10        	0         	10             	DEL       
chr13       	16624629    	17396078    	16857691       	16894606       	8         	0         	8              	DEL       
chr13       	16624629    	17396078    	16871420       	16894588       	6         	0         	6              	DEL       
chr13       	16624629    	17396078    	16527018       	16906946       	14        	0         	14             	DEL       
chr13       	16624629    	17396078    	16426040       	16940868       	8         	0         	8              	DEL       
chr13       	16624629    	17396078    	16423786       	16988277       	5         	0         	5              	DUP       
chr13       	16624629    	17396078    	16758343       	16988288       	7         	0         	7              	DUP       
chr13       	16624629    	17396078    	16660100       	16995462       	4         	0         	4              	DEL       
chr13       	16624629    	17396078    	16662346       	16995675       	6         	0         	6              	DUP       
chr13       	16624629    	17396078    	16526728       	17086624       	7         	0         	7              	DUP       
chr13       	16624629    	17396078    	16907030       	17146929       	7         	0         	7              	DUP       
chr13       	16624629    	17396078    	17086703       	17146669       	9         	0         	9              	DEL       
chr13       	16624629    	17396078    	16697712       	17148621       	28        	0         	28             	DEL       
chr13       	16624629    	17396078    	16653275       	17149091       	21        	0         	21             	DUP       
chr13       	16624629    	17396078    	16326634       	17149130       	25        	0         	25             	DUP       
chr13       	16624629    	17396078    	16358190       	17149133       	21        	0         	21             	DUP       
chr13       	16624629    	17396078    	16424005       	17173188       	8         	0         	8              	DEL       
chr13       	16624629    	17396078    	16758779       	17172966       	20        	0         	20             	DEL       
chr13       	16624629    	17396078    	16326891       	17234013       	6         	0         	6              	DEL       
chr13       	16624629    	17396078    	16857428       	17287609       	9         	0         	9              	DUP       
chr13       	16624629    	17396078    	16844815       	17287618       	5         	0         	5              	DUP       
chr13       	16624629    	17396078    	16962335       	17287626       	5         	0         	5              	DUP       
chr13       	16624629    	17396078    	17225277       	17291012       	4         	0         	4              	DEL       
chr13       	16624629    	17396078    	16718018       	17307939       	5         	0         	5              	DEL       
chr13       	16624629    	17396078    	16545501       	17308424       	10        	0         	10             	DUP       
chr13       	16624629    	17396078    	16350419       	17308037       	6         	0         	6              	DEL       
chr13       	16624629    	17396078    	17287337       	17328210       	6         	0         	6              	DUP       
chr13       	16624629    	17396078    	16624662       	17327973       	9         	0         	9              	DEL       
chr13       	16624629    	17396078    	17235839       	17331249       	11        	0         	11             	DUP       
chr13       	16624629    	17396078    	17148658       	17361465       	28        	0         	28             	DUP       
chr13       	16624629    	17396078    	16653266       	17361473       	6         	0         	6              	DUP       
chr13       	16624629    	17396078    	16697709       	17361190       	11        	0         	11             	DEL       
chr13       	16624629    	17396078    	17308432       	17365778       	6         	0         	6              	DEL       
chr13       	16624629    	17396078    	16894614       	17366001       	5         	0         	5              	DUP       
chr13       	16624629    	17396078    	16871215       	17366002       	6         	0         	6              	DUP       
chr13       	16624629    	17396078    	16334420       	17384617       	8         	0         	8              	DUP       
chr13       	16624629    	17396078    	16624630       	17396078       	10        	0         	10             	DEL       
chr13       	16624629    	17396078    	17287341       	17396324       	8         	0         	8              	DUP       
chr13       	16624629    	17396078    	16857655       	17412405       	5         	0         	5              	DEL       
chr13       	16653274    	17149091    	17039759       	17268359       	6         	0         	6              	DUP       
chr13       	16653274    	17149091    	16992912       	17384297       	10        	0         	10             	DEL       
chr13       	16653274    	17149091    	16326652       	16653511       	6         	0         	6              	DUP       
chr13       	16653274    	17149091    	16358206       	16653525       	9         	0         	9              	DUP       
chr13       	16653274    	17149091    	16316243       	16795881       	6         	0         	6              	DEL       
chr13       	16653274    	17149091    	16845048       	16857406       	11        	0         	11             	DEL       
chr13       	16653274    	17149091    	16335056       	16871402       	5         	0         	5              	DUP       
chr13       	16653274    	17149091    	16545807       	16871215       	10        	0         	10             	DEL       
chr13       	16653274    	17149091    	16857691       	16894606       	8         	0         	8              	DEL       
chr13       	16653274    	17149091    	16871420       	16894588       	6         	0         	6              	DEL       
chr13       	16653274    	17149091    	16527018       	16906946       	14        	0         	14             	DEL       
chr13       	16653274    	17149091    	16426040       	16940868       	8         	0         	8              	DEL       
chr13       	16653274    	17149091    	16423786       	16988277       	5         	0         	5              	DUP       
chr13       	16653274    	17149091    	16758343       	16988288       	7         	0         	7              	DUP       
chr13       	16653274    	17149091    	16660100       	16995462       	4         	0         	4              	DEL       
chr13       	16653274    	17149091    	16662346       	16995675       	6         	0         	6              	DUP       
chr13       	16653274    	17149091    	16526728       	17086624       	7         	0         	7              	DUP       
chr13       	16653274    	17149091    	16907030       	17146929       	7         	0         	7              	DUP       
chr13       	16653274    	17149091    	17086703       	17146669       	9         	0         	9              	DEL       
chr13       	16653274    	17149091    	16697712       	17148621       	28        	0         	28             	DEL       
chr13       	16653274    	17149091    	16653275       	17149091       	21        	0         	21             	DUP       
chr13       	16653274    	17149091    	16326634       	17149130       	25        	0         	25             	DUP       
chr13       	16653274    	17149091    	16358190       	17149133       	21        	0         	21             	DUP       
chr13       	16653274    	17149091    	16758779       	17172966       	20        	0         	20             	DEL       
chr13       	16653274    	17149091    	16857428       	17287609       	9         	0         	9              	DUP       
chr13       	16653274    	17149091    	16844815       	17287618       	5         	0         	5              	DUP       
chr13       	16653274    	17149091    	16962335       	17287626       	5         	0         	5              	DUP       
chr13       	16653274    	17149091    	16718018       	17307939       	5         	0         	5              	DEL       
chr13       	16653274    	17149091    	17148658       	17361465       	28        	0         	28             	DUP       
chr13       	16653274    	17149091    	16653266       	17361473       	6         	0         	6              	DUP       
chr13       	16653274    	17149091    	16697709       	17361190       	11        	0         	11             	DEL       
chr13       	16653274    	17149091    	16894614       	17366001       	5         	0         	5              	DUP       
chr13       	16653274    	17149091    	16871215       	17366002       	6         	0         	6              	DUP       
chr13       	16653274    	17149091    	16857655       	17412405       	5         	0         	5              	DEL       
chr13       	16653265    	17361473    	16421724       	17186516       	4         	0         	4              	DUP       
chr13       	16653265    	17361473    	17039759       	17268359       	6         	0         	6              	DUP       
chr13       	16653265    	17361473    	16992912       	17384297       	10        	0         	10             	DEL       
chr13       	16653265    	17361473    	16326652       	16653511       	6         	0         	6              	DUP       
chr13       	16653265    	17361473    	16358206       	16653525       	9         	0         	9              	DUP       
chr13       	16653265    	17361473    	16316243       	16795881       	6         	0         	6              	DEL       
chr13       	16653265    	17361473    	16845048       	16857406       	11        	0         	11             	DEL       
chr13       	16653265    	17361473    	16335056       	16871402       	5         	0         	5              	DUP       
chr13       	16653265    	17361473    	16545807       	16871215       	10        	0         	10             	DEL       
chr13       	16653265    	17361473    	16857691       	16894606       	8         	0         	8              	DEL       
chr13       	16653265    	17361473    	16871420       	16894588       	6         	0         	6              	DEL       
chr13       	16653265    	17361473    	16527018       	16906946       	14        	0         	14             	DEL       
chr13       	16653265    	17361473    	16426040       	16940868       	8         	0         	8              	DEL       
chr13       	16653265    	17361473    	16423786       	16988277       	5         	0         	5              	DUP       
chr13       	16653265    	17361473    	16758343       	16988288       	7         	0         	7              	DUP       
chr13       	16653265    	17361473    	16660100       	16995462       	4         	0         	4              	DEL       
chr13       	16653265    	17361473    	16662346       	16995675       	6         	0         	6              	DUP       
chr13       	16653265    	17361473    	16526728       	17086624       	7         	0         	7              	DUP       
chr13       	16653265    	17361473    	16907030       	17146929       	7         	0         	7              	DUP       
chr13       	16653265    	17361473    	17086703       	17146669       	9         	0         	9              	DEL       
chr13       	16653265    	17361473    	16697712       	17148621       	28        	0         	28             	DEL       
chr13       	16653265    	17361473    	16653275       	17149091       	21        	0         	21             	DUP       
chr13       	16653265    	17361473    	16326634       	17149130       	25        	0         	25             	DUP       
chr13       	16653265    	17361473    	16358190       	17149133       	21        	0         	21             	DUP       
chr13       	16653265    	17361473    	16424005       	17173188       	8         	0         	8              	DEL       
chr13       	16653265    	17361473    	16758779       	17172966       	20        	0         	20             	DEL       
chr13       	16653265    	17361473    	16326891       	17234013       	6         	0         	6              	DEL       
chr13       	16653265    	17361473    	16857428       	17287609       	9         	0         	9              	DUP       
chr13       	16653265    	17361473    	16844815       	17287618       	5         	0         	5              	DUP       
chr13       	16653265    	17361473    	16962335       	17287626       	5         	0         	5              	DUP       
chr13       	16653265    	17361473    	17225277       	17291012       	4         	0         	4              	DEL       
chr13       	16653265    	17361473    	16718018       	17307939       	5         	0         	5              	DEL       
chr13       	16653265    	17361473    	16545501       	17308424       	10        	0         	10             	DUP       
chr13       	16653265    	17361473    	16350419       	17308037       	6         	0         	6              	DEL       
chr13       	16653265    	17361473    	17287337       	17328210       	6         	0         	6              	DUP       
chr13       	16653265    	17361473    	16624662       	17327973       	9         	0         	9              	DEL       
chr13       	16653265    	17361473    	17235839       	17331249       	11        	0         	11             	DUP       
chr13       	16653265    	17361473    	17148658       	17361465       	28        	0         	28             	DUP       
chr13       	16653265    	17361473    	16653266       	17361473       	6         	0         	6              	DUP       
chr13       	16653265    	17361473    	16697709       	17361190       	11        	0         	11             	DEL       
chr13       	16653265    	17361473    	17308432       	17365778       	6         	0         	6              	DEL       
chr13       	16653265    	17361473    	16894614       	17366001       	5         	0         	5              	DUP       
chr13       	16653265    	17361473    	16871215       	17366002       	6         	0         	6              	DUP       
chr13       	16653265    	17361473    	17287341       	17396324       	8         	0         	8              	DUP       
chr13       	16653265    	17361473    	16857655       	17412405       	5         	0         	5              	DEL       
chr13       	16660099    	16995462    	16992912       	17384297       	10        	0         	10             	DEL       
chr13       	16660099    	16995462    	16316243       	16795881       	6         	0         	6              	DEL       
chr13       	16660099    	16995462    	16845048       	16857406       	11        	0         	11             	DEL       
chr13       	16660099    	16995462    	16335056       	16871402       	5         	0         	5              	DUP       
chr13       	16660099    	16995462    	16545807       	16871215       	10        	0         	10             	DEL       
chr13       	16660099    	16995462    	16857691       	16894606       	8         	0         	8              	DEL       
chr13       	16660099    	16995462    	16871420       	16894588       	6         	0         	6              	DEL       
chr13       	16660099    	16995462    	16527018       	16906946       	14        	0         	14             	DEL       
chr13       	16660099    	16995462    	16426040       	16940868       	8         	0         	8              	DEL       
chr13       	16660099    	16995462    	16423786       	16988277       	5         	0         	5              	DUP       
chr13       	16660099    	16995462    	16758343       	16988288       	7         	0         	7              	DUP       
chr13       	16660099    	16995462    	16660100       	16995462       	4         	0         	4              	DEL       
chr13       	16660099    	16995462    	16662346       	16995675       	6         	0         	6              	DUP       
chr13       	16660099    	16995462    	16907030       	17146929       	7         	0         	7              	DUP       
chr13       	16660099    	16995462    	16697712       	17148621       	28        	0         	28             	DEL       
chr13       	16660099    	16995462    	16758779       	17172966       	20        	0         	20             	DEL       
chr13       	16660099    	16995462    	16857428       	17287609       	9         	0         	9              	DUP       
chr13       	16660099    	16995462    	16844815       	17287618       	5         	0         	5              	DUP       
chr13       	16660099    	16995462    	16962335       	17287626       	5         	0         	5              	DUP       
chr13       	16660099    	16995462    	16718018       	17307939       	5         	0         	5              	DEL       
chr13       	16660099    	16995462    	16697709       	17361190       	11        	0         	11             	DEL       
chr13       	16660099    	16995462    	16894614       	17366001       	5         	0         	5              	DUP       
chr13       	16660099    	16995462    	16871215       	17366002       	6         	0         	6              	DUP       
chr13       	16660099    	16995462    	16857655       	17412405       	5         	0         	5              	DEL       
chr13       	16662345    	16995675    	16992912       	17384297       	10        	0         	10             	DEL       
chr13       	16662345    	16995675    	16316243       	16795881       	6         	0         	6              	DEL       
chr13       	16662345    	16995675    	16845048       	16857406       	11        	0         	11             	DEL       
chr13       	16662345    	16995675    	16335056       	16871402       	5         	0         	5              	DUP       
chr13       	16662345    	16995675    	16545807       	16871215       	10        	0         	10             	DEL       
chr13       	16662345    	16995675    	16857691       	16894606       	8         	0         	8              	DEL       
chr13       	16662345    	16995675    	16871420       	16894588       	6         	0         	6              	DEL       
chr13       	16662345    	16995675    	16527018       	16906946       	14        	0         	14             	DEL       
chr13       	16662345    	16995675    	16426040       	16940868       	8         	0         	8              	DEL       
chr13       	16662345    	16995675    	16423786       	16988277       	5         	0         	5              	DUP       
chr13       	16662345    	16995675    	16758343       	16988288       	7         	0         	7              	DUP       
chr13       	16662345    	16995675    	16660100       	16995462       	4         	0         	4              	DEL       
chr13       	16662345    	16995675    	16662346       	16995675       	6         	0         	6              	DUP       
chr13       	16662345    	16995675    	16907030       	17146929       	7         	0         	7              	DUP       
chr13       	16662345    	16995675    	16697712       	17148621       	28        	0         	28             	DEL       
chr13       	16662345    	16995675    	16758779       	17172966       	20        	0         	20             	DEL       
chr13       	16662345    	16995675    	16857428       	17287609       	9         	0         	9              	DUP       
chr13       	16662345    	16995675    	16844815       	17287618       	5         	0         	5              	DUP       
chr13       	16662345    	16995675    	16962335       	17287626       	5         	0         	5              	DUP       
chr13       	16662345    	16995675    	16718018       	17307939       	5         	0         	5              	DEL       
chr13       	16662345    	16995675    	16697709       	17361190       	11        	0         	11             	DEL       
chr13       	16662345    	16995675    	16894614       	17366001       	5         	0         	5              	DUP       
chr13       	16662345    	16995675    	16871215       	17366002       	6         	0         	6              	DUP       
chr13       	16662345    	16995675    	16857655       	17412405       	5         	0         	5              	DEL       
chr13       	16697711    	17148621    	17039759       	17268359       	6         	0         	6              	DUP       
chr13       	16697711    	17148621    	16992912       	17384297       	10        	0         	10             	DEL       
chr13       	16697711    	17148621    	16316243       	16795881       	6         	0         	6              	DEL       
chr13       	16697711    	17148621    	16845048       	16857406       	11        	0         	11             	DEL       
chr13       	16697711    	17148621    	16335056       	16871402       	5         	0         	5              	DUP       
chr13       	16697711    	17148621    	16545807       	16871215       	10        	0         	10             	DEL       
chr13       	16697711    	17148621    	16857691       	16894606       	8         	0         	8              	DEL       
chr13       	16697711    	17148621    	16871420       	16894588       	6         	0         	6              	DEL       
chr13       	16697711    	17148621    	16527018       	16906946       	14        	0         	14             	DEL       
chr13       	16697711    	17148621    	16426040       	16940868       	8         	0         	8              	DEL       
chr13       	16697711    	17148621    	16423786       	16988277       	5         	0         	5              	DUP       
chr13       	16697711    	17148621    	16758343       	16988288       	7         	0         	7              	DUP       
chr13       	16697711    	17148621    	16660100       	16995462       	4         	0         	4              	DEL       
chr13       	16697711    	17148621    	16662346       	16995675       	6         	0         	6              	DUP       
chr13       	16697711    	17148621    	16526728       	17086624       	7         	0         	7              	DUP       
chr13       	16697711    	17148621    	16907030       	17146929       	7         	0         	7              	DUP       
chr13       	16697711    	17148621    	17086703       	17146669       	9         	0         	9              	DEL       
chr13       	16697711    	17148621    	16697712       	17148621       	28        	0         	28             	DEL       
chr13       	16697711    	17148621    	16758779       	17172966       	20        	0         	20             	DEL       
chr13       	16697711    	17148621    	16857428       	17287609       	9         	0         	9              	DUP       
chr13       	16697711    	17148621    	16844815       	17287618       	5         	0         	5              	DUP       
chr13       	16697711    	17148621    	16962335       	17287626       	5         	0         	5              	DUP       
chr13       	16697711    	17148621    	16718018       	17307939       	5         	0         	5              	DEL       
chr13       	16697711    	17148621    	17148658       	17361465       	28        	0         	28             	DUP       
chr13       	16697711    	17148621    	16697709       	17361190       	11        	0         	11             	DEL       
chr13       	16697711    	17148621    	16894614       	17366001       	5         	0         	5              	DUP       
chr13       	16697711    	17148621    	16871215       	17366002       	6         	0         	6              	DUP       
chr13       	16697711    	17148621    	16857655       	17412405       	5         	0         	5              	DEL       
chr13       	16697708    	17361190    	16421724       	17186516       	4         	0         	4              	DUP       
chr13       	16697708    	17361190    	17039759       	17268359       	6         	0         	6              	DUP       
chr13       	16697708    	17361190    	16992912       	17384297       	10        	0         	10             	DEL       
chr13       	16697708    	17361190    	16316243       	16795881       	6         	0         	6              	DEL       
chr13       	16697708    	17361190    	16845048       	16857406       	11        	0         	11             	DEL       
chr13       	16697708    	17361190    	16335056       	16871402       	5         	0         	5              	DUP       
chr13       	16697708    	17361190    	16545807       	16871215       	10        	0         	10             	DEL       
chr13       	16697708    	17361190    	16857691       	16894606       	8         	0         	8              	DEL       
chr13       	16697708    	17361190    	16871420       	16894588       	6         	0         	6              	DEL       
chr13       	16697708    	17361190    	16527018       	16906946       	14        	0         	14             	DEL       
chr13       	16697708    	17361190    	16426040       	16940868       	8         	0         	8              	DEL       
chr13       	16697708    	17361190    	16423786       	16988277       	5         	0         	5              	DUP       
chr13       	16697708    	17361190    	16758343       	16988288       	7         	0         	7              	DUP       
chr13       	16697708    	17361190    	16660100       	16995462       	4         	0         	4              	DEL       
chr13       	16697708    	17361190    	16662346       	16995675       	6         	0         	6              	DUP       
chr13       	16697708    	17361190    	16526728       	17086624       	7         	0         	7              	DUP       
chr13       	16697708    	17361190    	16907030       	17146929       	7         	0         	7              	DUP       
chr13       	16697708    	17361190    	17086703       	17146669       	9         	0         	9              	DEL       
chr13       	16697708    	17361190    	16697712       	17148621       	28        	0         	28             	DEL       
chr13       	16697708    	17361190    	16653275       	17149091       	21        	0         	21             	DUP       
chr13       	16697708    	17361190    	16326634       	17149130       	25        	0         	25             	DUP       
chr13       	16697708    	17361190    	16358190       	17149133       	21        	0         	21             	DUP       
chr13       	16697708    	17361190    	16424005       	17173188       	8         	0         	8              	DEL       
chr13       	16697708    	17361190    	16758779       	17172966       	20        	0         	20             	DEL       
chr13       	16697708    	17361190    	16326891       	17234013       	6         	0         	6              	DEL       
chr13       	16697708    	17361190    	16857428       	17287609       	9         	0         	9              	DUP       
chr13       	16697708    	17361190    	16844815       	17287618       	5         	0         	5              	DUP       
chr13       	16697708    	17361190    	16962335       	17287626       	5         	0         	5              	DUP       
chr13       	16697708    	17361190    	17225277       	17291012       	4         	0         	4              	DEL       
chr13       	16697708    	17361190    	16718018       	17307939       	5         	0         	5              	DEL       
chr13       	16697708    	17361190    	16545501       	17308424       	10        	0         	10             	DUP       
chr13       	16697708    	17361190    	16350419       	17308037       	6         	0         	6              	DEL       
chr13       	16697708    	17361190    	17287337       	17328210       	6         	0         	6              	DUP       
chr13       	16697708    	17361190    	16624662       	17327973       	9         	0         	9              	DEL       
chr13       	16697708    	17361190    	17235839       	17331249       	11        	0         	11             	DUP       
chr13       	16697708    	17361190    	17148658       	17361465       	28        	0         	28             	DUP       
chr13       	16697708    	17361190    	16697709       	17361190       	11        	0         	11             	DEL       
chr13       	16697708    	17361190    	17308432       	17365778       	6         	0         	6              	DEL       
chr13       	16697708    	17361190    	16894614       	17366001       	5         	0         	5              	DUP       
chr13       	16697708    	17361190    	16871215       	17366002       	6         	0         	6              	DUP       
chr13       	16697708    	17361190    	17287341       	17396324       	8         	0         	8              	DUP       
chr13       	16697708    	17361190    	16857655       	17412405       	5         	0         	5              	DEL       
chr13       	16718017    	17307939    	16421724       	17186516       	4         	0         	4              	DUP       
chr13       	16718017    	17307939    	17039759       	17268359       	6         	0         	6              	DUP       
chr13       	16718017    	17307939    	16992912       	17384297       	10        	0         	10             	DEL       
chr13       	16718017    	17307939    	16316243       	16795881       	6         	0         	6              	DEL       
chr13       	16718017    	17307939    	16845048       	16857406       	11        	0         	11             	DEL       
chr13       	16718017    	17307939    	16335056       	16871402       	5         	0         	5              	DUP       
chr13       	16718017    	17307939    	16545807       	16871215       	10        	0         	10             	DEL       
chr13       	16718017    	17307939    	16857691       	16894606       	8         	0         	8              	DEL       
chr13       	16718017    	17307939    	16871420       	16894588       	6         	0         	6              	DEL       
chr13       	16718017    	17307939    	16527018       	16906946       	14        	0         	14             	DEL       
chr13       	16718017    	17307939    	16426040       	16940868       	8         	0         	8              	DEL       
chr13       	16718017    	17307939    	16423786       	16988277       	5         	0         	5              	DUP       
chr13       	16718017    	17307939    	16758343       	16988288       	7         	0         	7              	DUP       
chr13       	16718017    	17307939    	16660100       	16995462       	4         	0         	4              	DEL       
chr13       	16718017    	17307939    	16662346       	16995675       	6         	0         	6              	DUP       
chr13       	16718017    	17307939    	16526728       	17086624       	7         	0         	7              	DUP       
chr13       	16718017    	17307939    	16907030       	17146929       	7         	0         	7              	DUP       
chr13       	16718017    	17307939    	17086703       	17146669       	9         	0         	9              	DEL       
chr13       	16718017    	17307939    	16697712       	17148621       	28        	0         	28             	DEL       
chr13       	16718017    	17307939    	16653275       	17149091       	21        	0         	21             	DUP       
chr13       	16718017    	17307939    	16326634       	17149130       	25        	0         	25             	DUP       
chr13       	16718017    	17307939    	16358190       	17149133       	21        	0         	21             	DUP       
chr13       	16718017    	17307939    	16424005       	17173188       	8         	0         	8              	DEL       
chr13       	16718017    	17307939    	16758779       	17172966       	20        	0         	20             	DEL       
chr13       	16718017    	17307939    	16326891       	17234013       	6         	0         	6              	DEL       
chr13       	16718017    	17307939    	16857428       	17287609       	9         	0         	9              	DUP       
chr13       	16718017    	17307939    	16844815       	17287618       	5         	0         	5              	DUP       
chr13       	16718017    	17307939    	16962335       	17287626       	5         	0         	5              	DUP       
chr13       	16718017    	17307939    	17225277       	17291012       	4         	0         	4              	DEL       
chr13       	16718017    	17307939    	16718018       	17307939       	5         	0         	5              	DEL       
chr13       	16718017    	17307939    	16350419       	17308037       	6         	0         	6              	DEL       
chr13       	16718017    	17307939    	17287337       	17328210       	6         	0         	6              	DUP       
chr13       	16718017    	17307939    	17235839       	17331249       	11        	0         	11             	DUP       
chr13       	16718017    	17307939    	17148658       	17361465       	28        	0         	28             	DUP       
chr13       	16718017    	17307939    	16894614       	17366001       	5         	0         	5              	DUP       
chr13       	16718017    	17307939    	16871215       	17366002       	6         	0         	6              	DUP       
chr13       	16718017    	17307939    	17287341       	17396324       	8         	0         	8              	DUP       
chr13       	16718017    	17307939    	16857655       	17412405       	5         	0         	5              	DEL       
chr13       	16758342    	16988288    	16316243       	16795881       	6         	0         	6              	DEL       
chr13       	16758342    	16988288    	16845048       	16857406       	11        	0         	11             	DEL       
chr13       	16758342    	16988288    	16335056       	16871402       	5         	0         	5              	DUP       
chr13       	16758342    	16988288    	16545807       	16871215       	10        	0         	10             	DEL       
chr13       	16758342    	16988288    	16857691       	16894606       	8         	0         	8              	DEL       
chr13       	16758342    	16988288    	16871420       	16894588       	6         	0         	6              	DEL       
chr13       	16758342    	16988288    	16527018       	16906946       	14        	0         	14             	DEL       
chr13       	16758342    	16988288    	16426040       	16940868       	8         	0         	8              	DEL       
chr13       	16758342    	16988288    	16423786       	16988277       	5         	0         	5              	DUP       
chr13       	16758342    	16988288    	16758343       	16988288       	7         	0         	7              	DUP       
chr13       	16758342    	16988288    	16907030       	17146929       	7         	0         	7              	DUP       
chr13       	16758342    	16988288    	16758779       	17172966       	20        	0         	20             	DEL       
chr13       	16758342    	16988288    	16857428       	17287609       	9         	0         	9              	DUP       
chr13       	16758342    	16988288    	16844815       	17287618       	5         	0         	5              	DUP       
chr13       	16758342    	16988288    	16962335       	17287626       	5         	0         	5              	DUP       
chr13       	16758342    	16988288    	16894614       	17366001       	5         	0         	5              	DUP       
chr13       	16758342    	16988288    	16871215       	17366002       	6         	0         	6              	DUP       
chr13       	16758342    	16988288    	16857655       	17412405       	5         	0         	5              	DEL       
chr13       	16758778    	17172966    	17039759       	17268359       	6         	0         	6              	DUP       
chr13       	16758778    	17172966    	16992912       	17384297       	10        	0         	10             	DEL       
chr13       	16758778    	17172966    	16316243       	16795881       	6         	0         	6              	DEL       
chr13       	16758778    	17172966    	16845048       	16857406       	11        	0         	11             	DEL       
chr13       	16758778    	17172966    	16335056       	16871402       	5         	0         	5              	DUP       
chr13       	16758778    	17172966    	16545807       	16871215       	10        	0         	10             	DEL       
chr13       	16758778    	17172966    	16857691       	16894606       	8         	0         	8              	DEL       
chr13       	16758778    	17172966    	16871420       	16894588       	6         	0         	6              	DEL       
chr13       	16758778    	17172966    	16527018       	16906946       	14        	0         	14             	DEL       
chr13       	16758778    	17172966    	16426040       	16940868       	8         	0         	8              	DEL       
chr13       	16758778    	17172966    	16423786       	16988277       	5         	0         	5              	DUP       
chr13       	16758778    	17172966    	16758343       	16988288       	7         	0         	7              	DUP       
chr13       	16758778    	17172966    	16660100       	16995462       	4         	0         	4              	DEL       
chr13       	16758778    	17172966    	16662346       	16995675       	6         	0         	6              	DUP       
chr13       	16758778    	17172966    	16526728       	17086624       	7         	0         	7              	DUP       
chr13       	16758778    	17172966    	16907030       	17146929       	7         	0         	7              	DUP       
chr13       	16758778    	17172966    	17086703       	17146669       	9         	0         	9              	DEL       
chr13       	16758778    	17172966    	16697712       	17148621       	28        	0         	28             	DEL       
chr13       	16758778    	17172966    	16653275       	17149091       	21        	0         	21             	DUP       
chr13       	16758778    	17172966    	16326634       	17149130       	25        	0         	25             	DUP       
chr13       	16758778    	17172966    	16358190       	17149133       	21        	0         	21             	DUP       
chr13       	16758778    	17172966    	16758779       	17172966       	20        	0         	20             	DEL       
chr13       	16758778    	17172966    	16857428       	17287609       	9         	0         	9              	DUP       
chr13       	16758778    	17172966    	16844815       	17287618       	5         	0         	5              	DUP       
chr13       	16758778    	17172966    	16962335       	17287626       	5         	0         	5              	DUP       
chr13       	16758778    	17172966    	17148658       	17361465       	28        	0         	28             	DUP       
chr13       	16758778    	17172966    	16894614       	17366001       	5         	0         	5              	DUP       
chr13       	16758778    	17172966    	16871215       	17366002       	6         	0         	6              	DUP       
chr13       	16758778    	17172966    	16857655       	17412405       	5         	0         	5              	DEL       
chr13       	16844814    	17287618    	16421724       	17186516       	4         	0         	4              	DUP       
chr13       	16844814    	17287618    	17039759       	17268359       	6         	0         	6              	DUP       
chr13       	16844814    	17287618    	16992912       	17384297       	10        	0         	10             	DEL       
chr13       	16844814    	17287618    	16845048       	16857406       	11        	0         	11             	DEL       
chr13       	16844814    	17287618    	16335056       	16871402       	5         	0         	5              	DUP       
chr13       	16844814    	17287618    	16545807       	16871215       	10        	0         	10             	DEL       
chr13       	16844814    	17287618    	16857691       	16894606       	8         	0         	8              	DEL       
chr13       	16844814    	17287618    	16871420       	16894588       	6         	0         	6              	DEL       
chr13       	16844814    	17287618    	16527018       	16906946       	14        	0         	14             	DEL       
chr13       	16844814    	17287618    	16426040       	16940868       	8         	0         	8              	DEL       
chr13       	16844814    	17287618    	16423786       	16988277       	5         	0         	5              	DUP       
chr13       	16844814    	17287618    	16758343       	16988288       	7         	0         	7              	DUP       
chr13       	16844814    	17287618    	16660100       	16995462       	4         	0         	4              	DEL       
chr13       	16844814    	17287618    	16662346       	16995675       	6         	0         	6              	DUP       
chr13       	16844814    	17287618    	16526728       	17086624       	7         	0         	7              	DUP       
chr13       	16844814    	17287618    	16907030       	17146929       	7         	0         	7              	DUP       
chr13       	16844814    	17287618    	17086703       	17146669       	9         	0         	9              	DEL       
chr13       	16844814    	17287618    	16697712       	17148621       	28        	0         	28             	DEL       
chr13       	16844814    	17287618    	16653275       	17149091       	21        	0         	21             	DUP       
chr13       	16844814    	17287618    	16326634       	17149130       	25        	0         	25             	DUP       
chr13       	16844814    	17287618    	16358190       	17149133       	21        	0         	21             	DUP       
chr13       	16844814    	17287618    	16424005       	17173188       	8         	0         	8              	DEL       
chr13       	16844814    	17287618    	16758779       	17172966       	20        	0         	20             	DEL       
chr13       	16844814    	17287618    	16326891       	17234013       	6         	0         	6              	DEL       
chr13       	16844814    	17287618    	16857428       	17287609       	9         	0         	9              	DUP       
chr13       	16844814    	17287618    	16844815       	17287618       	5         	0         	5              	DUP       
chr13       	16844814    	17287618    	16962335       	17287626       	5         	0         	5              	DUP       
chr13       	16844814    	17287618    	17225277       	17291012       	4         	0         	4              	DEL       
chr13       	16844814    	17287618    	17287337       	17328210       	6         	0         	6              	DUP       
chr13       	16844814    	17287618    	17235839       	17331249       	11        	0         	11             	DUP       
chr13       	16844814    	17287618    	17148658       	17361465       	28        	0         	28             	DUP       
chr13       	16844814    	17287618    	16894614       	17366001       	5         	0         	5              	DUP       
chr13       	16844814    	17287618    	16871215       	17366002       	6         	0         	6              	DUP       
chr13       	16844814    	17287618    	17287341       	17396324       	8         	0         	8              	DUP       
chr13       	16844814    	17287618    	16857655       	17412405       	5         	0         	5              	DEL       
chr13       	16857690    	16894606    	16335056       	16871402       	5         	0         	5              	DUP       
chr13       	16857690    	16894606    	16545807       	16871215       	10        	0         	10             	DEL       
chr13       	16857690    	16894606    	16857691       	16894606       	8         	0         	8              	DEL       
chr13       	16857690    	16894606    	16871420       	16894588       	6         	0         	6              	DEL       
chr13       	16857690    	16894606    	16894614       	17366001       	5         	0         	5              	DUP       
chr13       	16857690    	16894606    	16871215       	17366002       	6         	0         	6              	DUP       
chr13       	16857690    	16894606    	16857655       	17412405       	5         	0         	5              	DEL       
chr13       	16857427    	17287609    	16421724       	17186516       	4         	0         	4              	DUP       
chr13       	16857427    	17287609    	17039759       	17268359       	6         	0         	6              	DUP       
chr13       	16857427    	17287609    	16992912       	17384297       	10        	0         	10             	DEL       
chr13       	16857427    	17287609    	16845048       	16857406       	11        	0         	11             	DEL       
chr13       	16857427    	17287609    	16335056       	16871402       	5         	0         	5              	DUP       
chr13       	16857427    	17287609    	16545807       	16871215       	10        	0         	10             	DEL       
chr13       	16857427    	17287609    	16857691       	16894606       	8         	0         	8              	DEL       
chr13       	16857427    	17287609    	16871420       	16894588       	6         	0         	6              	DEL       
chr13       	16857427    	17287609    	16527018       	16906946       	14        	0         	14             	DEL       
chr13       	16857427    	17287609    	16426040       	16940868       	8         	0         	8              	DEL       
chr13       	16857427    	17287609    	16423786       	16988277       	5         	0         	5              	DUP       
chr13       	16857427    	17287609    	16758343       	16988288       	7         	0         	7              	DUP       
chr13       	16857427    	17287609    	16660100       	16995462       	4         	0         	4              	DEL       
chr13       	16857427    	17287609    	16662346       	16995675       	6         	0         	6              	DUP       
chr13       	16857427    	17287609    	16526728       	17086624       	7         	0         	7              	DUP       
chr13       	16857427    	17287609    	16907030       	17146929       	7         	0         	7              	DUP       
chr13       	16857427    	17287609    	17086703       	17146669       	9         	0         	9              	DEL       
chr13       	16857427    	17287609    	16697712       	17148621       	28        	0         	28             	DEL       
chr13       	16857427    	17287609    	16653275       	17149091       	21        	0         	21             	DUP       
chr13       	16857427    	17287609    	16326634       	17149130       	25        	0         	25             	DUP       
chr13       	16857427    	17287609    	16358190       	17149133       	21        	0         	21             	DUP       
chr13       	16857427    	17287609    	16424005       	17173188       	8         	0         	8              	DEL       
chr13       	16857427    	17287609    	16758779       	17172966       	20        	0         	20             	DEL       
chr13       	16857427    	17287609    	16326891       	17234013       	6         	0         	6              	DEL       
chr13       	16857427    	17287609    	16857428       	17287609       	9         	0         	9              	DUP       
chr13       	16857427    	17287609    	16844815       	17287618       	5         	0         	5              	DUP       
chr13       	16857427    	17287609    	16962335       	17287626       	5         	0         	5              	DUP       
chr13       	16857427    	17287609    	17225277       	17291012       	4         	0         	4              	DEL       
chr13       	16857427    	17287609    	17287337       	17328210       	6         	0         	6              	DUP       
chr13       	16857427    	17287609    	17235839       	17331249       	11        	0         	11             	DUP       
chr13       	16857427    	17287609    	17148658       	17361465       	28        	0         	28             	DUP       
chr13       	16857427    	17287609    	16894614       	17366001       	5         	0         	5              	DUP       
chr13       	16857427    	17287609    	16871215       	17366002       	6         	0         	6              	DUP       
chr13       	16857427    	17287609    	17287341       	17396324       	8         	0         	8              	DUP       
chr13       	16857427    	17287609    	16857655       	17412405       	5         	0         	5              	DEL       
chr13       	16857654    	17412405    	16421724       	17186516       	4         	0         	4              	DUP       
chr13       	16857654    	17412405    	17039759       	17268359       	6         	0         	6              	DUP       
chr13       	16857654    	17412405    	16441597       	17384290       	5         	0         	5              	DEL       
chr13       	16857654    	17412405    	16992912       	17384297       	10        	0         	10             	DEL       
chr13       	16857654    	17412405    	16335056       	16871402       	5         	0         	5              	DUP       
chr13       	16857654    	17412405    	16545807       	16871215       	10        	0         	10             	DEL       
chr13       	16857654    	17412405    	16857691       	16894606       	8         	0         	8              	DEL       
chr13       	16857654    	17412405    	16871420       	16894588       	6         	0         	6              	DEL       
chr13       	16857654    	17412405    	16527018       	16906946       	14        	0         	14             	DEL       
chr13       	16857654    	17412405    	16426040       	16940868       	8         	0         	8              	DEL       
chr13       	16857654    	17412405    	16423786       	16988277       	5         	0         	5              	DUP       
chr13       	16857654    	17412405    	16758343       	16988288       	7         	0         	7              	DUP       
chr13       	16857654    	17412405    	16660100       	16995462       	4         	0         	4              	DEL       
chr13       	16857654    	17412405    	16662346       	16995675       	6         	0         	6              	DUP       
chr13       	16857654    	17412405    	16526728       	17086624       	7         	0         	7              	DUP       
chr13       	16857654    	17412405    	16907030       	17146929       	7         	0         	7              	DUP       
chr13       	16857654    	17412405    	17086703       	17146669       	9         	0         	9              	DEL       
chr13       	16857654    	17412405    	16697712       	17148621       	28        	0         	28             	DEL       
chr13       	16857654    	17412405    	16653275       	17149091       	21        	0         	21             	DUP       
chr13       	16857654    	17412405    	16326634       	17149130       	25        	0         	25             	DUP       
chr13       	16857654    	17412405    	16358190       	17149133       	21        	0         	21             	DUP       
chr13       	16857654    	17412405    	16424005       	17173188       	8         	0         	8              	DEL       
chr13       	16857654    	17412405    	16758779       	17172966       	20        	0         	20             	DEL       
chr13       	16857654    	17412405    	16326891       	17234013       	6         	0         	6              	DEL       
chr13       	16857654    	17412405    	16857428       	17287609       	9         	0         	9              	DUP       
chr13       	16857654    	17412405    	16844815       	17287618       	5         	0         	5              	DUP       
chr13       	16857654    	17412405    	16962335       	17287626       	5         	0         	5              	DUP       
chr13       	16857654    	17412405    	17225277       	17291012       	4         	0         	4              	DEL       
chr13       	16857654    	17412405    	16718018       	17307939       	5         	0         	5              	DEL       
chr13       	16857654    	17412405    	16545501       	17308424       	10        	0         	10             	DUP       
chr13       	16857654    	17412405    	16350419       	17308037       	6         	0         	6              	DEL       
chr13       	16857654    	17412405    	17287337       	17328210       	6         	0         	6              	DUP       
chr13       	16857654    	17412405    	16624662       	17327973       	9         	0         	9              	DEL       
chr13       	16857654    	17412405    	17235839       	17331249       	11        	0         	11             	DUP       
chr13       	16857654    	17412405    	17148658       	17361465       	28        	0         	28             	DUP       
chr13       	16857654    	17412405    	16653266       	17361473       	6         	0         	6              	DUP       
chr13       	16857654    	17412405    	16697709       	17361190       	11        	0         	11             	DEL       
chr13       	16857654    	17412405    	17308432       	17365778       	6         	0         	6              	DEL       
chr13       	16857654    	17412405    	16894614       	17366001       	5         	0         	5              	DUP       
chr13       	16857654    	17412405    	16871215       	17366002       	6         	0         	6              	DUP       
chr13       	16857654    	17412405    	16334420       	17384617       	8         	0         	8              	DUP       
chr13       	16857654    	17412405    	16624630       	17396078       	10        	0         	10             	DEL       
chr13       	16857654    	17412405    	17287341       	17396324       	8         	0         	8              	DUP       
chr13       	16857654    	17412405    	16857655       	17412405       	5         	0         	5              	DEL       
chr13       	16871419    	16894588    	16335056       	16871402       	5         	0         	5              	DUP       
chr13       	16871419    	16894588    	16857691       	16894606       	8         	0         	8              	DEL       
chr13       	16871419    	16894588    	16871420       	16894588       	6         	0         	6              	DEL       
chr13       	16871419    	16894588    	16894614       	17366001       	5         	0         	5              	DUP       
chr13       	16871214    	17366002    	16421724       	17186516       	4         	0         	4              	DUP       
chr13       	16871214    	17366002    	17039759       	17268359       	6         	0         	6              	DUP       
chr13       	16871214    	17366002    	16992912       	17384297       	10        	0         	10             	DEL       
chr13       	16871214    	17366002    	16335056       	16871402       	5         	0         	5              	DUP       
chr13       	16871214    	17366002    	16545807       	16871215       	10        	0         	10             	DEL       
chr13       	16871214    	17366002    	16857691       	16894606       	8         	0         	8              	DEL       
chr13       	16871214    	17366002    	16871420       	16894588       	6         	0         	6              	DEL       
chr13       	16871214    	17366002    	16527018       	16906946       	14        	0         	14             	DEL       
chr13       	16871214    	17366002    	16426040       	16940868       	8         	0         	8              	DEL       
chr13       	16871214    	17366002    	16423786       	16988277       	5         	0         	5              	DUP       
chr13       	16871214    	17366002    	16758343       	16988288       	7         	0         	7              	DUP       
chr13       	16871214    	17366002    	16660100       	16995462       	4         	0         	4              	DEL       
chr13       	16871214    	17366002    	16662346       	16995675       	6         	0         	6              	DUP       
chr13       	16871214    	17366002    	16526728       	17086624       	7         	0         	7              	DUP       
chr13       	16871214    	17366002    	16907030       	17146929       	7         	0         	7              	DUP       
chr13       	16871214    	17366002    	17086703       	17146669       	9         	0         	9              	DEL       
chr13       	16871214    	17366002    	16697712       	17148621       	28        	0         	28             	DEL       
chr13       	16871214    	17366002    	16653275       	17149091       	21        	0         	21             	DUP       
chr13       	16871214    	17366002    	16326634       	17149130       	25        	0         	25             	DUP       
chr13       	16871214    	17366002    	16358190       	17149133       	21        	0         	21             	DUP       
chr13       	16871214    	17366002    	16424005       	17173188       	8         	0         	8              	DEL       
chr13       	16871214    	17366002    	16758779       	17172966       	20        	0         	20             	DEL       
chr13       	16871214    	17366002    	16326891       	17234013       	6         	0         	6              	DEL       
chr13       	16871214    	17366002    	16857428       	17287609       	9         	0         	9              	DUP       
chr13       	16871214    	17366002    	16844815       	17287618       	5         	0         	5              	DUP       
chr13       	16871214    	17366002    	16962335       	17287626       	5         	0         	5              	DUP       
chr13       	16871214    	17366002    	17225277       	17291012       	4         	0         	4              	DEL       
chr13       	16871214    	17366002    	16718018       	17307939       	5         	0         	5              	DEL       
chr13       	16871214    	17366002    	16545501       	17308424       	10        	0         	10             	DUP       
chr13       	16871214    	17366002    	16350419       	17308037       	6         	0         	6              	DEL       
chr13       	16871214    	17366002    	17287337       	17328210       	6         	0         	6              	DUP       
chr13       	16871214    	17366002    	16624662       	17327973       	9         	0         	9              	DEL       
chr13       	16871214    	17366002    	17235839       	17331249       	11        	0         	11             	DUP       
chr13       	16871214    	17366002    	17148658       	17361465       	28        	0         	28             	DUP       
chr13       	16871214    	17366002    	16653266       	17361473       	6         	0         	6              	DUP       
chr13       	16871214    	17366002    	16697709       	17361190       	11        	0         	11             	DEL       
chr13       	16871214    	17366002    	17308432       	17365778       	6         	0         	6              	DEL       
chr13       	16871214    	17366002    	16894614       	17366001       	5         	0         	5              	DUP       
chr13       	16871214    	17366002    	16871215       	17366002       	6         	0         	6              	DUP       
chr13       	16871214    	17366002    	17287341       	17396324       	8         	0         	8              	DUP       
chr13       	16894613    	17366001    	16421724       	17186516       	4         	0         	4              	DUP       
chr13       	16894613    	17366001    	17039759       	17268359       	6         	0         	6              	DUP       
chr13       	16894613    	17366001    	16992912       	17384297       	10        	0         	10             	DEL       
chr13       	16894613    	17366001    	16857691       	16894606       	8         	0         	8              	DEL       
chr13       	16894613    	17366001    	16871420       	16894588       	6         	0         	6              	DEL       
chr13       	16894613    	17366001    	16527018       	16906946       	14        	0         	14             	DEL       
chr13       	16894613    	17366001    	16426040       	16940868       	8         	0         	8              	DEL       
chr13       	16894613    	17366001    	16423786       	16988277       	5         	0         	5              	DUP       
chr13       	16894613    	17366001    	16758343       	16988288       	7         	0         	7              	DUP       
chr13       	16894613    	17366001    	16660100       	16995462       	4         	0         	4              	DEL       
chr13       	16894613    	17366001    	16662346       	16995675       	6         	0         	6              	DUP       
chr13       	16894613    	17366001    	16526728       	17086624       	7         	0         	7              	DUP       
chr13       	16894613    	17366001    	16907030       	17146929       	7         	0         	7              	DUP       
chr13       	16894613    	17366001    	17086703       	17146669       	9         	0         	9              	DEL       
chr13       	16894613    	17366001    	16697712       	17148621       	28        	0         	28             	DEL       
chr13       	16894613    	17366001    	16653275       	17149091       	21        	0         	21             	DUP       
chr13       	16894613    	17366001    	16326634       	17149130       	25        	0         	25             	DUP       
chr13       	16894613    	17366001    	16358190       	17149133       	21        	0         	21             	DUP       
chr13       	16894613    	17366001    	16424005       	17173188       	8         	0         	8              	DEL       
chr13       	16894613    	17366001    	16758779       	17172966       	20        	0         	20             	DEL       
chr13       	16894613    	17366001    	16326891       	17234013       	6         	0         	6              	DEL       
chr13       	16894613    	17366001    	16857428       	17287609       	9         	0         	9              	DUP       
chr13       	16894613    	17366001    	16844815       	17287618       	5         	0         	5              	DUP       
chr13       	16894613    	17366001    	16962335       	17287626       	5         	0         	5              	DUP       
chr13       	16894613    	17366001    	17225277       	17291012       	4         	0         	4              	DEL       
chr13       	16894613    	17366001    	16718018       	17307939       	5         	0         	5              	DEL       
chr13       	16894613    	17366001    	16545501       	17308424       	10        	0         	10             	DUP       
chr13       	16894613    	17366001    	16350419       	17308037       	6         	0         	6              	DEL       
chr13       	16894613    	17366001    	17287337       	17328210       	6         	0         	6              	DUP       
chr13       	16894613    	17366001    	16624662       	17327973       	9         	0         	9              	DEL       
chr13       	16894613    	17366001    	17235839       	17331249       	11        	0         	11             	DUP       
chr13       	16894613    	17366001    	17148658       	17361465       	28        	0         	28             	DUP       
chr13       	16894613    	17366001    	16653266       	17361473       	6         	0         	6              	DUP       
chr13       	16894613    	17366001    	16697709       	17361190       	11        	0         	11             	DEL       
chr13       	16894613    	17366001    	17308432       	17365778       	6         	0         	6              	DEL       
chr13       	16894613    	17366001    	16894614       	17366001       	5         	0         	5              	DUP       
chr13       	16894613    	17366001    	16871215       	17366002       	6         	0         	6              	DUP       
chr13       	16894613    	17366001    	17287341       	17396324       	8         	0         	8              	DUP       
chr13       	16906908    	17146864    	17039759       	17268359       	6         	0         	6              	DUP       
chr13       	16906908    	17146864    	16992912       	17384297       	10        	0         	10             	DEL       
chr13       	16906908    	17146864    	16527018       	16906946       	14        	0         	14             	DEL       
chr13       	16906908    	17146864    	16426040       	16940868       	8         	0         	8              	DEL       
chr13       	16906908    	17146864    	16423786       	16988277       	5         	0         	5              	DUP       
chr13       	16906908    	17146864    	16758343       	16988288       	7         	0         	7              	DUP       
chr13       	16906908    	17146864    	16660100       	16995462       	4         	0         	4              	DEL       
chr13       	16906908    	17146864    	16662346       	16995675       	6         	0         	6              	DUP       
chr13       	16906908    	17146864    	16526728       	17086624       	7         	0         	7              	DUP       
chr13       	16906908    	17146864    	16907030       	17146929       	7         	0         	7              	DUP       
chr13       	16906908    	17146864    	17086703       	17146669       	9         	0         	9              	DEL       
chr13       	16906908    	17146864    	16962335       	17287626       	5         	0         	5              	DUP       
chr13       	16962334    	17287626    	16421724       	17186516       	4         	0         	4              	DUP       
chr13       	16962334    	17287626    	17039759       	17268359       	6         	0         	6              	DUP       
chr13       	16962334    	17287626    	16992912       	17384297       	10        	0         	10             	DEL       
chr13       	16962334    	17287626    	16423786       	16988277       	5         	0         	5              	DUP       
chr13       	16962334    	17287626    	16758343       	16988288       	7         	0         	7              	DUP       
chr13       	16962334    	17287626    	16660100       	16995462       	4         	0         	4              	DEL       
chr13       	16962334    	17287626    	16662346       	16995675       	6         	0         	6              	DUP       
chr13       	16962334    	17287626    	16526728       	17086624       	7         	0         	7              	DUP       
chr13       	16962334    	17287626    	16907030       	17146929       	7         	0         	7              	DUP       
chr13       	16962334    	17287626    	17086703       	17146669       	9         	0         	9              	DEL       
chr13       	16962334    	17287626    	16697712       	17148621       	28        	0         	28             	DEL       
chr13       	16962334    	17287626    	16653275       	17149091       	21        	0         	21             	DUP       
chr13       	16962334    	17287626    	16326634       	17149130       	25        	0         	25             	DUP       
chr13       	16962334    	17287626    	16358190       	17149133       	21        	0         	21             	DUP       
chr13       	16962334    	17287626    	16424005       	17173188       	8         	0         	8              	DEL       
chr13       	16962334    	17287626    	16758779       	17172966       	20        	0         	20             	DEL       
chr13       	16962334    	17287626    	16326891       	17234013       	6         	0         	6              	DEL       
chr13       	16962334    	17287626    	16857428       	17287609       	9         	0         	9              	DUP       
chr13       	16962334    	17287626    	16844815       	17287618       	5         	0         	5              	DUP       
chr13       	16962334    	17287626    	16962335       	17287626       	5         	0         	5              	DUP       
chr13       	16962334    	17287626    	17225277       	17291012       	4         	0         	4              	DEL       
chr13       	16962334    	17287626    	17287337       	17328210       	6         	0         	6              	DUP       
chr13       	16962334    	17287626    	17235839       	17331249       	11        	0         	11             	DUP       
chr13       	16962334    	17287626    	17148658       	17361465       	28        	0         	28             	DUP       
chr13       	16962334    	17287626    	17287341       	17396324       	8         	0         	8              	DUP       
chr13       	16992911    	17384297    	16421724       	17186516       	4         	0         	4              	DUP       
chr13       	16992911    	17384297    	17039759       	17268359       	6         	0         	6              	DUP       
chr13       	16992911    	17384297    	16441597       	17384290       	5         	0         	5              	DEL       
chr13       	16992911    	17384297    	16992912       	17384297       	10        	0         	10             	DEL       
chr13       	16992911    	17384297    	16660100       	16995462       	4         	0         	4              	DEL       
chr13       	16992911    	17384297    	16662346       	16995675       	6         	0         	6              	DUP       
chr13       	16992911    	17384297    	16526728       	17086624       	7         	0         	7              	DUP       
chr13       	16992911    	17384297    	16907030       	17146929       	7         	0         	7              	DUP       
chr13       	16992911    	17384297    	17086703       	17146669       	9         	0         	9              	DEL       
chr13       	16992911    	17384297    	16697712       	17148621       	28        	0         	28             	DEL       
chr13       	16992911    	17384297    	16653275       	17149091       	21        	0         	21             	DUP       
chr13       	16992911    	17384297    	16326634       	17149130       	25        	0         	25             	DUP       
chr13       	16992911    	17384297    	16358190       	17149133       	21        	0         	21             	DUP       
chr13       	16992911    	17384297    	16424005       	17173188       	8         	0         	8              	DEL       
chr13       	16992911    	17384297    	16758779       	17172966       	20        	0         	20             	DEL       
chr13       	16992911    	17384297    	16326891       	17234013       	6         	0         	6              	DEL       
chr13       	16992911    	17384297    	16857428       	17287609       	9         	0         	9              	DUP       
chr13       	16992911    	17384297    	16844815       	17287618       	5         	0         	5              	DUP       
chr13       	16992911    	17384297    	16962335       	17287626       	5         	0         	5              	DUP       
chr13       	16992911    	17384297    	17225277       	17291012       	4         	0         	4              	DEL       
chr13       	16992911    	17384297    	16718018       	17307939       	5         	0         	5              	DEL       
chr13       	16992911    	17384297    	16545501       	17308424       	10        	0         	10             	DUP       
chr13       	16992911    	17384297    	16350419       	17308037       	6         	0         	6              	DEL       
chr13       	16992911    	17384297    	17287337       	17328210       	6         	0         	6              	DUP       
chr13       	16992911    	17384297    	16624662       	17327973       	9         	0         	9              	DEL       
chr13       	16992911    	17384297    	17235839       	17331249       	11        	0         	11             	DUP       
chr13       	16992911    	17384297    	17148658       	17361465       	28        	0         	28             	DUP       
chr13       	16992911    	17384297    	16653266       	17361473       	6         	0         	6              	DUP       
chr13       	16992911    	17384297    	16697709       	17361190       	11        	0         	11             	DEL       
chr13       	16992911    	17384297    	17308432       	17365778       	6         	0         	6              	DEL       
chr13       	16992911    	17384297    	16894614       	17366001       	5         	0         	5              	DUP       
chr13       	16992911    	17384297    	16871215       	17366002       	6         	0         	6              	DUP       
chr13       	16992911    	17384297    	17287341       	17396324       	8         	0         	8              	DUP       
chr13       	17039758    	17268359    	16421724       	17186516       	4         	0         	4              	DUP       
chr13       	17039758    	17268359    	17039759       	17268359       	6         	0         	6              	DUP       
chr13       	17039758    	17268359    	16526728       	17086624       	7         	0         	7              	DUP       
chr13       	17039758    	17268359    	16907030       	17146929       	7         	0         	7              	DUP       
chr13       	17039758    	17268359    	17086703       	17146669       	9         	0         	9              	DEL       
chr13       	17039758    	17268359    	16697712       	17148621       	28        	0         	28             	DEL       
chr13       	17039758    	17268359    	16653275       	17149091       	21        	0         	21             	DUP       
chr13       	17039758    	17268359    	16326634       	17149130       	25        	0         	25             	DUP       
chr13       	17039758    	17268359    	16358190       	17149133       	21        	0         	21             	DUP       
chr13       	17039758    	17268359    	16424005       	17173188       	8         	0         	8              	DEL       
chr13       	17039758    	17268359    	16758779       	17172966       	20        	0         	20             	DEL       
chr13       	17039758    	17268359    	16326891       	17234013       	6         	0         	6              	DEL       
chr13       	17039758    	17268359    	17225277       	17291012       	4         	0         	4              	DEL       
chr13       	17039758    	17268359    	17235839       	17331249       	11        	0         	11             	DUP       
chr13       	17039758    	17268359    	17148658       	17361465       	28        	0         	28             	DUP       
chr13       	17086702    	17146669    	16526728       	17086624       	7         	0         	7              	DUP       
chr13       	17086702    	17146669    	17086703       	17146669       	9         	0         	9              	DEL       
chr13       	17148657    	17361465    	16421724       	17186516       	4         	0         	4              	DUP       
chr13       	17148657    	17361465    	17039759       	17268359       	6         	0         	6              	DUP       
chr13       	17148657    	17361465    	16697712       	17148621       	28        	0         	28             	DEL       
chr13       	17148657    	17361465    	16653275       	17149091       	21        	0         	21             	DUP       
chr13       	17148657    	17361465    	16326634       	17149130       	25        	0         	25             	DUP       
chr13       	17148657    	17361465    	16358190       	17149133       	21        	0         	21             	DUP       
chr13       	17148657    	17361465    	16424005       	17173188       	8         	0         	8              	DEL       
chr13       	17148657    	17361465    	16758779       	17172966       	20        	0         	20             	DEL       
chr13       	17148657    	17361465    	16326891       	17234013       	6         	0         	6              	DEL       
chr13       	17148657    	17361465    	16857428       	17287609       	9         	0         	9              	DUP       
chr13       	17148657    	17361465    	16844815       	17287618       	5         	0         	5              	DUP       
chr13       	17148657    	17361465    	16962335       	17287626       	5         	0         	5              	DUP       
chr13       	17148657    	17361465    	17225277       	17291012       	4         	0         	4              	DEL       
chr13       	17148657    	17361465    	16718018       	17307939       	5         	0         	5              	DEL       
chr13       	17148657    	17361465    	16545501       	17308424       	10        	0         	10             	DUP       
chr13       	17148657    	17361465    	16350419       	17308037       	6         	0         	6              	DEL       
chr13       	17148657    	17361465    	17287337       	17328210       	6         	0         	6              	DUP       
chr13       	17148657    	17361465    	16624662       	17327973       	9         	0         	9              	DEL       
chr13       	17148657    	17361465    	17235839       	17331249       	11        	0         	11             	DUP       
chr13       	17148657    	17361465    	17148658       	17361465       	28        	0         	28             	DUP       
chr13       	17148657    	17361465    	16653266       	17361473       	6         	0         	6              	DUP       
chr13       	17148657    	17361465    	16697709       	17361190       	11        	0         	11             	DEL       
chr13       	17148657    	17361465    	17308432       	17365778       	6         	0         	6              	DEL       
chr13       	17148657    	17361465    	17287341       	17396324       	8         	0         	8              	DUP       
chr13       	17225276    	17291012    	17039759       	17268359       	6         	0         	6              	DUP       
chr13       	17225276    	17291012    	16326891       	17234013       	6         	0         	6              	DEL       
chr13       	17225276    	17291012    	16857428       	17287609       	9         	0         	9              	DUP       
chr13       	17225276    	17291012    	16844815       	17287618       	5         	0         	5              	DUP       
chr13       	17225276    	17291012    	16962335       	17287626       	5         	0         	5              	DUP       
chr13       	17225276    	17291012    	17225277       	17291012       	4         	0         	4              	DEL       
chr13       	17225276    	17291012    	17287337       	17328210       	6         	0         	6              	DUP       
chr13       	17225276    	17291012    	17235839       	17331249       	11        	0         	11             	DUP       
chr13       	17225276    	17291012    	17287341       	17396324       	8         	0         	8              	DUP       
chr13       	17235838    	17331249    	17039759       	17268359       	6         	0         	6              	DUP       
chr13       	17235838    	17331249    	16857428       	17287609       	9         	0         	9              	DUP       
chr13       	17235838    	17331249    	16844815       	17287618       	5         	0         	5              	DUP       
chr13       	17235838    	17331249    	16962335       	17287626       	5         	0         	5              	DUP       
chr13       	17235838    	17331249    	17225277       	17291012       	4         	0         	4              	DEL       
chr13       	17235838    	17331249    	16718018       	17307939       	5         	0         	5              	DEL       
chr13       	17235838    	17331249    	16545501       	17308424       	10        	0         	10             	DUP       
chr13       	17235838    	17331249    	16350419       	17308037       	6         	0         	6              	DEL       
chr13       	17235838    	17331249    	17287337       	17328210       	6         	0         	6              	DUP       
chr13       	17235838    	17331249    	16624662       	17327973       	9         	0         	9              	DEL       
chr13       	17235838    	17331249    	17235839       	17331249       	11        	0         	11             	DUP       
chr13       	17235838    	17331249    	17308432       	17365778       	6         	0         	6              	DEL       
chr13       	17235838    	17331249    	17287341       	17396324       	8         	0         	8              	DUP       
chr13       	17287336    	17328210    	16857428       	17287609       	9         	0         	9              	DUP       
chr13       	17287336    	17328210    	16844815       	17287618       	5         	0         	5              	DUP       
chr13       	17287336    	17328210    	16962335       	17287626       	5         	0         	5              	DUP       
chr13       	17287336    	17328210    	17225277       	17291012       	4         	0         	4              	DEL       
chr13       	17287336    	17328210    	16718018       	17307939       	5         	0         	5              	DEL       
chr13       	17287336    	17328210    	16545501       	17308424       	10        	0         	10             	DUP       
chr13       	17287336    	17328210    	16350419       	17308037       	6         	0         	6              	DEL       
chr13       	17287336    	17328210    	17287337       	17328210       	6         	0         	6              	DUP       
chr13       	17287336    	17328210    	16624662       	17327973       	9         	0         	9              	DEL       
chr13       	17287336    	17328210    	17308432       	17365778       	6         	0         	6              	DEL       
chr13       	17287336    	17328210    	17287341       	17396324       	8         	0         	8              	DUP       
chr13       	17287340    	17396324    	16441597       	17384290       	5         	0         	5              	DEL       
chr13       	17287340    	17396324    	16992912       	17384297       	10        	0         	10             	DEL       
chr13       	17287340    	17396324    	16857428       	17287609       	9         	0         	9              	DUP       
chr13       	17287340    	17396324    	16844815       	17287618       	5         	0         	5              	DUP       
chr13       	17287340    	17396324    	16962335       	17287626       	5         	0         	5              	DUP       
chr13       	17287340    	17396324    	17225277       	17291012       	4         	0         	4              	DEL       
chr13       	17287340    	17396324    	16718018       	17307939       	5         	0         	5              	DEL       
chr13       	17287340    	17396324    	16545501       	17308424       	10        	0         	10             	DUP       
chr13       	17287340    	17396324    	16350419       	17308037       	6         	0         	6              	DEL       
chr13       	17287340    	17396324    	17287337       	17328210       	6         	0         	6              	DUP       
chr13       	17287340    	17396324    	16624662       	17327973       	9         	0         	9              	DEL       
chr13       	17287340    	17396324    	17235839       	17331249       	11        	0         	11             	DUP       
chr13       	17287340    	17396324    	17148658       	17361465       	28        	0         	28             	DUP       
chr13       	17287340    	17396324    	16653266       	17361473       	6         	0         	6              	DUP       
chr13       	17287340    	17396324    	16697709       	17361190       	11        	0         	11             	DEL       
chr13       	17287340    	17396324    	17308432       	17365778       	6         	0         	6              	DEL       
chr13       	17287340    	17396324    	16894614       	17366001       	5         	0         	5              	DUP       
chr13       	17287340    	17396324    	16871215       	17366002       	6         	0         	6              	DUP       
chr13       	17287340    	17396324    	16334420       	17384617       	8         	0         	8              	DUP       
chr13       	17287340    	17396324    	16624630       	17396078       	10        	0         	10             	DEL       
chr13       	17287340    	17396324    	17287341       	17396324       	8         	0         	8              	DUP       
chr13       	17308467    	17365623    	16545501       	17308424       	10        	0         	10             	DUP       
chr13       	17308467    	17365623    	17287337       	17328210       	6         	0         	6              	DUP       
chr13       	17308467    	17365623    	16624662       	17327973       	9         	0         	9              	DEL       
chr13       	17308467    	17365623    	17235839       	17331249       	11        	0         	11             	DUP       
chr13       	17308467    	17365623    	17148658       	17361465       	28        	0         	28             	DUP       
chr13       	17308467    	17365623    	16653266       	17361473       	6         	0         	6              	DUP       
chr13       	17308467    	17365623    	16697709       	17361190       	11        	0         	11             	DEL       
chr13       	17308467    	17365623    	17308432       	17365778       	6         	0         	6              	DEL       
chr13       	17422618    	17668196    	17422619       	17668196       	4         	0         	4              	DUP       
chr13       	17422618    	17668196    	17593846       	17735483       	5         	0         	5              	DUP       
chr13       	17422618    	17668196    	17553570       	17840469       	4         	0         	4              	DEL       
chr13       	17422618    	17668196    	17574407       	17877529       	5         	0         	5              	DEL       
chr13       	17422618    	17668196    	17553255       	17882501       	9         	0         	9              	DUP       
chr13       	17422618    	17668196    	17426130       	17960461       	6         	0         	6              	DEL       
chr13       	17422618    	17668196    	17431912       	18029023       	9         	0         	9              	DEL       
chr13       	17426354    	17960345    	17422619       	17668196       	4         	0         	4              	DUP       
chr13       	17426354    	17960345    	17593846       	17735483       	5         	0         	5              	DUP       
chr13       	17426354    	17960345    	17553570       	17840469       	4         	0         	4              	DEL       
chr13       	17426354    	17960345    	17574407       	17877529       	5         	0         	5              	DEL       
chr13       	17426354    	17960345    	17553255       	17882501       	9         	0         	9              	DUP       
chr13       	17426354    	17960345    	17711206       	17927014       	4         	0         	4              	DEL       
chr13       	17426354    	17960345    	17775623       	17971560       	5         	0         	5              	DUP       
chr13       	17426354    	17960345    	17431912       	18029023       	9         	0         	9              	DEL       
chr13       	17431911    	18029023    	17422619       	17668196       	4         	0         	4              	DUP       
chr13       	17431911    	18029023    	17593846       	17735483       	5         	0         	5              	DUP       
chr13       	17431911    	18029023    	17553570       	17840469       	4         	0         	4              	DEL       
chr13       	17431911    	18029023    	17574407       	17877529       	5         	0         	5              	DEL       
chr13       	17431911    	18029023    	17553255       	17882501       	9         	0         	9              	DUP       
chr13       	17431911    	18029023    	17711206       	17927014       	4         	0         	4              	DEL       
chr13       	17431911    	18029023    	17426130       	17960461       	6         	0         	6              	DEL       
chr13       	17431911    	18029023    	17775623       	17971560       	5         	0         	5              	DUP       
chr13       	17431911    	18029023    	17431912       	18029023       	9         	0         	9              	DEL       
chr13       	17553569    	17840469    	17422619       	17668196       	4         	0         	4              	DUP       
chr13       	17553569    	17840469    	17593846       	17735483       	5         	0         	5              	DUP       
chr13       	17553569    	17840469    	17553570       	17840469       	4         	0         	4              	DEL       
chr13       	17553569    	17840469    	17574407       	17877529       	5         	0         	5              	DEL       
chr13       	17553569    	17840469    	17711206       	17927014       	4         	0         	4              	DEL       
chr13       	17553569    	17840469    	17775623       	17971560       	5         	0         	5              	DUP       
chr13       	17553254    	17882501    	17422619       	17668196       	4         	0         	4              	DUP       
chr13       	17553254    	17882501    	17593846       	17735483       	5         	0         	5              	DUP       
chr13       	17553254    	17882501    	17553570       	17840469       	4         	0         	4              	DEL       
chr13       	17553254    	17882501    	17574407       	17877529       	5         	0         	5              	DEL       
chr13       	17553254    	17882501    	17553255       	17882501       	9         	0         	9              	DUP       
chr13       	17553254    	17882501    	17711206       	17927014       	4         	0         	4              	DEL       
chr13       	17553254    	17882501    	17775623       	17971560       	5         	0         	5              	DUP       
chr13       	17574406    	17877529    	17422619       	17668196       	4         	0         	4              	DUP       
chr13       	17574406    	17877529    	17593846       	17735483       	5         	0         	5              	DUP       
chr13       	17574406    	17877529    	17553570       	17840469       	4         	0         	4              	DEL       
chr13       	17574406    	17877529    	17574407       	17877529       	5         	0         	5              	DEL       
chr13       	17574406    	17877529    	17711206       	17927014       	4         	0         	4              	DEL       
chr13       	17574406    	17877529    	17775623       	17971560       	5         	0         	5              	DUP       
chr13       	17593845    	17735483    	17422619       	17668196       	4         	0         	4              	DUP       
chr13       	17593845    	17735483    	17593846       	17735483       	5         	0         	5              	DUP       
chr13       	17593845    	17735483    	17711206       	17927014       	4         	0         	4              	DEL       
chr13       	17711205    	17927014    	17593846       	17735483       	5         	0         	5              	DUP       
chr13       	17711205    	17927014    	17553570       	17840469       	4         	0         	4              	DEL       
chr13       	17711205    	17927014    	17574407       	17877529       	5         	0         	5              	DEL       
chr13       	17711205    	17927014    	17553255       	17882501       	9         	0         	9              	DUP       
chr13       	17711205    	17927014    	17711206       	17927014       	4         	0         	4              	DEL       
chr13       	17711205    	17927014    	17775623       	17971560       	5         	0         	5              	DUP       
chr13       	17775622    	17971560    	17553570       	17840469       	4         	0         	4              	DEL       
chr13       	17775622    	17971560    	17574407       	17877529       	5         	0         	5              	DEL       
chr13       	17775622    	17971560    	17553255       	17882501       	9         	0         	9              	DUP       
chr13       	17775622    	17971560    	17711206       	17927014       	4         	0         	4              	DEL       
chr13       	17775622    	17971560    	17426130       	17960461       	6         	0         	6              	DEL       
chr13       	17775622    	17971560    	17775623       	17971560       	5         	0         	5              	DUP       
chr13       	18767668    	18787018    	18767667       	18787017       	6         	0         	6              	DEL       
chr13       	19173945    	19174718    	19173949       	19174718       	21        	5         	26             	DEL       
chr13       	19202675    	19703981    	19203274       	19704565       	15        	0         	15             	DUP       
chr13       	19202675    	19703981    	19202698       	19704235       	16        	0         	16             	DEL       
chr13       	19203177    	19704702    	19203274       	19704565       	15        	0         	15             	DUP       
chr13       	19203177    	19704702    	19202698       	19704235       	16        	0         	16             	DEL       
chr13       	21156761    	21157084    	21156778       	21157084       	2         	22        	24             	DEL       
chr13       	22449435    	22449695    	22449436       	22449695       	15        	0         	15             	INV       
chr13       	22481068    	22481376    	22481080       	22481376       	4         	14        	18             	DEL       
chr13       	22936654    	24359615    	23058265       	23063163       	19        	0         	19             	DEL       
chr13       	22936654    	24359615    	23483517       	23483833       	0         	29        	29             	DEL       
chr13       	22936654    	24359615    	24136828       	24137129       	0         	6         	6              	DEL       
chr13       	22936654    	24359615    	22933616       	24356184       	4         	0         	4              	DEL       
chr13       	22936654    	24359615    	22936654       	24359613       	12        	0         	12             	DUP       
chr13       	22936654    	24359615    	22936885       	24360105       	8         	0         	8              	DEL       
chr13       	22936654    	24359615    	22945428       	24367088       	5         	0         	5              	DUP       
chr13       	22936654    	24359615    	22945604       	24367475       	12        	0         	12             	DEL       
chr13       	22936886    	24360106    	23058265       	23063163       	19        	0         	19             	DEL       
chr13       	22936886    	24360106    	23483517       	23483833       	0         	29        	29             	DEL       
chr13       	22936886    	24360106    	24136828       	24137129       	0         	6         	6              	DEL       
chr13       	22936886    	24360106    	22933616       	24356184       	4         	0         	4              	DEL       
chr13       	22936886    	24360106    	22936654       	24359613       	12        	0         	12             	DUP       
chr13       	22936886    	24360106    	22936885       	24360105       	8         	0         	8              	DEL       
chr13       	22936886    	24360106    	22945428       	24367088       	5         	0         	5              	DUP       
chr13       	22936886    	24360106    	22945604       	24367475       	12        	0         	12             	DEL       
chr13       	22945428    	24367090    	23058265       	23063163       	19        	0         	19             	DEL       
chr13       	22945428    	24367090    	23483517       	23483833       	0         	29        	29             	DEL       
chr13       	22945428    	24367090    	24136828       	24137129       	0         	6         	6              	DEL       
chr13       	22945428    	24367090    	22933616       	24356184       	4         	0         	4              	DEL       
chr13       	22945428    	24367090    	22936654       	24359613       	12        	0         	12             	DUP       
chr13       	22945428    	24367090    	22936885       	24360105       	8         	0         	8              	DEL       
chr13       	22945428    	24367090    	22945428       	24367088       	5         	0         	5              	DUP       
chr13       	22945428    	24367090    	22945604       	24367475       	12        	0         	12             	DEL       
chr13       	22944628    	24366507    	23058265       	23063163       	19        	0         	19             	DEL       
chr13       	22944628    	24366507    	23483517       	23483833       	0         	29        	29             	DEL       
chr13       	22944628    	24366507    	24136828       	24137129       	0         	6         	6              	DEL       
chr13       	22944628    	24366507    	22933616       	24356184       	4         	0         	4              	DEL       
chr13       	22944628    	24366507    	22936654       	24359613       	12        	0         	12             	DUP       
chr13       	22944628    	24366507    	22936885       	24360105       	8         	0         	8              	DEL       
chr13       	22944628    	24366507    	22945428       	24367088       	5         	0         	5              	DUP       
chr13       	22944628    	24366507    	22945604       	24367475       	12        	0         	12             	DEL       
chr13       	23058233    	23063169    	23058265       	23063163       	19        	0         	19             	DEL       
chr13       	23483500    	23483833    	23483517       	23483833       	0         	29        	29             	DEL       
chr13       	24136814    	24137129    	24136828       	24137129       	0         	6         	6              	DEL       
chr13       	25031763    	26209582    	25071063       	25071367       	0         	10        	10             	DEL       
chr13       	25031763    	26209582    	25146889       	25147198       	3         	15        	18             	DEL       
chr13       	25031763    	26209582    	25031762       	26209581       	7         	0         	7              	DEL       
chr13       	25031763    	26209582    	25031950       	26209800       	4         	0         	4              	DUP       
chr13       	25071047    	25071367    	25071063       	25071367       	0         	10        	10             	DEL       
chr13       	25146878    	25147198    	25146889       	25147198       	3         	15        	18             	DEL       
chr13       	26475903    	26478049    	26475907       	26478049       	33        	1         	34             	DEL       
chr13       	26972742    	26973549    	26972768       	26973549       	7         	7         	14             	DUP       
chr13       	28265718    	28266045    	28265729       	28266044       	1         	18        	19             	DEL       
chr13       	29148456    	29148777    	29148473       	29148777       	1         	5         	6              	DEL       
chr13       	29211281    	29346454    	29317435       	29317736       	3         	8         	11             	DEL       
chr13       	29211281    	29346454    	29211282       	29346454       	4         	0         	4              	DUP       
chr13       	29211281    	29346454    	29212612       	29347873       	10        	0         	10             	DUP       
chr13       	29212612    	29347875    	29317435       	29317736       	3         	8         	11             	DEL       
chr13       	29212612    	29347875    	29211282       	29346454       	4         	0         	4              	DUP       
chr13       	29212612    	29347875    	29212612       	29347873       	10        	0         	10             	DUP       
chr13       	29317424    	29317736    	29317435       	29317736       	3         	8         	11             	DEL       
chr13       	29375408    	29375627    	29375535       	29375644       	0         	10        	10             	DEL       
chr13       	29380619    	29380944    	29380634       	29380944       	2         	12        	14             	DEL       
chr13       	29641685    	29647707    	29641700       	29647707       	28        	6         	34             	DEL       
chr13       	30601447    	30601783    	30601463       	30601783       	0         	12        	12             	DEL       
chr13       	30844074    	30844344    	30844083       	30844344       	4         	6         	10             	DEL       
chr13       	31389477    	31389549    	31389480       	31389549       	0         	18        	18             	DEL       
chr13       	31958506    	31964664    	31958511       	31964664       	18        	9         	27             	DEL       
chr13       	33618453    	33619184    	33618456       	33619184       	18        	11        	29             	DEL       
chr13       	33816170    	33816525    	33816171       	33816525       	2         	11        	13             	DEL       
chr13       	34067480    	34070212    	34067485       	34070212       	15        	5         	20             	DEL       
chr13       	34237412    	34241371    	34237417       	34241370       	4         	11        	15             	DEL       
chr13       	34237412    	34241371    	34237413       	34241457       	9         	6         	15             	DUP       
chr13       	34237413    	34241454    	34237417       	34241370       	4         	11        	15             	DEL       
chr13       	34237413    	34241454    	34237413       	34241457       	9         	6         	15             	DUP       
chr13       	35864266    	35864585    	35864283       	35864585       	0         	7         	7              	DEL       
chr13       	35956681    	35958485    	35956621       	35958331       	10        	0         	10             	DUP       
chr13       	35956681    	35958485    	35958126       	35958287       	0         	16        	16             	DUP       
chr13       	35956681    	35958485    	35956681       	35957930       	14        	5         	19             	DEL       
chr13       	35956681    	35958485    	35957999       	35958131       	1         	3         	4              	DEL       
chr13       	35956313    	35958440    	35956621       	35958331       	10        	0         	10             	DUP       
chr13       	35956313    	35958440    	35958126       	35958287       	0         	16        	16             	DUP       
chr13       	35956313    	35958440    	35956681       	35957930       	14        	5         	19             	DEL       
chr13       	35956313    	35958440    	35957999       	35958131       	1         	3         	4              	DEL       
chr13       	35957998    	35958131    	35958126       	35958287       	0         	16        	16             	DUP       
chr13       	35957998    	35958131    	35956681       	35957930       	14        	5         	19             	DEL       
chr13       	35957998    	35958131    	35957999       	35958131       	1         	3         	4              	DEL       
chr13       	35958125    	35958287    	35956621       	35958331       	10        	0         	10             	DUP       
chr13       	35958125    	35958287    	35958126       	35958287       	0         	16        	16             	DUP       
chr13       	35958125    	35958287    	35957999       	35958131       	1         	3         	4              	DEL       
chr13       	36232632    	36232724    	36232650       	36232724       	0         	12        	12             	DEL       
chr13       	36840327    	36840648    	36840330       	36840648       	2         	3         	5              	DEL       
chr13       	38483177    	38486064    	38483182       	38486064       	30        	11        	41             	DEL       
chr13       	39360044    	39361343    	39360081       	39361343       	19        	0         	19             	DEL       
chr13       	39454331    	39454654    	39454344       	39454654       	0         	15        	15             	DEL       
chr13       	40696974    	40697287    	40696990       	40697287       	1         	10        	11             	DEL       
chr13       	40879699    	40879753    	40879700       	40879753       	0         	4         	4              	DEL       
chr13       	41580963    	41581301    	41580980       	41581301       	1         	15        	16             	DEL       
chr13       	42181815    	42182089    	42181844       	42182089       	1         	8         	9              	DEL       
chr13       	42371910    	42372242    	42371946       	42372242       	3         	4         	7              	DEL       
chr13       	42373131    	42373516    	42373132       	42373518       	0         	12        	12             	DUP       
chr13       	42479151    	42479758    	42479152       	42479758       	10        	0         	10             	DEL       
chr13       	42965657    	42967311    	42965673       	42967311       	14        	4         	18             	DEL       
chr13       	43616129    	43616190    	43616102       	43616182       	0         	7         	7              	DEL       
chr13       	47115340    	47115655    	47115355       	47115655       	0         	25        	25             	DEL       
chr13       	48959168    	48962486    	48959167       	48962485       	7         	0         	7              	DEL       
chr13       	49377264    	49379726    	49377278       	49379720       	63        	42        	105            	DEL       
chr13       	50977797    	50978127    	50977815       	50978127       	0         	11        	11             	DEL       
chr13       	51348685    	51348848    	51348686       	51348848       	0         	6         	6              	DUP       
chr13       	53949929    	53950255    	53949948       	53950255       	0         	5         	5              	DEL       
chr13       	55367042    	55367333    	55367047       	55367333       	1         	6         	7              	DEL       
chr13       	55576960    	55577084    	55576963       	55577084       	0         	8         	8              	DEL       
chr13       	56249951    	56251035    	56249952       	56251035       	27        	11        	38             	DEL       
chr13       	56277456    	56278287    	56277459       	56278287       	28        	7         	35             	DEL       
chr13       	57401365    	57401715    	57401381       	57401714       	1         	26        	27             	DEL       
chr13       	58470628    	58470945    	58470636       	58470945       	0         	14        	14             	DEL       
chr13       	59598355    	59598689    	59598365       	59598689       	3         	22        	25             	DEL       
chr13       	60212026    	60212354    	60212027       	60212354       	1         	11        	12             	DEL       
chr13       	60307309    	60307559    	60307313       	60307559       	1         	4         	5              	DEL       
chr13       	60358317    	60358423    	60358339       	60358423       	0         	15        	15             	DEL       
chr13       	60978898    	60979731    	60978902       	60979731       	19        	10        	29             	DEL       
chr13       	62949669    	62949986    	62949683       	62949986       	2         	21        	23             	DEL       
chr13       	63082049    	63082377    	63082060       	63082377       	0         	13        	13             	DEL       
chr13       	64329165    	64329480    	64329175       	64329480       	1         	12        	13             	DEL       
chr13       	64768294    	64770291    	64768301       	64770291       	23        	7         	30             	DEL       
chr13       	64987487    	64987802    	64987488       	64987802       	9         	0         	9              	INV       
chr13       	65063675    	65064078    	65063676       	65064078       	3         	9         	12             	DEL       
chr13       	68362755    	68363134    	68362756       	68363134       	3         	11        	14             	DEL       
chr13       	68868493    	68868593    	68868497       	68868585       	0         	6         	6              	DEL       
chr13       	69392529    	69392829    	69392535       	69392829       	1         	23        	24             	DEL       
chr13       	71903125    	71906438    	71903127       	71906438       	17        	12        	29             	DEL       
chr13       	72268898    	72272786    	72268899       	72272786       	22        	1         	23             	DEL       
chr13       	72382571    	72382883    	72382586       	72382882       	3         	8         	11             	DEL       
chr13       	73162145    	73162804    	73162146       	73162806       	3         	3         	6              	DUP       
chr13       	73500773    	73501102    	73500784       	73501102       	3         	17        	20             	DEL       
chr13       	74341158    	74342612    	74341159       	74342612       	12        	7         	19             	DEL       
chr13       	74341158    	74342612    	74341243       	74342864       	9         	0         	9              	DUP       
chr13       	74341143    	74342861    	74341159       	74342612       	12        	7         	19             	DEL       
chr13       	74341143    	74342861    	74341243       	74342864       	9         	0         	9              	DUP       
chr13       	75051061    	75051140    	75051062       	75051140       	0         	14        	14             	DEL       
chr13       	76065136    	76065465    	76065146       	76065464       	1         	8         	9              	DEL       
chr13       	78665623    	78666117    	78665631       	78666117       	1         	3         	4              	DEL       
chr13       	79086931    	79087267    	79086946       	79087267       	3         	10        	13             	DEL       
chr13       	79507256    	79507573    	79507272       	79507573       	2         	7         	9              	DEL       
chr13       	81173100    	81173429    	81173120       	81173429       	1         	6         	7              	DEL       
chr13       	81782738    	81782837    	81782739       	81782837       	25        	24        	49             	INV       
chr13       	82315058    	82315402    	82315077       	82315402       	1         	12        	13             	DEL       
chr13       	82481911    	82481970    	82481950       	82482001       	0         	4         	4              	DEL       
chr13       	82591798    	82598070    	82591801       	82598070       	21        	7         	28             	DEL       
chr13       	82605312    	82605620    	82605327       	82605620       	2         	19        	21             	DEL       
chr13       	83375145    	83375369    	83375158       	83375369       	1         	12        	13             	DEL       
chr13       	85226275    	85229255    	85226276       	85229255       	25        	1         	26             	DEL       
chr13       	85730226    	85730483    	85730227       	85730483       	15        	0         	15             	INV       
chr13       	86078160    	86078243    	86078175       	86078232       	0         	7         	7              	DEL       
chr13       	86085071    	86085289    	86085072       	86085282       	0         	13        	13             	DEL       
chr13       	88351008    	88351345    	88351028       	88351345       	7         	12        	19             	DEL       
chr13       	89769112    	89769266    	89769129       	89769266       	0         	15        	15             	DEL       
chr13       	90507783    	90508033    	90507799       	90508033       	1         	28        	29             	DEL       
chr13       	93231322    	93231425    	93231341       	93231414       	0         	7         	7              	DEL       
chr13       	93676113    	93676180    	93676114       	93676180       	0         	4         	4              	DEL       
chr13       	95981167    	95981486    	95981182       	95981486       	1         	17        	18             	DEL       
chr13       	97339101    	97339274    	97339102       	97339274       	0         	5         	5              	DUP       
chr13       	98068981    	98069302    	98068996       	98069302       	2         	10        	12             	DEL       
chr13       	98971447    	98971583    	98971460       	98971583       	0         	4         	4              	DEL       
chr13       	99026009    	99026097    	99026026       	99026097       	1         	5         	6              	DEL       
chr13       	101241791   	101244073   	101241795      	101244073      	24        	10        	34             	DEL       
chr13       	101254591   	101254911   	101254609      	101254911      	0         	11        	11             	DEL       
chr13       	103439413   	103439896   	103439415      	103439896      	12        	27        	39             	DEL       
chr13       	103492026   	103492310   	103492040      	103492310      	3         	27        	30             	DEL       
chr13       	104508857   	104509172   	104508870      	104509172      	1         	21        	22             	DEL       
chr13       	104654110   	104654972   	104654111      	104654972      	9         	0         	9              	DEL       
chr13       	105055738   	105056083   	105055752      	105056083      	4         	27        	31             	DEL       
chr13       	105796973   	105797572   	105796974      	105797572      	13        	5         	18             	DEL       
chr13       	107272189   	107272513   	107272201      	107272513      	2         	19        	21             	DEL       
chr13       	107908179   	107909137   	107908211      	107909111      	25        	0         	25             	DEL       
chr13       	108709396   	108710089   	108709400      	108710089      	30        	20        	50             	DEL       
chr13       	109765762   	109766902   	109765665      	109766723      	18        	0         	18             	DEL       
chr13       	110907066   	110907305   	110907081      	110907305      	1         	9         	10             	DEL       
chr13       	110928540   	110928729   	110928541      	110928733      	0         	13        	13             	DUP       
chr13       	110938202   	110938396   	110938203      	110938399      	0         	8         	8              	DUP       
chr13       	112766853   	112767431   	112766854      	112767431      	4         	0         	4              	DEL       
chr13       	113672392   	113672557   	113672393      	113672557      	0         	11        	11             	DUP       
chr14       	16127946    	16128688    	16127947       	16128688       	11        	0         	11             	DEL       
chr14       	16136218    	16137856    	16136219       	16137856       	45        	0         	45             	DEL       
chr14       	19907851    	19911319    	19907853       	19911319       	13        	11        	24             	DEL       
chr14       	21067984    	21068298    	21067985       	21068298       	0         	4         	4              	DEL       
chr14       	21310026    	21310242    	21310028       	21310242       	0         	17        	17             	DEL       
chr14       	22449120    	22513938    	22449121       	22513942       	28        	11        	39             	DEL       
chr14       	23453036    	23453437    	23453042       	23453437       	2         	25        	27             	DEL       
chr14       	23900200    	23900406    	23900201       	23900406       	0         	10        	10             	DUP       
chr14       	23966234    	24001072    	23966235       	24001072       	4         	0         	4              	DUP       
chr14       	23966234    	24001072    	23974044       	24016264       	5         	0         	5              	DUP       
chr14       	23974044    	24016266    	23966235       	24001072       	4         	0         	4              	DUP       
chr14       	23974044    	24016266    	23974044       	24016264       	5         	0         	5              	DUP       
chr14       	24463412    	24463577    	24463413       	24463577       	0         	8         	8              	DEL       
chr14       	25536589    	25536841    	25536606       	25536841       	1         	8         	9              	DEL       
chr14       	26232400    	26232712    	26232412       	26232712       	1         	25        	26             	DEL       
chr14       	28400636    	28402954    	28400640       	28402954       	65        	16        	81             	DEL       
chr14       	29258831    	29259596    	29258843       	29259596       	34        	20        	54             	DEL       
chr14       	30517300    	30517555    	30517301       	30517555       	0         	11        	11             	DEL       
chr14       	30793777    	30794108    	30793794       	30794108       	4         	14        	18             	DEL       
chr14       	31344669    	31344844    	31344672       	31344844       	0         	19        	19             	DEL       
chr14       	31473788    	31474114    	31473803       	31474114       	2         	15        	17             	DEL       
chr14       	32922765    	32923102    	32922766       	32923102       	0         	4         	4              	DEL       
chr14       	33820828    	33821168    	33820842       	33821168       	1         	19        	20             	DEL       
chr14       	34044819    	34045630    	34044820       	34045630       	16        	7         	23             	DEL       
chr14       	34932195    	34932517    	34932207       	34932517       	1         	13        	14             	DEL       
chr14       	35038493    	35040301    	35038509       	35040301       	23        	6         	29             	DEL       
chr14       	35136407    	35145862    	35136434       	35145837       	11        	0         	11             	DEL       
chr14       	37663942    	37668608    	37663943       	37668608       	16        	9         	25             	DEL       
chr14       	37776029    	37776246    	37776046       	37776246       	0         	6         	6              	DEL       
chr14       	38535313    	38535823    	38535314       	38535823       	7         	7         	14             	DEL       
chr14       	39629186    	39631009    	39629205       	39631009       	26        	12        	38             	DEL       
chr14       	42291872    	42292221    	42291888       	42292220       	1         	9         	10             	DEL       
chr14       	46108719    	46109040    	46108735       	46109040       	0         	22        	22             	DEL       
chr14       	47865037    	47865353    	47865052       	47865353       	0         	8         	8              	DEL       
chr14       	48882020    	49020572    	48882021       	49020572       	2         	12        	14             	DUP       
chr14       	48882020    	49020572    	49020571       	49023145       	14        	0         	14             	DEL       
chr14       	48882020    	49020572    	48882202       	49023231       	12        	0         	12             	DEL       
chr14       	48882105    	49023145    	48882021       	49020572       	2         	12        	14             	DUP       
chr14       	48882105    	49023145    	49020571       	49023145       	14        	0         	14             	DEL       
chr14       	48882105    	49023145    	48882202       	49023231       	12        	0         	12             	DEL       
chr14       	49020573    	49023163    	48882021       	49020572       	2         	12        	14             	DUP       
chr14       	49020573    	49023163    	49020571       	49023145       	14        	0         	14             	DEL       
chr14       	49020573    	49023163    	48882202       	49023231       	12        	0         	12             	DEL       
chr14       	49491724    	49491871    	49491738       	49491871       	0         	5         	5              	DEL       
chr14       	49536545    	49536636    	49536544       	49536636       	0         	11        	11             	DEL       
chr14       	49652151    	49652310    	49652169       	49652309       	0         	8         	8              	DEL       
chr14       	49725321    	49725642    	49725322       	49725638       	1         	10        	11             	DUP       
chr14       	50073400    	50074940    	50073416       	50074944       	23        	0         	23             	DEL       
chr14       	51134685    	51134989    	51134695       	51134989       	1         	15        	16             	DEL       
chr14       	51927149    	51927256    	51927163       	51927256       	0         	17        	17             	DEL       
chr14       	54097332    	54097667    	54097348       	54097667       	2         	24        	26             	DEL       
chr14       	56200141    	56200312    	56200142       	56200312       	0         	22        	22             	DUP       
chr14       	59078579    	59078887    	59078595       	59078887       	2         	18        	20             	DEL       
chr14       	59874678    	59876523    	59874680       	59876523       	26        	9         	35             	DEL       
chr14       	60591336    	60592771    	60591337       	60592771       	20        	8         	28             	DEL       
chr14       	63256940    	63258140    	63257040       	63258166       	13        	0         	13             	DEL       
chr14       	64893667    	64896822    	64893678       	64896822       	21        	12        	33             	DEL       
chr14       	66343910    	66344223    	66343926       	66344223       	1         	11        	12             	DEL       
chr14       	67367475    	67396309    	67367475       	67396269       	6         	0         	6              	DUP       
chr14       	68136313    	68137014    	68136341       	68137014       	37        	18        	55             	DEL       
chr14       	68356197    	68356797    	68356197       	68356738       	4         	0         	4              	DUP       
chr14       	68528661    	68528736    	68528677       	68528736       	0         	20        	20             	DEL       
chr14       	69313594    	69313755    	69313595       	69313766       	0         	9         	9              	DUP       
chr14       	70223334    	70223523    	70223351       	70223523       	0         	9         	9              	DEL       
chr14       	70331741    	70331820    	70331742       	70331820       	0         	9         	9              	DEL       
chr14       	70611880    	70612015    	70611903       	70612015       	0         	6         	6              	DEL       
chr14       	70854242    	70854536    	70854261       	70854536       	3         	21        	24             	DEL       
chr14       	70971109    	70971443    	70971119       	70971443       	1         	24        	25             	DEL       
chr14       	73540145    	73571938    	73540145       	73571936       	6         	0         	6              	DUP       
chr14       	73540145    	73571938    	73543989       	73575733       	5         	0         	5              	DUP       
chr14       	73543989    	73575735    	73540145       	73571936       	6         	0         	6              	DUP       
chr14       	73543989    	73575735    	73543989       	73575733       	5         	0         	5              	DUP       
chr14       	73951916    	73952221    	73951923       	73952215       	0         	6         	6              	DEL       
chr14       	75115057    	75115114    	75115062       	75115114       	0         	4         	4              	DEL       
chr14       	76347429    	76347865    	76347431       	76347865       	0         	7         	7              	DEL       
chr14       	78361889    	78362242    	78361902       	78362241       	2         	23        	25             	DEL       
chr14       	79187582    	79187682    	79187599       	79187682       	0         	23        	23             	DEL       
chr14       	79639944    	79648706    	79639947       	79648707       	14        	8         	22             	DEL       
chr14       	81002770    	81003084    	81002783       	81003083       	0         	10        	10             	DEL       
chr14       	82032765    	82036986    	82032766       	82036986       	27        	10        	37             	DEL       
chr14       	82553256    	82553538    	82553272       	82553538       	2         	23        	25             	DEL       
chr14       	83169491    	83170140    	83169509       	83170139       	18        	16        	34             	DEL       
chr14       	83434046    	83434137    	83434066       	83434137       	0         	14        	14             	DEL       
chr14       	84830763    	84835811    	84830772       	84835811       	23        	12        	35             	DEL       
chr14       	87391711    	87392040    	87391720       	87392039       	1         	18        	19             	DEL       
chr14       	87672775    	87674792    	87672776       	87674792       	24        	7         	31             	DEL       
chr14       	87698362    	87698764    	87698366       	87698764       	4         	7         	11             	DEL       
chr14       	88423673    	88423832    	88423674       	88423832       	0         	18        	18             	DEL       
chr14       	88682798    	88684456    	88683086       	88684235       	12        	0         	12             	DUP       
chr14       	88942483    	88942734    	88942494       	88942734       	0         	28        	28             	DEL       
chr14       	90694630    	90695202    	90694631       	90695202       	9         	0         	9              	DUP       
chr14       	90694630    	90695202    	90694896       	90695387       	0         	4         	4              	DUP       
chr14       	90700684    	90700780    	90700693       	90700780       	0         	7         	7              	DEL       
chr14       	93459707    	93460124    	93459761       	93460282       	11        	0         	11             	INV       
chr14       	94172400    	94173538    	94172403       	94173538       	17        	8         	25             	DEL       
chr14       	94363765    	94378740    	94363764       	94378739       	7         	0         	7              	DEL       
chr14       	97736592    	98089117    	97736593       	98089117       	0         	5         	5              	DUP       
chr14       	98317642    	98318750    	98317666       	98318750       	19        	10        	29             	DEL       
chr14       	98356256    	98356334    	98356283       	98356334       	0         	6         	6              	DEL       
chr14       	100378659   	100378993   	100378677      	100378993      	0         	5         	5              	DEL       
chr14       	101524528   	101524865   	101524539      	101524865      	2         	11        	13             	DEL       
chr14       	101923804   	101923927   	101923805      	101923927      	0         	15        	15             	DEL       
chr14       	103297683   	103297788   	103297685      	103297788      	1         	9         	10             	DEL       
chr14       	103999642   	103999779   	103999643      	103999779      	0         	6         	6              	DEL       
chr14       	104288822   	104289534   	104288822      	104289472      	6         	0         	6              	DUP       
chr14       	104430171   	104430682   	104430172      	104430682      	5         	0         	5              	DEL       
chr14       	104807634   	104808347   	104807635      	104808347      	17        	0         	17             	DEL       
chr14       	104948875   	104951596   	104949017      	104951401      	23        	0         	23             	DEL       
chr14       	105040102   	105040708   	105040103      	105040708      	12        	0         	12             	DEL       
chr14       	105162474   	105162660   	105162462      	105162670      	0         	4         	4              	DUP       
chr14       	105573496   	105693808   	105573431      	105693807      	6         	0         	6              	DEL       
chr14       	105573496   	105693808   	105625888      	105743031      	8         	0         	8              	DEL       
chr14       	105573496   	105693808   	105617837      	105637362      	8         	0         	8              	DEL       
chr14       	105573496   	105693808   	105627828      	105646403      	5         	0         	5              	DUP       
chr14       	105573496   	105693808   	105627744      	105646373      	4         	1         	5              	DEL       
chr14       	105573496   	105693808   	105630109      	105649140      	10        	0         	10             	DEL       
chr14       	105573496   	105693808   	105630582      	105649475      	27        	0         	27             	DUP       
chr14       	105573496   	105693808   	105580950      	105700630      	6         	0         	6              	DUP       
chr14       	105573496   	105693808   	105614627      	105729860      	10        	0         	10             	DEL       
chr14       	105573496   	105693808   	105634678      	105730209      	4         	0         	4              	DUP       
chr14       	105573496   	105693808   	105668289      	105741766      	7         	0         	7              	DEL       
chr14       	105573496   	105693808   	105616415      	105760980      	0         	7         	7              	DUP       
chr14       	105573496   	105693808   	105617598      	105761983      	6         	0         	6              	DEL       
chr14       	105573496   	105693808   	105619376      	105763510      	8         	0         	8              	DUP       
chr14       	105580950   	105700632   	105573431      	105693807      	6         	0         	6              	DEL       
chr14       	105580950   	105700632   	105625888      	105743031      	8         	0         	8              	DEL       
chr14       	105580950   	105700632   	105617837      	105637362      	8         	0         	8              	DEL       
chr14       	105580950   	105700632   	105627828      	105646403      	5         	0         	5              	DUP       
chr14       	105580950   	105700632   	105627744      	105646373      	4         	1         	5              	DEL       
chr14       	105580950   	105700632   	105630109      	105649140      	10        	0         	10             	DEL       
chr14       	105580950   	105700632   	105630582      	105649475      	27        	0         	27             	DUP       
chr14       	105580950   	105700632   	105580950      	105700630      	6         	0         	6              	DUP       
chr14       	105580950   	105700632   	105614627      	105729860      	10        	0         	10             	DEL       
chr14       	105580950   	105700632   	105634678      	105730209      	4         	0         	4              	DUP       
chr14       	105580950   	105700632   	105668289      	105741766      	7         	0         	7              	DEL       
chr14       	105580950   	105700632   	105616415      	105760980      	0         	7         	7              	DUP       
chr14       	105580950   	105700632   	105617598      	105761983      	6         	0         	6              	DEL       
chr14       	105580950   	105700632   	105619376      	105763510      	8         	0         	8              	DUP       
chr14       	105614628   	105729861   	105573431      	105693807      	6         	0         	6              	DEL       
chr14       	105614628   	105729861   	105625888      	105743031      	8         	0         	8              	DEL       
chr14       	105614628   	105729861   	105617837      	105637362      	8         	0         	8              	DEL       
chr14       	105614628   	105729861   	105627828      	105646403      	5         	0         	5              	DUP       
chr14       	105614628   	105729861   	105627744      	105646373      	4         	1         	5              	DEL       
chr14       	105614628   	105729861   	105630109      	105649140      	10        	0         	10             	DEL       
chr14       	105614628   	105729861   	105630582      	105649475      	27        	0         	27             	DUP       
chr14       	105614628   	105729861   	105580950      	105700630      	6         	0         	6              	DUP       
chr14       	105614628   	105729861   	105717903      	105718852      	4         	0         	4              	DEL       
chr14       	105614628   	105729861   	105614627      	105729860      	10        	0         	10             	DEL       
chr14       	105614628   	105729861   	105634678      	105730209      	4         	0         	4              	DUP       
chr14       	105614628   	105729861   	105668289      	105741766      	7         	0         	7              	DEL       
chr14       	105614628   	105729861   	105725725      	105755234      	4         	0         	4              	DEL       
chr14       	105614628   	105729861   	105616415      	105760980      	0         	7         	7              	DUP       
chr14       	105614628   	105729861   	105617598      	105761983      	6         	0         	6              	DEL       
chr14       	105614628   	105729861   	105619376      	105763510      	8         	0         	8              	DUP       
chr14       	105616345   	105760943   	105573431      	105693807      	6         	0         	6              	DEL       
chr14       	105616345   	105760943   	105625888      	105743031      	8         	0         	8              	DEL       
chr14       	105616345   	105760943   	105617837      	105637362      	8         	0         	8              	DEL       
chr14       	105616345   	105760943   	105627828      	105646403      	5         	0         	5              	DUP       
chr14       	105616345   	105760943   	105627744      	105646373      	4         	1         	5              	DEL       
chr14       	105616345   	105760943   	105630109      	105649140      	10        	0         	10             	DEL       
chr14       	105616345   	105760943   	105630582      	105649475      	27        	0         	27             	DUP       
chr14       	105616345   	105760943   	105580950      	105700630      	6         	0         	6              	DUP       
chr14       	105616345   	105760943   	105717903      	105718852      	4         	0         	4              	DEL       
chr14       	105616345   	105760943   	105614627      	105729860      	10        	0         	10             	DEL       
chr14       	105616345   	105760943   	105634678      	105730209      	4         	0         	4              	DUP       
chr14       	105616345   	105760943   	105668289      	105741766      	7         	0         	7              	DEL       
chr14       	105616345   	105760943   	105725725      	105755234      	4         	0         	4              	DEL       
chr14       	105616345   	105760943   	105746056      	105756304      	4         	0         	4              	DEL       
chr14       	105616345   	105760943   	105616415      	105760980      	0         	7         	7              	DUP       
chr14       	105616345   	105760943   	105617598      	105761983      	6         	0         	6              	DEL       
chr14       	105616345   	105760943   	105619376      	105763510      	8         	0         	8              	DUP       
chr14       	105616345   	105760943   	105740065      	105768176      	4         	0         	4              	DEL       
chr14       	105616345   	105760943   	105743665      	105771937      	6         	0         	6              	DEL       
chr14       	105617838   	105637363   	105625888      	105743031      	8         	0         	8              	DEL       
chr14       	105617838   	105637363   	105617837      	105637362      	8         	0         	8              	DEL       
chr14       	105617838   	105637363   	105627828      	105646403      	5         	0         	5              	DUP       
chr14       	105617838   	105637363   	105627744      	105646373      	4         	1         	5              	DEL       
chr14       	105617838   	105637363   	105630109      	105649140      	10        	0         	10             	DEL       
chr14       	105617838   	105637363   	105630582      	105649475      	27        	0         	27             	DUP       
chr14       	105617838   	105637363   	105634678      	105730209      	4         	0         	4              	DUP       
chr14       	105617838   	105637363   	105619376      	105763510      	8         	0         	8              	DUP       
chr14       	105619376   	105763512   	105573431      	105693807      	6         	0         	6              	DEL       
chr14       	105619376   	105763512   	105625888      	105743031      	8         	0         	8              	DEL       
chr14       	105619376   	105763512   	105617837      	105637362      	8         	0         	8              	DEL       
chr14       	105619376   	105763512   	105627828      	105646403      	5         	0         	5              	DUP       
chr14       	105619376   	105763512   	105627744      	105646373      	4         	1         	5              	DEL       
chr14       	105619376   	105763512   	105630109      	105649140      	10        	0         	10             	DEL       
chr14       	105619376   	105763512   	105630582      	105649475      	27        	0         	27             	DUP       
chr14       	105619376   	105763512   	105580950      	105700630      	6         	0         	6              	DUP       
chr14       	105619376   	105763512   	105717903      	105718852      	4         	0         	4              	DEL       
chr14       	105619376   	105763512   	105614627      	105729860      	10        	0         	10             	DEL       
chr14       	105619376   	105763512   	105634678      	105730209      	4         	0         	4              	DUP       
chr14       	105619376   	105763512   	105668289      	105741766      	7         	0         	7              	DEL       
chr14       	105619376   	105763512   	105725725      	105755234      	4         	0         	4              	DEL       
chr14       	105619376   	105763512   	105746056      	105756304      	4         	0         	4              	DEL       
chr14       	105619376   	105763512   	105616415      	105760980      	0         	7         	7              	DUP       
chr14       	105619376   	105763512   	105617598      	105761983      	6         	0         	6              	DEL       
chr14       	105619376   	105763512   	105619376      	105763510      	8         	0         	8              	DUP       
chr14       	105619376   	105763512   	105740065      	105768176      	4         	0         	4              	DEL       
chr14       	105619376   	105763512   	105743665      	105771937      	6         	0         	6              	DEL       
chr14       	105625889   	105743032   	105573431      	105693807      	6         	0         	6              	DEL       
chr14       	105625889   	105743032   	105625888      	105743031      	8         	0         	8              	DEL       
chr14       	105625889   	105743032   	105617837      	105637362      	8         	0         	8              	DEL       
chr14       	105625889   	105743032   	105627828      	105646403      	5         	0         	5              	DUP       
chr14       	105625889   	105743032   	105627744      	105646373      	4         	1         	5              	DEL       
chr14       	105625889   	105743032   	105630109      	105649140      	10        	0         	10             	DEL       
chr14       	105625889   	105743032   	105630582      	105649475      	27        	0         	27             	DUP       
chr14       	105625889   	105743032   	105580950      	105700630      	6         	0         	6              	DUP       
chr14       	105625889   	105743032   	105717903      	105718852      	4         	0         	4              	DEL       
chr14       	105625889   	105743032   	105614627      	105729860      	10        	0         	10             	DEL       
chr14       	105625889   	105743032   	105634678      	105730209      	4         	0         	4              	DUP       
chr14       	105625889   	105743032   	105668289      	105741766      	7         	0         	7              	DEL       
chr14       	105625889   	105743032   	105725725      	105755234      	4         	0         	4              	DEL       
chr14       	105625889   	105743032   	105740065      	105768176      	4         	0         	4              	DEL       
chr14       	105627743   	105646373   	105617837      	105637362      	8         	0         	8              	DEL       
chr14       	105627743   	105646373   	105627828      	105646403      	5         	0         	5              	DUP       
chr14       	105627743   	105646373   	105627744      	105646373      	4         	1         	5              	DEL       
chr14       	105627743   	105646373   	105630109      	105649140      	10        	0         	10             	DEL       
chr14       	105627743   	105646373   	105630582      	105649475      	27        	0         	27             	DUP       
chr14       	105627743   	105646373   	105634678      	105730209      	4         	0         	4              	DUP       
chr14       	105627828   	105646405   	105617837      	105637362      	8         	0         	8              	DEL       
chr14       	105627828   	105646405   	105627828      	105646403      	5         	0         	5              	DUP       
chr14       	105627828   	105646405   	105627744      	105646373      	4         	1         	5              	DEL       
chr14       	105627828   	105646405   	105630109      	105649140      	10        	0         	10             	DEL       
chr14       	105627828   	105646405   	105630582      	105649475      	27        	0         	27             	DUP       
chr14       	105627828   	105646405   	105634678      	105730209      	4         	0         	4              	DUP       
chr14       	105630110   	105649141   	105617837      	105637362      	8         	0         	8              	DEL       
chr14       	105630110   	105649141   	105627828      	105646403      	5         	0         	5              	DUP       
chr14       	105630110   	105649141   	105627744      	105646373      	4         	1         	5              	DEL       
chr14       	105630110   	105649141   	105630109      	105649140      	10        	0         	10             	DEL       
chr14       	105630110   	105649141   	105630582      	105649475      	27        	0         	27             	DUP       
chr14       	105630110   	105649141   	105634678      	105730209      	4         	0         	4              	DUP       
chr14       	105630582   	105649477   	105617837      	105637362      	8         	0         	8              	DEL       
chr14       	105630582   	105649477   	105627828      	105646403      	5         	0         	5              	DUP       
chr14       	105630582   	105649477   	105627744      	105646373      	4         	1         	5              	DEL       
chr14       	105630582   	105649477   	105630109      	105649140      	10        	0         	10             	DEL       
chr14       	105630582   	105649477   	105630582      	105649475      	27        	0         	27             	DUP       
chr14       	105630582   	105649477   	105634678      	105730209      	4         	0         	4              	DUP       
chr14       	105668290   	105741767   	105573431      	105693807      	6         	0         	6              	DEL       
chr14       	105668290   	105741767   	105580950      	105700630      	6         	0         	6              	DUP       
chr14       	105668290   	105741767   	105717903      	105718852      	4         	0         	4              	DEL       
chr14       	105668290   	105741767   	105614627      	105729860      	10        	0         	10             	DEL       
chr14       	105668290   	105741767   	105634678      	105730209      	4         	0         	4              	DUP       
chr14       	105668290   	105741767   	105668289      	105741766      	7         	0         	7              	DEL       
chr14       	105668290   	105741767   	105725725      	105755234      	4         	0         	4              	DEL       
chr14       	105668290   	105741767   	105740065      	105768176      	4         	0         	4              	DEL       
chr14       	105717902   	105718852   	105717903      	105718852      	4         	0         	4              	DEL       
chr14       	105725724   	105755234   	105625888      	105743031      	8         	0         	8              	DEL       
chr14       	105725724   	105755234   	105614627      	105729860      	10        	0         	10             	DEL       
chr14       	105725724   	105755234   	105634678      	105730209      	4         	0         	4              	DUP       
chr14       	105725724   	105755234   	105668289      	105741766      	7         	0         	7              	DEL       
chr14       	105725724   	105755234   	105725725      	105755234      	4         	0         	4              	DEL       
chr14       	105725724   	105755234   	105746056      	105756304      	4         	0         	4              	DEL       
chr14       	105725724   	105755234   	105740065      	105768176      	4         	0         	4              	DEL       
chr14       	105725724   	105755234   	105743665      	105771937      	6         	0         	6              	DEL       
chr14       	105740066   	105768151   	105625888      	105743031      	8         	0         	8              	DEL       
chr14       	105740066   	105768151   	105668289      	105741766      	7         	0         	7              	DEL       
chr14       	105740066   	105768151   	105725725      	105755234      	4         	0         	4              	DEL       
chr14       	105740066   	105768151   	105746056      	105756304      	4         	0         	4              	DEL       
chr14       	105740066   	105768151   	105616415      	105760980      	0         	7         	7              	DUP       
chr14       	105740066   	105768151   	105617598      	105761983      	6         	0         	6              	DEL       
chr14       	105740066   	105768151   	105619376      	105763510      	8         	0         	8              	DUP       
chr14       	105740066   	105768151   	105740065      	105768176      	4         	0         	4              	DEL       
chr14       	105740066   	105768151   	105743665      	105771937      	6         	0         	6              	DEL       
chr14       	105743666   	105771938   	105725725      	105755234      	4         	0         	4              	DEL       
chr14       	105743666   	105771938   	105746056      	105756304      	4         	0         	4              	DEL       
chr14       	105743666   	105771938   	105616415      	105760980      	0         	7         	7              	DUP       
chr14       	105743666   	105771938   	105617598      	105761983      	6         	0         	6              	DEL       
chr14       	105743666   	105771938   	105619376      	105763510      	8         	0         	8              	DUP       
chr14       	105743666   	105771938   	105740065      	105768176      	4         	0         	4              	DEL       
chr14       	105743666   	105771938   	105743665      	105771937      	6         	0         	6              	DEL       
chr14       	105773448   	105859088   	105773455      	105859088      	7         	5         	12             	DEL       
chr14       	105864631   	105886035   	105864632      	105886035      	10        	10        	20             	DEL       
chr14       	105864631   	105886035   	105864635      	106537811      	8         	3         	11             	DEL       
chr14       	105864634   	106537811   	105864632      	105886035      	10        	10        	20             	DEL       
chr14       	105864634   	106537811   	106326215      	106350980      	7         	0         	7              	DEL       
chr14       	105864634   	106537811   	106327241      	106352176      	12        	0         	12             	DUP       
chr14       	105864634   	106537811   	105864635      	106537811      	8         	3         	11             	DEL       
chr14       	106326216   	106350981   	106326215      	106350980      	7         	0         	7              	DEL       
chr14       	106326216   	106350981   	106327241      	106352176      	12        	0         	12             	DUP       
chr14       	106327240   	106352176   	106326215      	106350980      	7         	0         	7              	DEL       
chr14       	106327240   	106352176   	106327241      	106352176      	12        	0         	12             	DUP       
chr14       	106567162   	106567291   	106567167      	106567290      	0         	5         	5              	DEL       
chr14       	106595673   	106677790   	106630964      	106642875      	11        	0         	11             	DUP       
chr14       	106595673   	106677790   	106636670      	106636758      	0         	9         	9              	DEL       
chr14       	106595673   	106677790   	106630687      	106642593      	6         	0         	6              	DEL       
chr14       	106595673   	106677790   	106595673      	106677788      	5         	0         	5              	DUP       
chr14       	106630964   	106642877   	106630964      	106642875      	11        	0         	11             	DUP       
chr14       	106630964   	106642877   	106636670      	106636758      	0         	9         	9              	DEL       
chr14       	106630964   	106642877   	106630687      	106642593      	6         	0         	6              	DEL       
chr14       	106636653   	106636758   	106636670      	106636758      	0         	9         	9              	DEL       
chr14       	106706389   	106752326   	106706390      	106752326      	4         	0         	4              	DEL       
chr15       	17009494    	17481035    	17009495       	17481035       	5         	0         	5              	DUP       
chr15       	17009494    	17481035    	17028211       	17029493       	25        	0         	25             	DEL       
chr15       	17009494    	17481035    	17038843       	17040530       	4         	0         	4              	DEL       
chr15       	17009494    	17481035    	17163366       	17447248       	4         	0         	4              	DUP       
chr15       	17028210    	17029493    	17028211       	17029493       	25        	0         	25             	DEL       
chr15       	17163365    	17447248    	17163366       	17447248       	4         	0         	4              	DUP       
chr15       	18405672    	19345238    	18405673       	19345238       	5         	0         	5              	DEL       
chr15       	18405672    	19345238    	18910897       	19640537       	17        	0         	17             	DUP       
chr15       	18910790    	19640642    	18405673       	19345238       	5         	0         	5              	DEL       
chr15       	18910790    	19640642    	18910897       	19640537       	17        	0         	17             	DUP       
chr15       	19816856    	19818827    	19816872       	19818903       	15        	0         	15             	DEL       
chr15       	19830975    	19831127    	19830980       	19831127       	1         	10        	11             	DEL       
chr15       	20376209    	20384360    	20376267       	20384338       	40        	0         	40             	DEL       
chr15       	23047155    	23049791    	23047155       	23049789       	6         	0         	6              	DUP       
chr15       	23862565    	23862729    	23862566       	23862729       	0         	6         	6              	DEL       
chr15       	23961909    	23962219    	23961921       	23962219       	0         	10        	10             	DEL       
chr15       	24096520    	24421966    	24143755       	24199743       	5         	0         	5              	DEL       
chr15       	24096520    	24421966    	24233234       	24374929       	5         	0         	5              	DUP       
chr15       	24096520    	24421966    	24233477       	24375167       	7         	0         	7              	DEL       
chr15       	24096520    	24421966    	24177833       	24393319       	4         	0         	4              	DUP       
chr15       	24096520    	24421966    	24096519       	24421965       	8         	0         	8              	DEL       
chr15       	24096520    	24421966    	24096907       	24422222       	10        	0         	10             	DUP       
chr15       	24096520    	24421966    	24209685       	24516380       	8         	0         	8              	DUP       
chr15       	24096520    	24421966    	24330141       	24537564       	6         	0         	6              	DUP       
chr15       	24096520    	24421966    	24330393       	24537941       	9         	0         	9              	DEL       
chr15       	24096520    	24421966    	24398254       	24571100       	8         	0         	8              	DUP       
chr15       	24096520    	24421966    	24398492       	24571711       	7         	0         	7              	DEL       
chr15       	24096907    	24422224    	24143755       	24199743       	5         	0         	5              	DEL       
chr15       	24096907    	24422224    	24233234       	24374929       	5         	0         	5              	DUP       
chr15       	24096907    	24422224    	24233477       	24375167       	7         	0         	7              	DEL       
chr15       	24096907    	24422224    	24177833       	24393319       	4         	0         	4              	DUP       
chr15       	24096907    	24422224    	24096519       	24421965       	8         	0         	8              	DEL       
chr15       	24096907    	24422224    	24096907       	24422222       	10        	0         	10             	DUP       
chr15       	24096907    	24422224    	24209685       	24516380       	8         	0         	8              	DUP       
chr15       	24096907    	24422224    	24330141       	24537564       	6         	0         	6              	DUP       
chr15       	24096907    	24422224    	24330393       	24537941       	9         	0         	9              	DEL       
chr15       	24096907    	24422224    	24398254       	24571100       	8         	0         	8              	DUP       
chr15       	24096907    	24422224    	24398492       	24571711       	7         	0         	7              	DEL       
chr15       	24177832    	24393319    	24143755       	24199743       	5         	0         	5              	DEL       
chr15       	24177832    	24393319    	24233234       	24374929       	5         	0         	5              	DUP       
chr15       	24177832    	24393319    	24233477       	24375167       	7         	0         	7              	DEL       
chr15       	24177832    	24393319    	24177833       	24393319       	4         	0         	4              	DUP       
chr15       	24177832    	24393319    	24209685       	24516380       	8         	0         	8              	DUP       
chr15       	24177832    	24393319    	24330141       	24537564       	6         	0         	6              	DUP       
chr15       	24177832    	24393319    	24330393       	24537941       	9         	0         	9              	DEL       
chr15       	24209685    	24516382    	24233234       	24374929       	5         	0         	5              	DUP       
chr15       	24209685    	24516382    	24233477       	24375167       	7         	0         	7              	DEL       
chr15       	24209685    	24516382    	24177833       	24393319       	4         	0         	4              	DUP       
chr15       	24209685    	24516382    	24096519       	24421965       	8         	0         	8              	DEL       
chr15       	24209685    	24516382    	24096907       	24422222       	10        	0         	10             	DUP       
chr15       	24209685    	24516382    	24209685       	24516380       	8         	0         	8              	DUP       
chr15       	24209685    	24516382    	24330141       	24537564       	6         	0         	6              	DUP       
chr15       	24209685    	24516382    	24330393       	24537941       	9         	0         	9              	DEL       
chr15       	24209685    	24516382    	24398254       	24571100       	8         	0         	8              	DUP       
chr15       	24209685    	24516382    	24398492       	24571711       	7         	0         	7              	DEL       
chr15       	24233234    	24374931    	24233234       	24374929       	5         	0         	5              	DUP       
chr15       	24233234    	24374931    	24233477       	24375167       	7         	0         	7              	DEL       
chr15       	24233234    	24374931    	24330141       	24537564       	6         	0         	6              	DUP       
chr15       	24233234    	24374931    	24330393       	24537941       	9         	0         	9              	DEL       
chr15       	24233478    	24375168    	24233234       	24374929       	5         	0         	5              	DUP       
chr15       	24233478    	24375168    	24233477       	24375167       	7         	0         	7              	DEL       
chr15       	24233478    	24375168    	24330141       	24537564       	6         	0         	6              	DUP       
chr15       	24233478    	24375168    	24330393       	24537941       	9         	0         	9              	DEL       
chr15       	24330141    	24537566    	24233234       	24374929       	5         	0         	5              	DUP       
chr15       	24330141    	24537566    	24233477       	24375167       	7         	0         	7              	DEL       
chr15       	24330141    	24537566    	24177833       	24393319       	4         	0         	4              	DUP       
chr15       	24330141    	24537566    	24096519       	24421965       	8         	0         	8              	DEL       
chr15       	24330141    	24537566    	24096907       	24422222       	10        	0         	10             	DUP       
chr15       	24330141    	24537566    	24209685       	24516380       	8         	0         	8              	DUP       
chr15       	24330141    	24537566    	24330141       	24537564       	6         	0         	6              	DUP       
chr15       	24330141    	24537566    	24330393       	24537941       	9         	0         	9              	DEL       
chr15       	24330141    	24537566    	24398254       	24571100       	8         	0         	8              	DUP       
chr15       	24330141    	24537566    	24398492       	24571711       	7         	0         	7              	DEL       
chr15       	24330394    	24537942    	24233234       	24374929       	5         	0         	5              	DUP       
chr15       	24330394    	24537942    	24233477       	24375167       	7         	0         	7              	DEL       
chr15       	24330394    	24537942    	24177833       	24393319       	4         	0         	4              	DUP       
chr15       	24330394    	24537942    	24096519       	24421965       	8         	0         	8              	DEL       
chr15       	24330394    	24537942    	24096907       	24422222       	10        	0         	10             	DUP       
chr15       	24330394    	24537942    	24209685       	24516380       	8         	0         	8              	DUP       
chr15       	24330394    	24537942    	24330141       	24537564       	6         	0         	6              	DUP       
chr15       	24330394    	24537942    	24330393       	24537941       	9         	0         	9              	DEL       
chr15       	24330394    	24537942    	24398254       	24571100       	8         	0         	8              	DUP       
chr15       	24330394    	24537942    	24398492       	24571711       	7         	0         	7              	DEL       
chr15       	24398254    	24571102    	24096519       	24421965       	8         	0         	8              	DEL       
chr15       	24398254    	24571102    	24096907       	24422222       	10        	0         	10             	DUP       
chr15       	24398254    	24571102    	24209685       	24516380       	8         	0         	8              	DUP       
chr15       	24398254    	24571102    	24330141       	24537564       	6         	0         	6              	DUP       
chr15       	24398254    	24571102    	24330393       	24537941       	9         	0         	9              	DEL       
chr15       	24398254    	24571102    	24398254       	24571100       	8         	0         	8              	DUP       
chr15       	24398254    	24571102    	24398492       	24571711       	7         	0         	7              	DEL       
chr15       	24398493    	24571712    	24096519       	24421965       	8         	0         	8              	DEL       
chr15       	24398493    	24571712    	24096907       	24422222       	10        	0         	10             	DUP       
chr15       	24398493    	24571712    	24209685       	24516380       	8         	0         	8              	DUP       
chr15       	24398493    	24571712    	24330141       	24537564       	6         	0         	6              	DUP       
chr15       	24398493    	24571712    	24330393       	24537941       	9         	0         	9              	DEL       
chr15       	24398493    	24571712    	24398254       	24571100       	8         	0         	8              	DUP       
chr15       	24398493    	24571712    	24398492       	24571711       	7         	0         	7              	DEL       
chr15       	24871694    	24873565    	24871815       	24873492       	17        	0         	17             	DEL       
chr15       	25686248    	25687233    	25686249       	25687233       	12        	3         	15             	DEL       
chr15       	26776340    	26776649    	26776349       	26776649       	0         	11        	11             	DEL       
chr15       	27238094    	27238199    	27238095       	27238199       	0         	6         	6              	DEL       
chr15       	29119270    	29119693    	29119202       	29119693       	7         	0         	7              	DEL       
chr15       	30632029    	32621381    	30846576       	30846786       	5         	0         	5              	DEL       
chr15       	30632029    	32621381    	31999032       	31999325       	1         	7         	8              	DEL       
chr15       	30632029    	32621381    	32010015       	32010077       	0         	4         	4              	DEL       
chr15       	30632029    	32621381    	30632291       	32622225       	10        	0         	10             	DUP       
chr15       	30632029    	32621381    	30632257       	32621566       	9         	0         	9              	DEL       
chr15       	30632291    	32622227    	30846576       	30846786       	5         	0         	5              	DEL       
chr15       	30632291    	32622227    	31999032       	31999325       	1         	7         	8              	DEL       
chr15       	30632291    	32622227    	32010015       	32010077       	0         	4         	4              	DEL       
chr15       	30632291    	32622227    	30632291       	32622225       	10        	0         	10             	DUP       
chr15       	30632291    	32622227    	30632257       	32621566       	9         	0         	9              	DEL       
chr15       	31999016    	31999325    	31999032       	31999325       	1         	7         	8              	DEL       
chr15       	33794246    	33794441    	33794247       	33794441       	16        	0         	16             	INV       
chr15       	33908245    	33908513    	33908246       	33908513       	0         	13        	13             	DEL       
chr15       	34449546    	34449828    	34449555       	34449818       	2         	4         	6              	DEL       
chr15       	34454772    	34455099    	34454787       	34455099       	0         	5         	5              	DEL       
chr15       	34716814    	34717150    	34716832       	34717150       	3         	18        	21             	DEL       
chr15       	35867928    	35870014    	35867933       	35870014       	16        	2         	18             	DEL       
chr15       	37252531    	37252593    	37252536       	37252593       	0         	10        	10             	DEL       
chr15       	38974802    	38975158    	38974815       	38975157       	3         	18        	21             	DEL       
chr15       	39452188    	39452658    	39452190       	39452649       	11        	31        	42             	DEL       
chr15       	41559341    	41561123    	41559342       	41561130       	3         	1         	4              	DEL       
chr15       	41561306    	41561535    	41561310       	41561535       	0         	7         	7              	DEL       
chr15       	41573814    	41577885    	41573817       	41577885       	17        	1         	18             	DEL       
chr15       	41725536    	41725869    	41725550       	41725869       	0         	14        	14             	DEL       
chr15       	43368228    	43368555    	43368243       	43368555       	1         	22        	23             	DEL       
chr15       	45277838    	45277985    	45277858       	45277985       	0         	17        	17             	DEL       
chr15       	45775765    	45776116    	45775782       	45776116       	0         	13        	13             	DEL       
chr15       	47428435    	47428610    	47428437       	47428610       	0         	6         	6              	DEL       
chr15       	50629155    	50629598    	50629158       	50629598       	3         	11        	14             	DEL       
chr15       	52232985    	52233320    	52232997       	52233319       	0         	22        	22             	DEL       
chr15       	52523964    	52524853    	52523965       	52524853       	22        	8         	30             	DUP       
chr15       	53907720    	53910968    	53907721       	53910968       	23        	9         	32             	DEL       
chr15       	54926016    	54932227    	54925996       	54932235       	20        	1         	21             	DEL       
chr15       	55137693    	55138015    	55137708       	55138015       	3         	2         	5              	DEL       
chr15       	58304296    	58304618    	58304308       	58304618       	1         	18        	19             	DEL       
chr15       	58620648    	58620967    	58620666       	58620967       	1         	24        	25             	DEL       
chr15       	59420686    	59421018    	59420699       	59421018       	2         	26        	28             	DEL       
chr15       	61348379    	61348544    	61348380       	61348544       	6         	0         	6              	INV       
chr15       	62413892    	62415593    	62413896       	62415593       	16        	11        	27             	DEL       
chr15       	62655584    	62655721    	62655585       	62655721       	0         	16        	16             	DEL       
chr15       	62773064    	62773304    	62773077       	62773304       	0         	12        	12             	DEL       
chr15       	63548001    	63548261    	63548010       	63548261       	0         	8         	8              	DEL       
chr15       	64340978    	64341304    	64340994       	64341304       	2         	14        	16             	DEL       
chr15       	65326076    	65326473    	65326077       	65326473       	2         	4         	6              	DEL       
chr15       	66341473    	66341795    	66341486       	66341795       	4         	23        	27             	DEL       
chr15       	66791432    	66791731    	66791433       	66791731       	1         	13        	14             	DEL       
chr15       	67112363    	67113253    	67112364       	67113253       	21        	0         	21             	DEL       
chr15       	68133663    	68136589    	68133682       	68136589       	53        	28        	81             	DEL       
chr15       	68420998    	68421219    	68420999       	68421219       	0         	11        	11             	DEL       
chr15       	68757227    	68757557    	68757243       	68757557       	3         	8         	11             	DEL       
chr15       	69240228    	69240313    	69240229       	69240313       	0         	4         	4              	DEL       
chr15       	71416269    	71421351    	71416270       	71421351       	18        	8         	26             	DEL       
chr15       	72093623    	72095817    	72093654       	72095807       	33        	0         	33             	DEL       
chr15       	72898396    	72898531    	72898408       	72898531       	0         	6         	6              	DEL       
chr15       	74976642    	74977360    	74976643       	74977360       	5         	0         	5              	DEL       
chr15       	76592254    	76604597    	76592256       	76604597       	23        	5         	28             	DEL       
chr15       	79552556    	79552696    	79552557       	79552696       	0         	6         	6              	DEL       
chr15       	79599500    	79599822    	79599514       	79599822       	1         	11        	12             	DEL       
chr15       	79619243    	79619556    	79619260       	79619556       	2         	9         	11             	DEL       
chr15       	80912035    	80913531    	80912036       	80913531       	0         	4         	4              	DEL       
chr15       	82606520    	82606831    	82606535       	82606834       	1         	13        	14             	DEL       
chr15       	82882867    	82888918    	82882879       	82888918       	34        	14        	48             	DEL       
chr15       	83611866    	83612076    	83611870       	83612076       	0         	11        	11             	DEL       
chr15       	85853442    	85853974    	85853443       	85853974       	8         	0         	8              	DEL       
chr15       	90115596    	90115697    	90115605       	90115697       	0         	6         	6              	DEL       
chr15       	90630741    	90631075    	90630758       	90631075       	0         	16        	16             	DEL       
chr15       	91564259    	91564351    	91564261       	91564351       	0         	17        	17             	DEL       
chr15       	92972556    	92972870    	92972568       	92972870       	0         	18        	18             	DEL       
chr15       	94390048    	94390118    	94390064       	94390117       	0         	12        	12             	DEL       
chr15       	97356225    	97356361    	97356226       	97356361       	27        	15        	42             	INV       
chr15       	98055475    	98055802    	98055499       	98055802       	2         	11        	13             	DEL       
chr15       	98162859    	98163188    	98162875       	98163188       	1         	8         	9              	DEL       
chr15       	98273786    	98274196    	98273788       	98274196       	3         	5         	8              	DEL       
chr15       	98299094    	98300578    	98299095       	98300578       	20        	8         	28             	DEL       
chr15       	99031281    	99032409    	99031324       	99032379       	28        	0         	28             	DEL       
chr15       	100069769   	100072501   	100069688      	100072459      	8         	0         	8              	DEL       
chr15       	100146718   	100152953   	100146719      	100152953      	1         	3         	4              	DUP       
chr15       	100442705   	101074829   	100511551      	100512063      	6         	0         	6              	DEL       
chr15       	100442705   	101074829   	100719130      	100720430      	5         	0         	5              	DEL       
chr15       	100442705   	101074829   	100912876      	100913171      	0         	10        	10             	DEL       
chr15       	100442705   	101074829   	100442705      	101074827      	8         	0         	8              	DUP       
chr15       	100511550   	100512063   	100511551      	100512063      	6         	0         	6              	DEL       
chr15       	100719129   	100720430   	100719130      	100720430      	5         	0         	5              	DEL       
chr15       	100912861   	100913171   	100912876      	100913171      	0         	10        	10             	DEL       
chr16       	152883      	162911      	152883         	162909         	5         	0         	5              	DUP       
chr16       	186142      	187196      	186143         	187196         	12        	0         	12             	DEL       
chr16       	1190845     	1191555     	1190918        	1191553        	5         	0         	5              	DUP       
chr16       	1372872     	1374273     	1372877        	1374192        	12        	0         	12             	DEL       
chr16       	1450686     	1450925     	1450693        	1450925        	0         	8         	8              	DEL       
chr16       	5920909     	5920971     	5920910        	5920971        	0         	8         	8              	DEL       
chr16       	8016618     	8016945     	8016620        	8016931        	0         	11        	11             	DEL       
chr16       	8562513     	8564279     	8562513        	8564261        	10        	0         	10             	DUP       
chr16       	11908461    	11908787    	11908479       	11908787       	2         	3         	5              	DEL       
chr16       	13850478    	13850580    	13850479       	13850582       	1         	6         	7              	DEL       
chr16       	13981764    	13981884    	13981766       	13981884       	0         	12        	12             	DEL       
chr16       	14359377    	14359796    	14359379       	14359796       	1         	5         	6              	DEL       
chr16       	16840505    	16846557    	16840521       	16846557       	55        	25        	80             	DEL       
chr16       	17736046    	17909109    	17736046       	17909107       	7         	0         	7              	DUP       
chr16       	17736046    	17909109    	17736229       	17909517       	5         	0         	5              	DEL       
chr16       	17736230    	17909518    	17736046       	17909107       	7         	0         	7              	DUP       
chr16       	17736230    	17909518    	17736229       	17909517       	5         	0         	5              	DEL       
chr16       	18821201    	18827055    	18821222       	18827054       	54        	37        	91             	DEL       
chr16       	19219106    	19219460    	19219120       	19219459       	1         	23        	24             	DEL       
chr16       	19494993    	19495313    	19495013       	19495313       	1         	18        	19             	DEL       
chr16       	20767218    	20767539    	20767235       	20767539       	1         	20        	21             	DEL       
chr16       	22897651    	22897930    	22897652       	22897930       	1         	5         	6              	DEL       
chr16       	23036453    	23038210    	23036454       	23038210       	23        	7         	30             	DEL       
chr16       	23517213    	23517527    	23517232       	23517527       	4         	20        	24             	DEL       
chr16       	23749064    	23750942    	23749041       	23750897       	11        	0         	11             	DEL       
chr16       	23899564    	23899871    	23899566       	23899865       	1         	10        	11             	DEL       
chr16       	24479266    	24479356    	24479283       	24479344       	0         	5         	5              	DEL       
chr16       	25054948    	25125981    	25054924       	25126098       	16        	0         	16             	DEL       
chr16       	25054948    	25125981    	25055253       	25126490       	14        	0         	14             	DUP       
chr16       	25055302    	25126594    	25054924       	25126098       	16        	0         	16             	DEL       
chr16       	25055302    	25126594    	25055253       	25126490       	14        	0         	14             	DUP       
chr16       	25328787    	25331806    	25328790       	25331806       	18        	3         	21             	DEL       
chr16       	25612232    	25612540    	25612248       	25612540       	2         	13        	15             	DEL       
chr16       	25710452    	25710508    	25710454       	25710508       	0         	11        	11             	DEL       
chr16       	26372077    	26372411    	26372093       	26372411       	0         	5         	5              	DEL       
chr16       	26374049    	26374946    	26374050       	26374954       	30        	9         	39             	DUP       
chr16       	26596701    	26597044    	26596716       	26597044       	1         	10        	11             	DEL       
chr16       	26811660    	26812390    	26811661       	26812390       	5         	0         	5              	DEL       
chr16       	27038797    	27038920    	27038799       	27038922       	1         	22        	23             	DEL       
chr16       	29226785    	29227121    	29226784       	29227263       	25        	0         	25             	INV       
chr16       	29589463    	30329614    	29903081       	29903452       	0         	5         	5              	DEL       
chr16       	29589463    	30329614    	29589462       	30329613       	8         	0         	8              	DEL       
chr16       	34062077    	34062293    	34062084       	34062265       	0         	7         	7              	DEL       
chr16       	36315704    	36322173    	36315703       	36322367       	6         	0         	6              	DEL       
chr16       	36322556    	36325765    	36322603       	36325931       	6         	0         	6              	DEL       
chr16       	36343578    	36348113    	36343525       	36348137       	15        	0         	15             	DEL       
chr16       	36343089    	36351150    	36343525       	36348137       	15        	0         	15             	DEL       
chr16       	36343089    	36351150    	36343242       	36350994       	11        	0         	11             	DUP       
chr16       	36343089    	36351150    	36350723       	36714720       	8         	0         	8              	DUP       
chr16       	36343089    	36351150    	36343249       	36714725       	6         	0         	6              	DUP       
chr16       	36343089    	36351150    	36350707       	36909418       	21        	0         	21             	DUP       
chr16       	36343089    	36351150    	36348341       	37700904       	4         	0         	4              	DUP       
chr16       	36343089    	36351150    	36351072       	37700736       	5         	0         	5              	DEL       
chr16       	36343089    	36351150    	36343457       	37700732       	4         	0         	4              	DEL       
chr16       	36343089    	36351150    	36348593       	37725541       	6         	0         	6              	DEL       
chr16       	36343089    	36351150    	36348533       	37915276       	15        	0         	15             	DEL       
chr16       	36343248    	36714725    	36343525       	36348137       	15        	0         	15             	DEL       
chr16       	36343248    	36714725    	36343242       	36350994       	11        	0         	11             	DUP       
chr16       	36343248    	36714725    	36356334       	36379367       	11        	0         	11             	DUP       
chr16       	36343248    	36714725    	36350723       	36714720       	8         	0         	8              	DUP       
chr16       	36343248    	36714725    	36343249       	36714725       	6         	0         	6              	DUP       
chr16       	36343248    	36714725    	36714396       	36909381       	18        	0         	18             	DUP       
chr16       	36343248    	36714725    	36350707       	36909418       	21        	0         	21             	DUP       
chr16       	36343248    	36714725    	36379388       	37020324       	4         	0         	4              	DEL       
chr16       	36343248    	36714725    	36348341       	37700904       	4         	0         	4              	DUP       
chr16       	36343248    	36714725    	36351072       	37700736       	5         	0         	5              	DEL       
chr16       	36343248    	36714725    	36343457       	37700732       	4         	0         	4              	DEL       
chr16       	36343248    	36714725    	36348593       	37725541       	6         	0         	6              	DEL       
chr16       	36343248    	36714725    	36348533       	37915276       	15        	0         	15             	DEL       
chr16       	36343248    	36714725    	36379398       	38120427       	6         	0         	6              	DEL       
chr16       	36343456    	37700732    	36343525       	36348137       	15        	0         	15             	DEL       
chr16       	36343456    	37700732    	36343242       	36350994       	11        	0         	11             	DUP       
chr16       	36343456    	37700732    	36356334       	36379367       	11        	0         	11             	DUP       
chr16       	36343456    	37700732    	36350723       	36714720       	8         	0         	8              	DUP       
chr16       	36343456    	37700732    	36343249       	36714725       	6         	0         	6              	DUP       
chr16       	36343456    	37700732    	36714396       	36909381       	18        	0         	18             	DUP       
chr16       	36343456    	37700732    	36350707       	36909418       	21        	0         	21             	DUP       
chr16       	36343456    	37700732    	36379388       	37020324       	4         	0         	4              	DEL       
chr16       	36343456    	37700732    	36768348       	37104690       	17        	0         	17             	DUP       
chr16       	36343456    	37700732    	36348341       	37700904       	4         	0         	4              	DUP       
chr16       	36343456    	37700732    	36351072       	37700736       	5         	0         	5              	DEL       
chr16       	36343456    	37700732    	36343457       	37700732       	4         	0         	4              	DEL       
chr16       	36343456    	37700732    	36348593       	37725541       	6         	0         	6              	DEL       
chr16       	36343456    	37700732    	36907602       	37885228       	10        	0         	10             	DUP       
chr16       	36343456    	37700732    	36348533       	37915276       	15        	0         	15             	DEL       
chr16       	36343456    	37700732    	37104090       	37939306       	28        	0         	28             	DUP       
chr16       	36343456    	37700732    	36747734       	37962753       	9         	0         	9              	DUP       
chr16       	36343456    	37700732    	36379398       	38120427       	6         	0         	6              	DEL       
chr16       	36343456    	37700732    	37020511       	38120458       	5         	0         	5              	DEL       
chr16       	36342789    	38253936    	36343525       	36348137       	15        	0         	15             	DEL       
chr16       	36342789    	38253936    	36343242       	36350994       	11        	0         	11             	DUP       
chr16       	36342789    	38253936    	36356334       	36379367       	11        	0         	11             	DUP       
chr16       	36342789    	38253936    	36350723       	36714720       	8         	0         	8              	DUP       
chr16       	36342789    	38253936    	36343249       	36714725       	6         	0         	6              	DUP       
chr16       	36342789    	38253936    	36714396       	36909381       	18        	0         	18             	DUP       
chr16       	36342789    	38253936    	36350707       	36909418       	21        	0         	21             	DUP       
chr16       	36342789    	38253936    	36379388       	37020324       	4         	0         	4              	DEL       
chr16       	36342789    	38253936    	36768348       	37104690       	17        	0         	17             	DUP       
chr16       	36342789    	38253936    	36348341       	37700904       	4         	0         	4              	DUP       
chr16       	36342789    	38253936    	36351072       	37700736       	5         	0         	5              	DEL       
chr16       	36342789    	38253936    	36343457       	37700732       	4         	0         	4              	DEL       
chr16       	36342789    	38253936    	36348593       	37725541       	6         	0         	6              	DEL       
chr16       	36342789    	38253936    	36907602       	37885228       	10        	0         	10             	DUP       
chr16       	36342789    	38253936    	36348533       	37915276       	15        	0         	15             	DEL       
chr16       	36342789    	38253936    	37725581       	37915607       	15        	0         	15             	DUP       
chr16       	36342789    	38253936    	37700940       	37915268       	6         	0         	6              	DEL       
chr16       	36342789    	38253936    	37104090       	37939306       	28        	0         	28             	DUP       
chr16       	36342789    	38253936    	36747734       	37962753       	9         	0         	9              	DUP       
chr16       	36342789    	38253936    	36379398       	38120427       	6         	0         	6              	DEL       
chr16       	36342789    	38253936    	37020511       	38120458       	5         	0         	5              	DEL       
chr16       	36342789    	38253936    	37729259       	38120985       	4         	0         	4              	DUP       
chr16       	36342789    	38253936    	37938864       	38166637       	15        	0         	15             	DUP       
chr16       	36342789    	38253936    	37885018       	38172825       	4         	0         	4              	DUP       
chr16       	36342789    	38253936    	36342790       	38253936       	10        	0         	10             	DEL       
chr16       	36348340    	37700904    	36343242       	36350994       	11        	0         	11             	DUP       
chr16       	36348340    	37700904    	36356334       	36379367       	11        	0         	11             	DUP       
chr16       	36348340    	37700904    	36350723       	36714720       	8         	0         	8              	DUP       
chr16       	36348340    	37700904    	36343249       	36714725       	6         	0         	6              	DUP       
chr16       	36348340    	37700904    	36714396       	36909381       	18        	0         	18             	DUP       
chr16       	36348340    	37700904    	36350707       	36909418       	21        	0         	21             	DUP       
chr16       	36348340    	37700904    	36379388       	37020324       	4         	0         	4              	DEL       
chr16       	36348340    	37700904    	36768348       	37104690       	17        	0         	17             	DUP       
chr16       	36348340    	37700904    	36348341       	37700904       	4         	0         	4              	DUP       
chr16       	36348340    	37700904    	36351072       	37700736       	5         	0         	5              	DEL       
chr16       	36348340    	37700904    	36343457       	37700732       	4         	0         	4              	DEL       
chr16       	36348340    	37700904    	36348593       	37725541       	6         	0         	6              	DEL       
chr16       	36348340    	37700904    	36907602       	37885228       	10        	0         	10             	DUP       
chr16       	36348340    	37700904    	36348533       	37915276       	15        	0         	15             	DEL       
chr16       	36348340    	37700904    	37700940       	37915268       	6         	0         	6              	DEL       
chr16       	36348340    	37700904    	37104090       	37939306       	28        	0         	28             	DUP       
chr16       	36348340    	37700904    	36747734       	37962753       	9         	0         	9              	DUP       
chr16       	36348340    	37700904    	36379398       	38120427       	6         	0         	6              	DEL       
chr16       	36348340    	37700904    	37020511       	38120458       	5         	0         	5              	DEL       
chr16       	36348592    	37725541    	36343242       	36350994       	11        	0         	11             	DUP       
chr16       	36348592    	37725541    	36356334       	36379367       	11        	0         	11             	DUP       
chr16       	36348592    	37725541    	36350723       	36714720       	8         	0         	8              	DUP       
chr16       	36348592    	37725541    	36343249       	36714725       	6         	0         	6              	DUP       
chr16       	36348592    	37725541    	36714396       	36909381       	18        	0         	18             	DUP       
chr16       	36348592    	37725541    	36350707       	36909418       	21        	0         	21             	DUP       
chr16       	36348592    	37725541    	36379388       	37020324       	4         	0         	4              	DEL       
chr16       	36348592    	37725541    	36768348       	37104690       	17        	0         	17             	DUP       
chr16       	36348592    	37725541    	36348341       	37700904       	4         	0         	4              	DUP       
chr16       	36348592    	37725541    	36351072       	37700736       	5         	0         	5              	DEL       
chr16       	36348592    	37725541    	36343457       	37700732       	4         	0         	4              	DEL       
chr16       	36348592    	37725541    	36348593       	37725541       	6         	0         	6              	DEL       
chr16       	36348592    	37725541    	36907602       	37885228       	10        	0         	10             	DUP       
chr16       	36348592    	37725541    	36348533       	37915276       	15        	0         	15             	DEL       
chr16       	36348592    	37725541    	37725581       	37915607       	15        	0         	15             	DUP       
chr16       	36348592    	37725541    	37700940       	37915268       	6         	0         	6              	DEL       
chr16       	36348592    	37725541    	37104090       	37939306       	28        	0         	28             	DUP       
chr16       	36348592    	37725541    	36747734       	37962753       	9         	0         	9              	DUP       
chr16       	36348592    	37725541    	36379398       	38120427       	6         	0         	6              	DEL       
chr16       	36348592    	37725541    	37020511       	38120458       	5         	0         	5              	DEL       
chr16       	36348532    	37915276    	36343242       	36350994       	11        	0         	11             	DUP       
chr16       	36348532    	37915276    	36356334       	36379367       	11        	0         	11             	DUP       
chr16       	36348532    	37915276    	36350723       	36714720       	8         	0         	8              	DUP       
chr16       	36348532    	37915276    	36343249       	36714725       	6         	0         	6              	DUP       
chr16       	36348532    	37915276    	36714396       	36909381       	18        	0         	18             	DUP       
chr16       	36348532    	37915276    	36350707       	36909418       	21        	0         	21             	DUP       
chr16       	36348532    	37915276    	36379388       	37020324       	4         	0         	4              	DEL       
chr16       	36348532    	37915276    	36768348       	37104690       	17        	0         	17             	DUP       
chr16       	36348532    	37915276    	36348341       	37700904       	4         	0         	4              	DUP       
chr16       	36348532    	37915276    	36351072       	37700736       	5         	0         	5              	DEL       
chr16       	36348532    	37915276    	36343457       	37700732       	4         	0         	4              	DEL       
chr16       	36348532    	37915276    	36348593       	37725541       	6         	0         	6              	DEL       
chr16       	36348532    	37915276    	36907602       	37885228       	10        	0         	10             	DUP       
chr16       	36348532    	37915276    	36348533       	37915276       	15        	0         	15             	DEL       
chr16       	36348532    	37915276    	37725581       	37915607       	15        	0         	15             	DUP       
chr16       	36348532    	37915276    	37700940       	37915268       	6         	0         	6              	DEL       
chr16       	36348532    	37915276    	37104090       	37939306       	28        	0         	28             	DUP       
chr16       	36348532    	37915276    	36747734       	37962753       	9         	0         	9              	DUP       
chr16       	36348532    	37915276    	36379398       	38120427       	6         	0         	6              	DEL       
chr16       	36348532    	37915276    	37020511       	38120458       	5         	0         	5              	DEL       
chr16       	36348532    	37915276    	37729259       	38120985       	4         	0         	4              	DUP       
chr16       	36348532    	37915276    	37885018       	38172825       	4         	0         	4              	DUP       
chr16       	36350722    	36714720    	36343242       	36350994       	11        	0         	11             	DUP       
chr16       	36350722    	36714720    	36356334       	36379367       	11        	0         	11             	DUP       
chr16       	36350722    	36714720    	36350723       	36714720       	8         	0         	8              	DUP       
chr16       	36350722    	36714720    	36343249       	36714725       	6         	0         	6              	DUP       
chr16       	36350722    	36714720    	36714396       	36909381       	18        	0         	18             	DUP       
chr16       	36350722    	36714720    	36350707       	36909418       	21        	0         	21             	DUP       
chr16       	36350722    	36714720    	36379388       	37020324       	4         	0         	4              	DEL       
chr16       	36350722    	36714720    	36351072       	37700736       	5         	0         	5              	DEL       
chr16       	36350722    	36714720    	36379398       	38120427       	6         	0         	6              	DEL       
chr16       	36350706    	36909418    	36343242       	36350994       	11        	0         	11             	DUP       
chr16       	36350706    	36909418    	36356334       	36379367       	11        	0         	11             	DUP       
chr16       	36350706    	36909418    	36350723       	36714720       	8         	0         	8              	DUP       
chr16       	36350706    	36909418    	36343249       	36714725       	6         	0         	6              	DUP       
chr16       	36350706    	36909418    	36714396       	36909381       	18        	0         	18             	DUP       
chr16       	36350706    	36909418    	36350707       	36909418       	21        	0         	21             	DUP       
chr16       	36350706    	36909418    	36379388       	37020324       	4         	0         	4              	DEL       
chr16       	36350706    	36909418    	36768348       	37104690       	17        	0         	17             	DUP       
chr16       	36350706    	36909418    	36351072       	37700736       	5         	0         	5              	DEL       
chr16       	36350706    	36909418    	36907602       	37885228       	10        	0         	10             	DUP       
chr16       	36350706    	36909418    	36747734       	37962753       	9         	0         	9              	DUP       
chr16       	36350706    	36909418    	36379398       	38120427       	6         	0         	6              	DEL       
chr16       	36351071    	37700736    	36343242       	36350994       	11        	0         	11             	DUP       
chr16       	36351071    	37700736    	36356334       	36379367       	11        	0         	11             	DUP       
chr16       	36351071    	37700736    	36350723       	36714720       	8         	0         	8              	DUP       
chr16       	36351071    	37700736    	36343249       	36714725       	6         	0         	6              	DUP       
chr16       	36351071    	37700736    	36714396       	36909381       	18        	0         	18             	DUP       
chr16       	36351071    	37700736    	36350707       	36909418       	21        	0         	21             	DUP       
chr16       	36351071    	37700736    	36379388       	37020324       	4         	0         	4              	DEL       
chr16       	36351071    	37700736    	36768348       	37104690       	17        	0         	17             	DUP       
chr16       	36351071    	37700736    	36351072       	37700736       	5         	0         	5              	DEL       
chr16       	36351071    	37700736    	36343457       	37700732       	4         	0         	4              	DEL       
chr16       	36351071    	37700736    	36907602       	37885228       	10        	0         	10             	DUP       
chr16       	36351071    	37700736    	37104090       	37939306       	28        	0         	28             	DUP       
chr16       	36351071    	37700736    	36747734       	37962753       	9         	0         	9              	DUP       
chr16       	36351071    	37700736    	36379398       	38120427       	6         	0         	6              	DEL       
chr16       	36351071    	37700736    	37020511       	38120458       	5         	0         	5              	DEL       
chr16       	36356121    	36379466    	36356334       	36379367       	11        	0         	11             	DUP       
chr16       	36356121    	36379466    	36379388       	37020324       	4         	0         	4              	DEL       
chr16       	36356121    	36379466    	36379398       	38120427       	6         	0         	6              	DEL       
chr16       	36379387    	37020324    	36356334       	36379367       	11        	0         	11             	DUP       
chr16       	36379387    	37020324    	36350723       	36714720       	8         	0         	8              	DUP       
chr16       	36379387    	37020324    	36343249       	36714725       	6         	0         	6              	DUP       
chr16       	36379387    	37020324    	36714396       	36909381       	18        	0         	18             	DUP       
chr16       	36379387    	37020324    	36350707       	36909418       	21        	0         	21             	DUP       
chr16       	36379387    	37020324    	36379388       	37020324       	4         	0         	4              	DEL       
chr16       	36379387    	37020324    	36768348       	37104690       	17        	0         	17             	DUP       
chr16       	36379387    	37020324    	36907602       	37885228       	10        	0         	10             	DUP       
chr16       	36379387    	37020324    	36747734       	37962753       	9         	0         	9              	DUP       
chr16       	36379387    	37020324    	36379398       	38120427       	6         	0         	6              	DEL       
chr16       	36379397    	38120427    	36356334       	36379367       	11        	0         	11             	DUP       
chr16       	36379397    	38120427    	36350723       	36714720       	8         	0         	8              	DUP       
chr16       	36379397    	38120427    	36343249       	36714725       	6         	0         	6              	DUP       
chr16       	36379397    	38120427    	36714396       	36909381       	18        	0         	18             	DUP       
chr16       	36379397    	38120427    	36350707       	36909418       	21        	0         	21             	DUP       
chr16       	36379397    	38120427    	36379388       	37020324       	4         	0         	4              	DEL       
chr16       	36379397    	38120427    	36768348       	37104690       	17        	0         	17             	DUP       
chr16       	36379397    	38120427    	36348341       	37700904       	4         	0         	4              	DUP       
chr16       	36379397    	38120427    	36351072       	37700736       	5         	0         	5              	DEL       
chr16       	36379397    	38120427    	36343457       	37700732       	4         	0         	4              	DEL       
chr16       	36379397    	38120427    	36348593       	37725541       	6         	0         	6              	DEL       
chr16       	36379397    	38120427    	36907602       	37885228       	10        	0         	10             	DUP       
chr16       	36379397    	38120427    	36348533       	37915276       	15        	0         	15             	DEL       
chr16       	36379397    	38120427    	37725581       	37915607       	15        	0         	15             	DUP       
chr16       	36379397    	38120427    	37700940       	37915268       	6         	0         	6              	DEL       
chr16       	36379397    	38120427    	37104090       	37939306       	28        	0         	28             	DUP       
chr16       	36379397    	38120427    	36747734       	37962753       	9         	0         	9              	DUP       
chr16       	36379397    	38120427    	36379398       	38120427       	6         	0         	6              	DEL       
chr16       	36379397    	38120427    	37020511       	38120458       	5         	0         	5              	DEL       
chr16       	36379397    	38120427    	37729259       	38120985       	4         	0         	4              	DUP       
chr16       	36379397    	38120427    	37938864       	38166637       	15        	0         	15             	DUP       
chr16       	36379397    	38120427    	37885018       	38172825       	4         	0         	4              	DUP       
chr16       	36714395    	36909381    	36350723       	36714720       	8         	0         	8              	DUP       
chr16       	36714395    	36909381    	36343249       	36714725       	6         	0         	6              	DUP       
chr16       	36714395    	36909381    	36714396       	36909381       	18        	0         	18             	DUP       
chr16       	36714395    	36909381    	36350707       	36909418       	21        	0         	21             	DUP       
chr16       	36714395    	36909381    	36768348       	37104690       	17        	0         	17             	DUP       
chr16       	36714395    	36909381    	36907602       	37885228       	10        	0         	10             	DUP       
chr16       	36714395    	36909381    	36747734       	37962753       	9         	0         	9              	DUP       
chr16       	36747733    	37962753    	36714396       	36909381       	18        	0         	18             	DUP       
chr16       	36747733    	37962753    	36350707       	36909418       	21        	0         	21             	DUP       
chr16       	36747733    	37962753    	36379388       	37020324       	4         	0         	4              	DEL       
chr16       	36747733    	37962753    	36768348       	37104690       	17        	0         	17             	DUP       
chr16       	36747733    	37962753    	36348341       	37700904       	4         	0         	4              	DUP       
chr16       	36747733    	37962753    	36351072       	37700736       	5         	0         	5              	DEL       
chr16       	36747733    	37962753    	36343457       	37700732       	4         	0         	4              	DEL       
chr16       	36747733    	37962753    	36348593       	37725541       	6         	0         	6              	DEL       
chr16       	36747733    	37962753    	36907602       	37885228       	10        	0         	10             	DUP       
chr16       	36747733    	37962753    	36348533       	37915276       	15        	0         	15             	DEL       
chr16       	36747733    	37962753    	37725581       	37915607       	15        	0         	15             	DUP       
chr16       	36747733    	37962753    	37700940       	37915268       	6         	0         	6              	DEL       
chr16       	36747733    	37962753    	37104090       	37939306       	28        	0         	28             	DUP       
chr16       	36747733    	37962753    	36747734       	37962753       	9         	0         	9              	DUP       
chr16       	36747733    	37962753    	37020511       	38120458       	5         	0         	5              	DEL       
chr16       	36747733    	37962753    	37729259       	38120985       	4         	0         	4              	DUP       
chr16       	36747733    	37962753    	37938864       	38166637       	15        	0         	15             	DUP       
chr16       	36747733    	37962753    	37885018       	38172825       	4         	0         	4              	DUP       
chr16       	36768187    	37104739    	36714396       	36909381       	18        	0         	18             	DUP       
chr16       	36768187    	37104739    	36350707       	36909418       	21        	0         	21             	DUP       
chr16       	36768187    	37104739    	36379388       	37020324       	4         	0         	4              	DEL       
chr16       	36768187    	37104739    	36768348       	37104690       	17        	0         	17             	DUP       
chr16       	36768187    	37104739    	36907602       	37885228       	10        	0         	10             	DUP       
chr16       	36768187    	37104739    	37104090       	37939306       	28        	0         	28             	DUP       
chr16       	36768187    	37104739    	37020511       	38120458       	5         	0         	5              	DEL       
chr16       	36907601    	37885228    	36714396       	36909381       	18        	0         	18             	DUP       
chr16       	36907601    	37885228    	36350707       	36909418       	21        	0         	21             	DUP       
chr16       	36907601    	37885228    	36379388       	37020324       	4         	0         	4              	DEL       
chr16       	36907601    	37885228    	36768348       	37104690       	17        	0         	17             	DUP       
chr16       	36907601    	37885228    	36348341       	37700904       	4         	0         	4              	DUP       
chr16       	36907601    	37885228    	36351072       	37700736       	5         	0         	5              	DEL       
chr16       	36907601    	37885228    	36343457       	37700732       	4         	0         	4              	DEL       
chr16       	36907601    	37885228    	36348593       	37725541       	6         	0         	6              	DEL       
chr16       	36907601    	37885228    	36907602       	37885228       	10        	0         	10             	DUP       
chr16       	36907601    	37885228    	37725581       	37915607       	15        	0         	15             	DUP       
chr16       	36907601    	37885228    	37700940       	37915268       	6         	0         	6              	DEL       
chr16       	36907601    	37885228    	37104090       	37939306       	28        	0         	28             	DUP       
chr16       	36907601    	37885228    	37020511       	38120458       	5         	0         	5              	DEL       
chr16       	36907601    	37885228    	37729259       	38120985       	4         	0         	4              	DUP       
chr16       	36907601    	37885228    	37885018       	38172825       	4         	0         	4              	DUP       
chr16       	37020510    	38120458    	36768348       	37104690       	17        	0         	17             	DUP       
chr16       	37020510    	38120458    	36348341       	37700904       	4         	0         	4              	DUP       
chr16       	37020510    	38120458    	36351072       	37700736       	5         	0         	5              	DEL       
chr16       	37020510    	38120458    	36343457       	37700732       	4         	0         	4              	DEL       
chr16       	37020510    	38120458    	36348593       	37725541       	6         	0         	6              	DEL       
chr16       	37020510    	38120458    	36907602       	37885228       	10        	0         	10             	DUP       
chr16       	37020510    	38120458    	36348533       	37915276       	15        	0         	15             	DEL       
chr16       	37020510    	38120458    	37725581       	37915607       	15        	0         	15             	DUP       
chr16       	37020510    	38120458    	37700940       	37915268       	6         	0         	6              	DEL       
chr16       	37020510    	38120458    	37104090       	37939306       	28        	0         	28             	DUP       
chr16       	37020510    	38120458    	36747734       	37962753       	9         	0         	9              	DUP       
chr16       	37020510    	38120458    	36379398       	38120427       	6         	0         	6              	DEL       
chr16       	37020510    	38120458    	37020511       	38120458       	5         	0         	5              	DEL       
chr16       	37020510    	38120458    	37729259       	38120985       	4         	0         	4              	DUP       
chr16       	37020510    	38120458    	37938864       	38166637       	15        	0         	15             	DUP       
chr16       	37020510    	38120458    	37885018       	38172825       	4         	0         	4              	DUP       
chr16       	37104077    	37939384    	36768348       	37104690       	17        	0         	17             	DUP       
chr16       	37104077    	37939384    	36348341       	37700904       	4         	0         	4              	DUP       
chr16       	37104077    	37939384    	36351072       	37700736       	5         	0         	5              	DEL       
chr16       	37104077    	37939384    	36343457       	37700732       	4         	0         	4              	DEL       
chr16       	37104077    	37939384    	36348593       	37725541       	6         	0         	6              	DEL       
chr16       	37104077    	37939384    	36907602       	37885228       	10        	0         	10             	DUP       
chr16       	37104077    	37939384    	36348533       	37915276       	15        	0         	15             	DEL       
chr16       	37104077    	37939384    	37725581       	37915607       	15        	0         	15             	DUP       
chr16       	37104077    	37939384    	37700940       	37915268       	6         	0         	6              	DEL       
chr16       	37104077    	37939384    	37104090       	37939306       	28        	0         	28             	DUP       
chr16       	37104077    	37939384    	37729259       	38120985       	4         	0         	4              	DUP       
chr16       	37104077    	37939384    	37938864       	38166637       	15        	0         	15             	DUP       
chr16       	37104077    	37939384    	37885018       	38172825       	4         	0         	4              	DUP       
chr16       	37700939    	37915268    	36348341       	37700904       	4         	0         	4              	DUP       
chr16       	37700939    	37915268    	36348593       	37725541       	6         	0         	6              	DEL       
chr16       	37700939    	37915268    	36907602       	37885228       	10        	0         	10             	DUP       
chr16       	37700939    	37915268    	36348533       	37915276       	15        	0         	15             	DEL       
chr16       	37700939    	37915268    	37725581       	37915607       	15        	0         	15             	DUP       
chr16       	37700939    	37915268    	37700940       	37915268       	6         	0         	6              	DEL       
chr16       	37700939    	37915268    	37729259       	38120985       	4         	0         	4              	DUP       
chr16       	37700939    	37915268    	37885018       	38172825       	4         	0         	4              	DUP       
chr16       	37725580    	37915607    	36348593       	37725541       	6         	0         	6              	DEL       
chr16       	37725580    	37915607    	36907602       	37885228       	10        	0         	10             	DUP       
chr16       	37725580    	37915607    	36348533       	37915276       	15        	0         	15             	DEL       
chr16       	37725580    	37915607    	37725581       	37915607       	15        	0         	15             	DUP       
chr16       	37725580    	37915607    	37700940       	37915268       	6         	0         	6              	DEL       
chr16       	37725580    	37915607    	37729259       	38120985       	4         	0         	4              	DUP       
chr16       	37725580    	37915607    	37885018       	38172825       	4         	0         	4              	DUP       
chr16       	37729258    	38120985    	36907602       	37885228       	10        	0         	10             	DUP       
chr16       	37729258    	38120985    	36348533       	37915276       	15        	0         	15             	DEL       
chr16       	37729258    	38120985    	37725581       	37915607       	15        	0         	15             	DUP       
chr16       	37729258    	38120985    	37700940       	37915268       	6         	0         	6              	DEL       
chr16       	37729258    	38120985    	37104090       	37939306       	28        	0         	28             	DUP       
chr16       	37729258    	38120985    	36747734       	37962753       	9         	0         	9              	DUP       
chr16       	37729258    	38120985    	36379398       	38120427       	6         	0         	6              	DEL       
chr16       	37729258    	38120985    	37020511       	38120458       	5         	0         	5              	DEL       
chr16       	37729258    	38120985    	37729259       	38120985       	4         	0         	4              	DUP       
chr16       	37729258    	38120985    	37938864       	38166637       	15        	0         	15             	DUP       
chr16       	37729258    	38120985    	37885018       	38172825       	4         	0         	4              	DUP       
chr16       	37885017    	38172825    	36907602       	37885228       	10        	0         	10             	DUP       
chr16       	37885017    	38172825    	36348533       	37915276       	15        	0         	15             	DEL       
chr16       	37885017    	38172825    	37725581       	37915607       	15        	0         	15             	DUP       
chr16       	37885017    	38172825    	37700940       	37915268       	6         	0         	6              	DEL       
chr16       	37885017    	38172825    	37104090       	37939306       	28        	0         	28             	DUP       
chr16       	37885017    	38172825    	36747734       	37962753       	9         	0         	9              	DUP       
chr16       	37885017    	38172825    	36379398       	38120427       	6         	0         	6              	DEL       
chr16       	37885017    	38172825    	37020511       	38120458       	5         	0         	5              	DEL       
chr16       	37885017    	38172825    	37729259       	38120985       	4         	0         	4              	DUP       
chr16       	37885017    	38172825    	37938864       	38166637       	15        	0         	15             	DUP       
chr16       	37885017    	38172825    	37885018       	38172825       	4         	0         	4              	DUP       
chr16       	37938863    	38166637    	37104090       	37939306       	28        	0         	28             	DUP       
chr16       	37938863    	38166637    	36747734       	37962753       	9         	0         	9              	DUP       
chr16       	37938863    	38166637    	36379398       	38120427       	6         	0         	6              	DEL       
chr16       	37938863    	38166637    	37020511       	38120458       	5         	0         	5              	DEL       
chr16       	37938863    	38166637    	37729259       	38120985       	4         	0         	4              	DUP       
chr16       	37938863    	38166637    	37938864       	38166637       	15        	0         	15             	DUP       
chr16       	48247010    	48247472    	48247011       	48247464       	1         	15        	16             	DUP       
chr16       	48474961    	48477593    	48475040       	48477581       	16        	0         	16             	DEL       
chr16       	48616972    	48617439    	48616903       	48617443       	8         	4         	12             	INV       
chr16       	48782955    	48783274    	48782970       	48783274       	0         	5         	5              	DEL       
chr16       	49002160    	49002296    	49002177       	49002296       	0         	19        	19             	DEL       
chr16       	49945484    	49945799    	49945499       	49945799       	2         	28        	30             	DEL       
chr16       	52378458    	52380931    	52378447       	52381040       	13        	0         	13             	DEL       
chr16       	55733640    	55777031    	55733641       	55777031       	4         	0         	4              	DUP       
chr16       	56583112    	56583447    	56583116       	56583447       	0         	8         	8              	DEL       
chr16       	58785653    	58785729    	58785655       	58785729       	0         	8         	8              	DEL       
chr16       	58799044    	58799104    	58799045       	58799104       	0         	5         	5              	DEL       
chr16       	59054473    	59054529    	59054474       	59054529       	1         	3         	4              	DEL       
chr16       	59998177    	59998492    	59998189       	59998492       	1         	5         	6              	DEL       
chr16       	62012956    	62013290    	62012972       	62013290       	3         	24        	27             	DEL       
chr16       	63722401    	63722484    	63722405       	63722484       	0         	15        	15             	DEL       
chr16       	66789289    	66789625    	66789302       	66789624       	1         	8         	9              	DEL       
chr16       	68578522    	68578606    	68578523       	68578606       	0         	5         	5              	DEL       
chr16       	70519105    	70519426    	70519121       	70519426       	2         	10        	12             	DEL       
chr16       	72054613    	72063015    	72054613       	72063013       	6         	0         	6              	DUP       
chr16       	72054613    	72063015    	72054842       	72063451       	8         	0         	8              	DEL       
chr16       	72054843    	72063452    	72054613       	72063013       	6         	0         	6              	DUP       
chr16       	72054843    	72063452    	72054842       	72063451       	8         	0         	8              	DEL       
chr16       	72719392    	72719698    	72719399       	72719698       	1         	21        	22             	DEL       
chr16       	74775879    	74775942    	74775883       	74775942       	0         	8         	8              	DEL       
chr16       	75395988    	75396731    	75395989       	75396731       	31        	0         	31             	DEL       
chr16       	76261013    	76261134    	76261014       	76261134       	1         	10        	11             	DEL       
chr16       	76505235    	76510128    	76505236       	76510128       	28        	19        	47             	DEL       
chr16       	76514662    	76514763    	76514664       	76514763       	0         	9         	9              	DEL       
chr16       	78337740    	78351001    	78337741       	78351001       	22        	7         	29             	DEL       
chr16       	78360619    	78360709    	78360620       	78360709       	0         	4         	4              	DEL       
chr16       	80763171    	80763366    	80763172       	80763366       	22        	0         	22             	INV       
chr16       	81085858    	81086213    	81085824       	81086515       	4         	0         	4              	DEL       
chr16       	81140213    	81140785    	81140214       	81140785       	7         	0         	7              	DEL       
chr16       	81577102    	81578069    	81577120       	81578067       	5         	0         	5              	DUP       
chr16       	81585660    	81585755    	81585661       	81585755       	0         	4         	4              	DEL       
chr16       	81765053    	81765596    	81765053       	81765621       	18        	21        	39             	DUP       
chr16       	82275691    	82276546    	82275692       	82276546       	5         	0         	5              	DEL       
chr16       	85155130    	85156197    	85155107       	85156195       	38        	9         	47             	INV       
chr16       	86250701    	86251010    	86250715       	86251010       	1         	20        	21             	DEL       
chr16       	87502266    	87502778    	87502284       	87502777       	4         	1         	5              	DUP       
chr16       	87948192    	87948247    	87948195       	87948247       	0         	5         	5              	DEL       
chr16       	88053077    	88053882    	88053077       	88053880       	5         	0         	5              	DUP       
chr16       	88534245    	88534321    	88534253       	88534321       	0         	7         	7              	DEL       
chr16       	88796223    	88797193    	88796223       	88797199       	10        	0         	10             	DEL       
chr16       	89907341    	89908738    	89907341       	89908551       	4         	1         	5              	DUP       
chr16       	89907341    	89908738    	89907827       	89908651       	10        	0         	10             	DEL       
chr16       	89907826    	89908651    	89907341       	89908551       	4         	1         	5              	DUP       
chr16       	89907826    	89908651    	89907827       	89908651       	10        	0         	10             	DEL       
chr17       	170815      	171998      	170868         	171880         	30        	0         	30             	DEL       
chr17       	287016      	288864      	287015         	288874         	14        	0         	14             	DEL       
chr17       	300066      	300924      	300067         	300924         	5         	0         	5              	DEL       
chr17       	343975      	347266      	343976         	347266         	48        	5         	53             	DEL       
chr17       	898385      	898988      	898385         	899023         	21        	0         	21             	DEL       
chr17       	914146      	915532      	914177         	915532         	27        	9         	36             	DEL       
chr17       	991170      	992558      	991202         	992562         	14        	0         	14             	DEL       
chr17       	1052427     	1053389     	1052428        	1053389        	4         	0         	4              	DEL       
chr17       	1118518     	1119409     	1118519        	1119409        	6         	0         	6              	DEL       
chr17       	1242986     	1244245     	1243007        	1244051        	13        	0         	13             	DEL       
chr17       	1413993     	1414125     	1414018        	1414125        	0         	5         	5              	DEL       
chr17       	1751374     	1752106     	1751374        	1752106        	27        	0         	27             	DEL       
chr17       	2291625     	2291761     	2291653        	2291761        	1         	8         	9              	DEL       
chr17       	5206162     	5206358     	5206164        	5206358        	2         	3         	5              	DEL       
chr17       	5982291     	5983409     	5982427        	5983575        	14        	0         	14             	INV       
chr17       	6030285     	6030603     	6030297        	6030603        	4         	33        	37             	DEL       
chr17       	7361246     	7362661     	7361234        	7362643        	13        	0         	13             	DEL       
chr17       	10300102    	10300454    	10300117       	10300454       	1         	16        	17             	DEL       
chr17       	11508349    	11508997    	11508350       	11508997       	15        	3         	18             	DEL       
chr17       	12293261    	12293579    	12293277       	12293579       	4         	20        	24             	DEL       
chr17       	12442331    	12443889    	12442345       	12443889       	16        	6         	22             	DEL       
chr17       	12449815    	12455937    	12449829       	12455937       	21        	9         	30             	DEL       
chr17       	13317159    	13317487    	13317181       	13317487       	5         	21        	26             	DEL       
chr17       	14286592    	14288238    	14286594       	14288238       	36        	19        	55             	DEL       
chr17       	15819786    	20637938    	17327067       	17327919       	21        	8         	29             	DEL       
chr17       	15819786    	20637938    	18887840       	18888850       	49        	14        	63             	DEL       
chr17       	15819786    	20637938    	19640120       	19640412       	2         	11        	13             	DEL       
chr17       	15819786    	20637938    	16858560       	20568921       	5         	0         	5              	DUP       
chr17       	15819786    	20637938    	15805017       	20607737       	4         	1         	5              	DUP       
chr17       	15819786    	20637938    	15819970       	20637984       	23        	0         	23             	DUP       
chr17       	15819786    	20637938    	15820309       	20638153       	10        	0         	10             	DEL       
chr17       	15820432    	20638182    	17327067       	17327919       	21        	8         	29             	DEL       
chr17       	15820432    	20638182    	18887840       	18888850       	49        	14        	63             	DEL       
chr17       	15820432    	20638182    	19640120       	19640412       	2         	11        	13             	DEL       
chr17       	15820432    	20638182    	16858560       	20568921       	5         	0         	5              	DUP       
chr17       	15820432    	20638182    	15805017       	20607737       	4         	1         	5              	DUP       
chr17       	15820432    	20638182    	15819970       	20637984       	23        	0         	23             	DUP       
chr17       	15820432    	20638182    	15820309       	20638153       	10        	0         	10             	DEL       
chr17       	16858560    	20568923    	17327067       	17327919       	21        	8         	29             	DEL       
chr17       	16858560    	20568923    	18887840       	18888850       	49        	14        	63             	DEL       
chr17       	16858560    	20568923    	19640120       	19640412       	2         	11        	13             	DEL       
chr17       	16858560    	20568923    	16858560       	20568921       	5         	0         	5              	DUP       
chr17       	17327059    	17327936    	17327067       	17327919       	21        	8         	29             	DEL       
chr17       	18887824    	18888850    	18887840       	18888850       	49        	14        	63             	DEL       
chr17       	19640103    	19640413    	19640120       	19640412       	2         	11        	13             	DEL       
chr17       	20759273    	20759747    	20759261       	20759845       	7         	0         	7              	DEL       
chr17       	21309344    	21317879    	21309343       	21317885       	5         	0         	5              	DEL       
chr17       	21400252    	21687632    	21512965       	21513025       	0         	7         	7              	DEL       
chr17       	21400252    	21687632    	21400252       	21687630       	10        	0         	10             	DUP       
chr17       	21400252    	21687632    	21401083       	21688574       	5         	0         	5              	DEL       
chr17       	21400252    	21687632    	21419698       	21705519       	10        	0         	10             	DUP       
chr17       	21419698    	21705521    	21512965       	21513025       	0         	7         	7              	DEL       
chr17       	21419698    	21705521    	21400252       	21687630       	10        	0         	10             	DUP       
chr17       	21419698    	21705521    	21401083       	21688574       	5         	0         	5              	DEL       
chr17       	21419698    	21705521    	21419698       	21705519       	10        	0         	10             	DUP       
chr17       	21512962    	21513025    	21512965       	21513025       	0         	7         	7              	DEL       
chr17       	21770095    	21778358    	21770097       	21778358       	0         	13        	13             	DEL       
chr17       	21949683    	26857526    	22139256       	22143674       	27        	6         	33             	DEL       
chr17       	21949683    	26857526    	23195681       	24327666       	0         	11        	11             	DUP       
chr17       	21949683    	26857526    	23343660       	24697263       	0         	5         	5              	DUP       
chr17       	21949683    	26857526    	24945947       	24946643       	4         	0         	4              	DUP       
chr17       	21949683    	26857526    	24030233       	26128761       	0         	20        	20             	DUP       
chr17       	21949683    	26857526    	26335606       	26335964       	0         	10        	10             	DUP       
chr17       	21949683    	26857526    	26658282       	26659220       	4         	0         	4              	DEL       
chr17       	21949683    	26857526    	26701523       	26702092       	4         	0         	4              	DUP       
chr17       	21949683    	26857526    	26735062       	26735812       	5         	0         	5              	DEL       
chr17       	21949683    	26857526    	26843012       	26846553       	48        	0         	48             	DEL       
chr17       	21949683    	26857526    	21949684       	26857526       	7         	0         	7              	DUP       
chr17       	21949683    	26857526    	26762955       	26959856       	4         	0         	4              	DEL       
chr17       	22139254    	22143675    	22139256       	22143674       	27        	6         	33             	DEL       
chr17       	23195680    	24327666    	23195681       	24327666       	0         	11        	11             	DUP       
chr17       	23195680    	24327666    	23343660       	24697263       	0         	5         	5              	DUP       
chr17       	23195680    	24327666    	24030233       	26128761       	0         	20        	20             	DUP       
chr17       	23343659    	24697263    	23195681       	24327666       	0         	11        	11             	DUP       
chr17       	23343659    	24697263    	23343660       	24697263       	0         	5         	5              	DUP       
chr17       	23343659    	24697263    	24030233       	26128761       	0         	20        	20             	DUP       
chr17       	24030232    	26128761    	23195681       	24327666       	0         	11        	11             	DUP       
chr17       	24030232    	26128761    	23343660       	24697263       	0         	5         	5              	DUP       
chr17       	24030232    	26128761    	24945947       	24946643       	4         	0         	4              	DUP       
chr17       	24030232    	26128761    	24030233       	26128761       	0         	20        	20             	DUP       
chr17       	26335605    	26335944    	26335606       	26335964       	0         	10        	10             	DUP       
chr17       	26701522    	26702092    	26701523       	26702092       	4         	0         	4              	DUP       
chr17       	26735061    	26735812    	26735062       	26735812       	5         	0         	5              	DEL       
chr17       	26843011    	26846553    	26843012       	26846553       	48        	0         	48             	DEL       
chr17       	28453366    	28456473    	28453369       	28456473       	24        	10        	34             	DEL       
chr17       	29882526    	29882607    	29882530       	29882607       	0         	4         	4              	DEL       
chr17       	30665884    	30666613    	30665885       	30666613       	5         	0         	5              	DEL       
chr17       	31332572    	31332923    	31332573       	31332923       	2         	15        	17             	DEL       
chr17       	31779604    	31780524    	31779605       	31780524       	14        	8         	22             	DEL       
chr17       	33150685    	33150867    	33150699       	33150867       	0         	4         	4              	DEL       
chr17       	33357012    	33357076    	33357013       	33357076       	15        	0         	15             	INV       
chr17       	36893224    	36893667    	36893225       	36893667       	1         	6         	7              	DEL       
chr17       	39291893    	39292501    	39291897       	39292501       	5         	8         	13             	DEL       
chr17       	40221669    	40222147    	40221414       	40222155       	5         	0         	5              	DEL       
chr17       	41047015    	41055251    	41047014       	41055250       	7         	0         	7              	DEL       
chr17       	41226584    	41255105    	41226584       	41255103       	6         	0         	6              	DUP       
chr17       	41265472    	41275881    	41265471       	41275880       	10        	0         	10             	DEL       
chr17       	42942416    	42942741    	42942435       	42942741       	0         	4         	4              	DEL       
chr17       	43439676    	43441040    	43439658       	43440872       	18        	0         	18             	DEL       
chr17       	45180465    	45181177    	45180466       	45181177       	11        	0         	11             	DEL       
chr17       	45578418    	46289344    	46205431       	46208994       	13        	0         	13             	DUP       
chr17       	45578418    	46289344    	46277789       	46282207       	15        	0         	15             	DEL       
chr17       	45578418    	46289344    	45578419       	46289347       	16        	0         	16             	DUP       
chr17       	45578418    	46289344    	46135407       	46292142       	7         	0         	7              	DUP       
chr17       	45578418    	46289344    	45584973       	64919432       	9         	0         	9              	DEL       
chr17       	45584974    	64919433    	46205431       	46208994       	13        	0         	13             	DUP       
chr17       	45584974    	64919433    	46277789       	46282207       	15        	0         	15             	DEL       
chr17       	45584974    	64919433    	45578419       	46289347       	16        	0         	16             	DUP       
chr17       	45584974    	64919433    	46135407       	46292142       	7         	0         	7              	DUP       
chr17       	45584974    	64919433    	48099182       	48100097       	2         	2         	4              	DEL       
chr17       	45584974    	64919433    	48538269       	48539858       	6         	11        	17             	DUP       
chr17       	45584974    	64919433    	48538441       	48539858       	12        	6         	18             	DEL       
chr17       	45584974    	64919433    	48686721       	48687251       	0         	10        	10             	DEL       
chr17       	45584974    	64919433    	48959789       	48960386       	4         	0         	4              	DEL       
chr17       	45584974    	64919433    	49151091       	49151407       	0         	25        	25             	DEL       
chr17       	45584974    	64919433    	50024509       	50024712       	0         	6         	6              	DEL       
chr17       	45584974    	64919433    	54706507       	54707177       	17        	8         	25             	DEL       
chr17       	45584974    	64919433    	57012371       	57015487       	10        	0         	10             	DEL       
chr17       	45584974    	64919433    	57610450       	57612553       	20        	5         	25             	DEL       
chr17       	45584974    	64919433    	58031365       	58031883       	0         	4         	4              	DEL       
chr17       	45584974    	64919433    	58836414       	58836502       	3         	1         	4              	DEL       
chr17       	45584974    	64919433    	59792855       	59793823       	29        	7         	36             	DEL       
chr17       	45584974    	64919433    	62857000       	62857124       	0         	11        	11             	DEL       
chr17       	45584974    	64919433    	63863731       	63887362       	9         	0         	9              	DEL       
chr17       	45584974    	64919433    	64135848       	64136777       	41        	0         	41             	DEL       
chr17       	45584974    	64919433    	45584973       	64919432       	9         	0         	9              	DEL       
chr17       	46135418    	46292144    	46205431       	46208994       	13        	0         	13             	DUP       
chr17       	46135418    	46292144    	46277789       	46282207       	15        	0         	15             	DEL       
chr17       	46135418    	46292144    	45578419       	46289347       	16        	0         	16             	DUP       
chr17       	46135418    	46292144    	46135407       	46292142       	7         	0         	7              	DUP       
chr17       	46205462    	46208952    	46205431       	46208994       	13        	0         	13             	DUP       
chr17       	46277762    	46282220    	46277789       	46282207       	15        	0         	15             	DEL       
chr17       	48538268    	48539855    	48538269       	48539858       	6         	11        	17             	DUP       
chr17       	48538268    	48539855    	48538441       	48539858       	12        	6         	18             	DEL       
chr17       	48959788    	48960386    	48959789       	48960386       	4         	0         	4              	DEL       
chr17       	49151076    	49151407    	49151091       	49151407       	0         	25        	25             	DEL       
chr17       	54706502    	54707177    	54706507       	54707177       	17        	8         	25             	DEL       
chr17       	57012351    	57015452    	57012371       	57015487       	10        	0         	10             	DEL       
chr17       	57610447    	57612553    	57610450       	57612553       	20        	5         	25             	DEL       
chr17       	59792853    	59793823    	59792855       	59793823       	29        	7         	36             	DEL       
chr17       	62856999    	62857124    	62857000       	62857124       	0         	11        	11             	DEL       
chr17       	63863732    	63887363    	63863731       	63887362       	9         	0         	9              	DEL       
chr17       	64135818    	64136791    	64135848       	64136777       	41        	0         	41             	DEL       
chr17       	65499950    	65500297    	65499951       	65500297       	3         	1         	4              	DUP       
chr17       	67524737    	67525068    	67524749       	67525068       	1         	17        	18             	DEL       
chr17       	67731237    	67731514    	67731255       	67731514       	0         	15        	15             	DEL       
chr17       	67858187    	68215307    	67858217       	68215258       	14        	0         	14             	DUP       
chr17       	67858187    	68215307    	67858813       	68215893       	11        	0         	11             	DEL       
chr17       	67858943    	68215862    	67858217       	68215258       	14        	0         	14             	DUP       
chr17       	67858943    	68215862    	67858813       	68215893       	11        	0         	11             	DEL       
chr17       	68231414    	68231636    	68231415       	68231636       	1         	9         	10             	DEL       
chr17       	68964784    	68965118    	68964800       	68965118       	1         	10        	11             	DEL       
chr17       	70458944    	70465036    	70458956       	70465035       	30        	13        	43             	DEL       
chr17       	71855997    	71856325    	71856013       	71856325       	0         	18        	18             	DEL       
chr17       	72738178    	72740152    	72738116       	72740241       	15        	0         	15             	DUP       
chr17       	74396975    	74397110    	74396983       	74397110       	0         	10        	10             	DEL       
chr17       	74642956    	74643095    	74642957       	74643095       	0         	5         	5              	DEL       
chr17       	74732719    	74733524    	74732719       	74733522       	11        	0         	11             	DUP       
chr17       	76991437    	76991757    	76991448       	76991757       	2         	20        	22             	DEL       
chr17       	77239865    	77240209    	77239882       	77240208       	2         	7         	9              	DEL       
chr17       	77832310    	77832496    	77832314       	77832496       	0         	5         	5              	DEL       
chr17       	77992200    	77992516    	77992217       	77992516       	0         	14        	14             	DEL       
chr17       	78286154    	78287349    	78286197       	78287332       	19        	0         	19             	DEL       
chr17       	79129365    	79129521    	79129370       	79129521       	0         	9         	9              	DEL       
chr17       	79555129    	79556087    	79555355       	79555843       	4         	0         	4              	DUP       
chr17       	80021756    	80024974    	80024303       	80024653       	4         	6         	10             	DUP       
chr17       	80021756    	80024974    	80021763       	80024972       	7         	0         	7              	DUP       
chr17       	80021756    	80024974    	80021922       	80025030       	6         	1         	7              	DEL       
chr17       	80021913    	80025054    	80024303       	80024653       	4         	6         	10             	DUP       
chr17       	80021913    	80025054    	80021763       	80024972       	7         	0         	7              	DUP       
chr17       	80021913    	80025054    	80021922       	80025030       	6         	1         	7              	DEL       
chr17       	80024312    	80024640    	80024303       	80024653       	4         	6         	10             	DUP       
chr17       	80488000    	80489985    	80487947       	80489984       	5         	0         	5              	DEL       
chr17       	80601544    	80602472    	80601563       	80602472       	32        	7         	39             	DEL       
chr17       	80691262    	80691331    	80691269       	80691331       	0         	23        	23             	DEL       
chr17       	80744576    	80744847    	80743911       	80744823       	31        	0         	31             	DEL       
chr17       	81503457    	81504445    	81503453       	81504386       	19        	0         	19             	DEL       
chr17       	81610653    	81610977    	81610670       	81610977       	2         	7         	9              	DEL       
chr17       	81643324    	81643640    	81643329       	81643628       	1         	4         	5              	DEL       
chr17       	81742542    	81792543    	81742541       	81792550       	12        	0         	12             	DEL       
chr17       	82148367    	82149108    	82148367       	82149089       	20        	0         	20             	DEL       
chr17       	82598064    	82598152    	82598066       	82598152       	0         	11        	11             	DEL       
chr17       	82716512    	82716593    	82716515       	82716593       	0         	6         	6              	DEL       
chr17       	83102016    	83103107    	83102019       	83103107       	20        	6         	26             	DEL       
chr18       	2472723     	2472838     	2472725        	2472838        	0         	28        	28             	DEL       
chr18       	2614470     	2614658     	2614471        	2614629        	4         	15        	19             	DEL       
chr18       	4535386     	4536734     	4535387        	4536734        	11        	12        	23             	DEL       
chr18       	5306843     	5307331     	5306857        	5307307        	20        	15        	35             	DEL       
chr18       	5308181     	5308272     	5308185        	5308272        	0         	5         	5              	DEL       
chr18       	5324643     	5326243     	5324646        	5326243        	21        	11        	32             	DEL       
chr18       	5457105     	5457206     	5457110        	5457206        	0         	8         	8              	DEL       
chr18       	8634165     	8634281     	8634167        	8634281        	0         	5         	5              	DEL       
chr18       	9036084     	9036374     	9036100        	9036374        	0         	9         	9              	DEL       
chr18       	9225119     	9225455     	9225122        	9225455        	2         	4         	6              	DEL       
chr18       	9385392     	9385717     	9385406        	9385717        	1         	10        	11             	DEL       
chr18       	9626590     	9626663     	9626585        	9626663        	0         	7         	7              	DEL       
chr18       	10222280    	10223607    	10222283       	10223607       	25        	1         	26             	DEL       
chr18       	10462406    	10462654    	10462425       	10462644       	1         	8         	9              	DEL       
chr18       	11509705    	11511475    	11509709       	11511475       	26        	7         	33             	DEL       
chr18       	12851182    	12851512    	12851197       	12851512       	0         	14        	14             	DEL       
chr18       	14450641    	14460493    	14450546       	14460493       	8         	0         	8              	DEL       
chr18       	14549337    	14550488    	14549310       	14550488       	8         	0         	8              	DEL       
chr18       	15407009    	15410649    	15405015       	15408168       	6         	0         	6              	DUP       
chr18       	15407009    	15410649    	15408715       	15409206       	12        	0         	12             	DEL       
chr18       	15407009    	15410649    	15407009       	15410647       	26        	0         	26             	DUP       
chr18       	15408714    	15409206    	15408715       	15409206       	12        	0         	12             	DEL       
chr18       	15465180    	15561004    	15537679       	15596979       	8         	0         	8              	DUP       
chr18       	15465180    	15561004    	15473008       	15548412       	6         	0         	6              	DEL       
chr18       	15465180    	15561004    	15472795       	15564766       	6         	0         	6              	DUP       
chr18       	15465180    	15561004    	15465181       	15561004       	5         	0         	5              	DEL       
chr18       	15465180    	15561004    	15504457       	15564516       	15        	0         	15             	DEL       
chr18       	15465180    	15561004    	15512476       	15572427       	6         	0         	6              	DEL       
chr18       	15465180    	15561004    	15472444       	15573312       	4         	0         	4              	DEL       
chr18       	15465180    	15561004    	15504205       	15604804       	6         	0         	6              	DUP       
chr18       	15465180    	15561004    	15470460       	15686656       	5         	0         	5              	DUP       
chr18       	15465180    	15561004    	15548437       	15699735       	9         	0         	9              	DUP       
chr18       	15465180    	15561004    	15512165       	15755069       	4         	0         	4              	DUP       
chr18       	15465180    	15561004    	15466245       	15758827       	8         	0         	8              	DEL       
chr18       	15465180    	15561004    	15470722       	15772083       	4         	0         	4              	DEL       
chr18       	15466244    	15758827    	15537679       	15596979       	8         	0         	8              	DUP       
chr18       	15466244    	15758827    	15473008       	15548412       	6         	0         	6              	DEL       
chr18       	15466244    	15758827    	15472795       	15564766       	6         	0         	6              	DUP       
chr18       	15466244    	15758827    	15465181       	15561004       	5         	0         	5              	DEL       
chr18       	15466244    	15758827    	15504457       	15564516       	15        	0         	15             	DEL       
chr18       	15466244    	15758827    	15512476       	15572427       	6         	0         	6              	DEL       
chr18       	15466244    	15758827    	15472444       	15573312       	4         	0         	4              	DEL       
chr18       	15466244    	15758827    	15504205       	15604804       	6         	0         	6              	DUP       
chr18       	15466244    	15758827    	15624590       	15679284       	4         	0         	4              	DEL       
chr18       	15466244    	15758827    	15656784       	15684608       	6         	0         	6              	DEL       
chr18       	15466244    	15758827    	15470460       	15686656       	5         	0         	5              	DUP       
chr18       	15466244    	15758827    	15577562       	15694692       	4         	0         	4              	DUP       
chr18       	15466244    	15758827    	15548437       	15699735       	9         	0         	9              	DUP       
chr18       	15466244    	15758827    	15564793       	15699539       	4         	0         	4              	DEL       
chr18       	15466244    	15758827    	15654121       	15752599       	5         	0         	5              	DEL       
chr18       	15466244    	15758827    	15512165       	15755069       	4         	0         	4              	DUP       
chr18       	15466244    	15758827    	15730140       	15755134       	12        	0         	12             	DUP       
chr18       	15466244    	15758827    	15466245       	15758827       	8         	0         	8              	DEL       
chr18       	15466244    	15758827    	15596703       	15759253       	5         	0         	5              	DUP       
chr18       	15466244    	15758827    	15679491       	15764432       	4         	0         	4              	DEL       
chr18       	15466244    	15758827    	15573580       	15770517       	6         	0         	6              	DEL       
chr18       	15466244    	15758827    	15470722       	15772083       	4         	0         	4              	DEL       
chr18       	15466244    	15758827    	15577931       	15776463       	11        	0         	11             	DEL       
chr18       	15466244    	15758827    	15745670       	20631091       	5         	0         	5              	DEL       
chr18       	15466244    	15758827    	15754786       	20640668       	26        	0         	26             	DUP       
chr18       	15470459    	15686656    	15537679       	15596979       	8         	0         	8              	DUP       
chr18       	15470459    	15686656    	15473008       	15548412       	6         	0         	6              	DEL       
chr18       	15470459    	15686656    	15472795       	15564766       	6         	0         	6              	DUP       
chr18       	15470459    	15686656    	15465181       	15561004       	5         	0         	5              	DEL       
chr18       	15470459    	15686656    	15504457       	15564516       	15        	0         	15             	DEL       
chr18       	15470459    	15686656    	15512476       	15572427       	6         	0         	6              	DEL       
chr18       	15470459    	15686656    	15472444       	15573312       	4         	0         	4              	DEL       
chr18       	15470459    	15686656    	15504205       	15604804       	6         	0         	6              	DUP       
chr18       	15470459    	15686656    	15624590       	15679284       	4         	0         	4              	DEL       
chr18       	15470459    	15686656    	15656784       	15684608       	6         	0         	6              	DEL       
chr18       	15470459    	15686656    	15470460       	15686656       	5         	0         	5              	DUP       
chr18       	15470459    	15686656    	15577562       	15694692       	4         	0         	4              	DUP       
chr18       	15470459    	15686656    	15548437       	15699735       	9         	0         	9              	DUP       
chr18       	15470459    	15686656    	15564793       	15699539       	4         	0         	4              	DEL       
chr18       	15470459    	15686656    	15654121       	15752599       	5         	0         	5              	DEL       
chr18       	15470459    	15686656    	15512165       	15755069       	4         	0         	4              	DUP       
chr18       	15470459    	15686656    	15596703       	15759253       	5         	0         	5              	DUP       
chr18       	15470459    	15686656    	15679491       	15764432       	4         	0         	4              	DEL       
chr18       	15470459    	15686656    	15573580       	15770517       	6         	0         	6              	DEL       
chr18       	15470459    	15686656    	15470722       	15772083       	4         	0         	4              	DEL       
chr18       	15470459    	15686656    	15577931       	15776463       	11        	0         	11             	DEL       
chr18       	15470721    	15772083    	15537679       	15596979       	8         	0         	8              	DUP       
chr18       	15470721    	15772083    	15473008       	15548412       	6         	0         	6              	DEL       
chr18       	15470721    	15772083    	15472795       	15564766       	6         	0         	6              	DUP       
chr18       	15470721    	15772083    	15465181       	15561004       	5         	0         	5              	DEL       
chr18       	15470721    	15772083    	15504457       	15564516       	15        	0         	15             	DEL       
chr18       	15470721    	15772083    	15512476       	15572427       	6         	0         	6              	DEL       
chr18       	15470721    	15772083    	15472444       	15573312       	4         	0         	4              	DEL       
chr18       	15470721    	15772083    	15504205       	15604804       	6         	0         	6              	DUP       
chr18       	15470721    	15772083    	15624590       	15679284       	4         	0         	4              	DEL       
chr18       	15470721    	15772083    	15656784       	15684608       	6         	0         	6              	DEL       
chr18       	15470721    	15772083    	15470460       	15686656       	5         	0         	5              	DUP       
chr18       	15470721    	15772083    	15577562       	15694692       	4         	0         	4              	DUP       
chr18       	15470721    	15772083    	15548437       	15699735       	9         	0         	9              	DUP       
chr18       	15470721    	15772083    	15564793       	15699539       	4         	0         	4              	DEL       
chr18       	15470721    	15772083    	15654121       	15752599       	5         	0         	5              	DEL       
chr18       	15470721    	15772083    	15512165       	15755069       	4         	0         	4              	DUP       
chr18       	15470721    	15772083    	15730140       	15755134       	12        	0         	12             	DUP       
chr18       	15470721    	15772083    	15466245       	15758827       	8         	0         	8              	DEL       
chr18       	15470721    	15772083    	15596703       	15759253       	5         	0         	5              	DUP       
chr18       	15470721    	15772083    	15679491       	15764432       	4         	0         	4              	DEL       
chr18       	15470721    	15772083    	15573580       	15770517       	6         	0         	6              	DEL       
chr18       	15470721    	15772083    	15470722       	15772083       	4         	0         	4              	DEL       
chr18       	15470721    	15772083    	15577931       	15776463       	11        	0         	11             	DEL       
chr18       	15470721    	15772083    	15745670       	20631091       	5         	0         	5              	DEL       
chr18       	15470721    	15772083    	15754786       	20640668       	26        	0         	26             	DUP       
chr18       	15473007    	15548412    	15537679       	15596979       	8         	0         	8              	DUP       
chr18       	15473007    	15548412    	15473008       	15548412       	6         	0         	6              	DEL       
chr18       	15473007    	15548412    	15504457       	15564516       	15        	0         	15             	DEL       
chr18       	15473007    	15548412    	15512476       	15572427       	6         	0         	6              	DEL       
chr18       	15473007    	15548412    	15504205       	15604804       	6         	0         	6              	DUP       
chr18       	15473007    	15548412    	15548437       	15699735       	9         	0         	9              	DUP       
chr18       	15473007    	15548412    	15512165       	15755069       	4         	0         	4              	DUP       
chr18       	15472794    	15564766    	15537679       	15596979       	8         	0         	8              	DUP       
chr18       	15472794    	15564766    	15473008       	15548412       	6         	0         	6              	DEL       
chr18       	15472794    	15564766    	15472795       	15564766       	6         	0         	6              	DUP       
chr18       	15472794    	15564766    	15465181       	15561004       	5         	0         	5              	DEL       
chr18       	15472794    	15564766    	15504457       	15564516       	15        	0         	15             	DEL       
chr18       	15472794    	15564766    	15512476       	15572427       	6         	0         	6              	DEL       
chr18       	15472794    	15564766    	15504205       	15604804       	6         	0         	6              	DUP       
chr18       	15472794    	15564766    	15548437       	15699735       	9         	0         	9              	DUP       
chr18       	15472794    	15564766    	15564793       	15699539       	4         	0         	4              	DEL       
chr18       	15472794    	15564766    	15512165       	15755069       	4         	0         	4              	DUP       
chr18       	15472443    	15573312    	15537679       	15596979       	8         	0         	8              	DUP       
chr18       	15472443    	15573312    	15473008       	15548412       	6         	0         	6              	DEL       
chr18       	15472443    	15573312    	15472795       	15564766       	6         	0         	6              	DUP       
chr18       	15472443    	15573312    	15465181       	15561004       	5         	0         	5              	DEL       
chr18       	15472443    	15573312    	15504457       	15564516       	15        	0         	15             	DEL       
chr18       	15472443    	15573312    	15512476       	15572427       	6         	0         	6              	DEL       
chr18       	15472443    	15573312    	15472444       	15573312       	4         	0         	4              	DEL       
chr18       	15472443    	15573312    	15504205       	15604804       	6         	0         	6              	DUP       
chr18       	15472443    	15573312    	15548437       	15699735       	9         	0         	9              	DUP       
chr18       	15472443    	15573312    	15564793       	15699539       	4         	0         	4              	DEL       
chr18       	15472443    	15573312    	15512165       	15755069       	4         	0         	4              	DUP       
chr18       	15504456    	15564516    	15537679       	15596979       	8         	0         	8              	DUP       
chr18       	15504456    	15564516    	15473008       	15548412       	6         	0         	6              	DEL       
chr18       	15504456    	15564516    	15465181       	15561004       	5         	0         	5              	DEL       
chr18       	15504456    	15564516    	15504457       	15564516       	15        	0         	15             	DEL       
chr18       	15504456    	15564516    	15512476       	15572427       	6         	0         	6              	DEL       
chr18       	15504456    	15564516    	15548437       	15699735       	9         	0         	9              	DUP       
chr18       	15504456    	15564516    	15512165       	15755069       	4         	0         	4              	DUP       
chr18       	15504204    	15604804    	15537679       	15596979       	8         	0         	8              	DUP       
chr18       	15504204    	15604804    	15473008       	15548412       	6         	0         	6              	DEL       
chr18       	15504204    	15604804    	15472795       	15564766       	6         	0         	6              	DUP       
chr18       	15504204    	15604804    	15465181       	15561004       	5         	0         	5              	DEL       
chr18       	15504204    	15604804    	15504457       	15564516       	15        	0         	15             	DEL       
chr18       	15504204    	15604804    	15512476       	15572427       	6         	0         	6              	DEL       
chr18       	15504204    	15604804    	15472444       	15573312       	4         	0         	4              	DEL       
chr18       	15504204    	15604804    	15504205       	15604804       	6         	0         	6              	DUP       
chr18       	15504204    	15604804    	15577562       	15694692       	4         	0         	4              	DUP       
chr18       	15504204    	15604804    	15548437       	15699735       	9         	0         	9              	DUP       
chr18       	15504204    	15604804    	15564793       	15699539       	4         	0         	4              	DEL       
chr18       	15504204    	15604804    	15512165       	15755069       	4         	0         	4              	DUP       
chr18       	15504204    	15604804    	15596703       	15759253       	5         	0         	5              	DUP       
chr18       	15504204    	15604804    	15573580       	15770517       	6         	0         	6              	DEL       
chr18       	15504204    	15604804    	15577931       	15776463       	11        	0         	11             	DEL       
chr18       	15512475    	15572427    	15537679       	15596979       	8         	0         	8              	DUP       
chr18       	15512475    	15572427    	15473008       	15548412       	6         	0         	6              	DEL       
chr18       	15512475    	15572427    	15472795       	15564766       	6         	0         	6              	DUP       
chr18       	15512475    	15572427    	15465181       	15561004       	5         	0         	5              	DEL       
chr18       	15512475    	15572427    	15504457       	15564516       	15        	0         	15             	DEL       
chr18       	15512475    	15572427    	15512476       	15572427       	6         	0         	6              	DEL       
chr18       	15512475    	15572427    	15548437       	15699735       	9         	0         	9              	DUP       
chr18       	15512475    	15572427    	15564793       	15699539       	4         	0         	4              	DEL       
chr18       	15512164    	15755069    	15537679       	15596979       	8         	0         	8              	DUP       
chr18       	15512164    	15755069    	15473008       	15548412       	6         	0         	6              	DEL       
chr18       	15512164    	15755069    	15472795       	15564766       	6         	0         	6              	DUP       
chr18       	15512164    	15755069    	15465181       	15561004       	5         	0         	5              	DEL       
chr18       	15512164    	15755069    	15504457       	15564516       	15        	0         	15             	DEL       
chr18       	15512164    	15755069    	15512476       	15572427       	6         	0         	6              	DEL       
chr18       	15512164    	15755069    	15472444       	15573312       	4         	0         	4              	DEL       
chr18       	15512164    	15755069    	15504205       	15604804       	6         	0         	6              	DUP       
chr18       	15512164    	15755069    	15624590       	15679284       	4         	0         	4              	DEL       
chr18       	15512164    	15755069    	15656784       	15684608       	6         	0         	6              	DEL       
chr18       	15512164    	15755069    	15470460       	15686656       	5         	0         	5              	DUP       
chr18       	15512164    	15755069    	15577562       	15694692       	4         	0         	4              	DUP       
chr18       	15512164    	15755069    	15548437       	15699735       	9         	0         	9              	DUP       
chr18       	15512164    	15755069    	15564793       	15699539       	4         	0         	4              	DEL       
chr18       	15512164    	15755069    	15654121       	15752599       	5         	0         	5              	DEL       
chr18       	15512164    	15755069    	15512165       	15755069       	4         	0         	4              	DUP       
chr18       	15512164    	15755069    	15730140       	15755134       	12        	0         	12             	DUP       
chr18       	15512164    	15755069    	15596703       	15759253       	5         	0         	5              	DUP       
chr18       	15512164    	15755069    	15679491       	15764432       	4         	0         	4              	DEL       
chr18       	15512164    	15755069    	15573580       	15770517       	6         	0         	6              	DEL       
chr18       	15512164    	15755069    	15577931       	15776463       	11        	0         	11             	DEL       
chr18       	15512164    	15755069    	15745670       	20631091       	5         	0         	5              	DEL       
chr18       	15512164    	15755069    	15754786       	20640668       	26        	0         	26             	DUP       
chr18       	15537678    	15596979    	15537679       	15596979       	8         	0         	8              	DUP       
chr18       	15537678    	15596979    	15473008       	15548412       	6         	0         	6              	DEL       
chr18       	15537678    	15596979    	15472795       	15564766       	6         	0         	6              	DUP       
chr18       	15537678    	15596979    	15465181       	15561004       	5         	0         	5              	DEL       
chr18       	15537678    	15596979    	15504457       	15564516       	15        	0         	15             	DEL       
chr18       	15537678    	15596979    	15512476       	15572427       	6         	0         	6              	DEL       
chr18       	15537678    	15596979    	15472444       	15573312       	4         	0         	4              	DEL       
chr18       	15537678    	15596979    	15577562       	15694692       	4         	0         	4              	DUP       
chr18       	15537678    	15596979    	15548437       	15699735       	9         	0         	9              	DUP       
chr18       	15537678    	15596979    	15564793       	15699539       	4         	0         	4              	DEL       
chr18       	15537678    	15596979    	15596703       	15759253       	5         	0         	5              	DUP       
chr18       	15537678    	15596979    	15573580       	15770517       	6         	0         	6              	DEL       
chr18       	15537678    	15596979    	15577931       	15776463       	11        	0         	11             	DEL       
chr18       	15548436    	15699735    	15537679       	15596979       	8         	0         	8              	DUP       
chr18       	15548436    	15699735    	15473008       	15548412       	6         	0         	6              	DEL       
chr18       	15548436    	15699735    	15472795       	15564766       	6         	0         	6              	DUP       
chr18       	15548436    	15699735    	15465181       	15561004       	5         	0         	5              	DEL       
chr18       	15548436    	15699735    	15504457       	15564516       	15        	0         	15             	DEL       
chr18       	15548436    	15699735    	15512476       	15572427       	6         	0         	6              	DEL       
chr18       	15548436    	15699735    	15472444       	15573312       	4         	0         	4              	DEL       
chr18       	15548436    	15699735    	15504205       	15604804       	6         	0         	6              	DUP       
chr18       	15548436    	15699735    	15624590       	15679284       	4         	0         	4              	DEL       
chr18       	15548436    	15699735    	15656784       	15684608       	6         	0         	6              	DEL       
chr18       	15548436    	15699735    	15470460       	15686656       	5         	0         	5              	DUP       
chr18       	15548436    	15699735    	15577562       	15694692       	4         	0         	4              	DUP       
chr18       	15548436    	15699735    	15548437       	15699735       	9         	0         	9              	DUP       
chr18       	15548436    	15699735    	15564793       	15699539       	4         	0         	4              	DEL       
chr18       	15548436    	15699735    	15654121       	15752599       	5         	0         	5              	DEL       
chr18       	15548436    	15699735    	15596703       	15759253       	5         	0         	5              	DUP       
chr18       	15548436    	15699735    	15679491       	15764432       	4         	0         	4              	DEL       
chr18       	15548436    	15699735    	15573580       	15770517       	6         	0         	6              	DEL       
chr18       	15548436    	15699735    	15577931       	15776463       	11        	0         	11             	DEL       
chr18       	15573579    	15770517    	15537679       	15596979       	8         	0         	8              	DUP       
chr18       	15573579    	15770517    	15504205       	15604804       	6         	0         	6              	DUP       
chr18       	15573579    	15770517    	15624590       	15679284       	4         	0         	4              	DEL       
chr18       	15573579    	15770517    	15656784       	15684608       	6         	0         	6              	DEL       
chr18       	15573579    	15770517    	15470460       	15686656       	5         	0         	5              	DUP       
chr18       	15573579    	15770517    	15577562       	15694692       	4         	0         	4              	DUP       
chr18       	15573579    	15770517    	15548437       	15699735       	9         	0         	9              	DUP       
chr18       	15573579    	15770517    	15564793       	15699539       	4         	0         	4              	DEL       
chr18       	15573579    	15770517    	15654121       	15752599       	5         	0         	5              	DEL       
chr18       	15573579    	15770517    	15512165       	15755069       	4         	0         	4              	DUP       
chr18       	15573579    	15770517    	15730140       	15755134       	12        	0         	12             	DUP       
chr18       	15573579    	15770517    	15466245       	15758827       	8         	0         	8              	DEL       
chr18       	15573579    	15770517    	15596703       	15759253       	5         	0         	5              	DUP       
chr18       	15573579    	15770517    	15679491       	15764432       	4         	0         	4              	DEL       
chr18       	15573579    	15770517    	15573580       	15770517       	6         	0         	6              	DEL       
chr18       	15573579    	15770517    	15577931       	15776463       	11        	0         	11             	DEL       
chr18       	15573579    	15770517    	15745670       	20631091       	5         	0         	5              	DEL       
chr18       	15573579    	15770517    	15754786       	20640668       	26        	0         	26             	DUP       
chr18       	15577561    	15694692    	15537679       	15596979       	8         	0         	8              	DUP       
chr18       	15577561    	15694692    	15504205       	15604804       	6         	0         	6              	DUP       
chr18       	15577561    	15694692    	15624590       	15679284       	4         	0         	4              	DEL       
chr18       	15577561    	15694692    	15656784       	15684608       	6         	0         	6              	DEL       
chr18       	15577561    	15694692    	15470460       	15686656       	5         	0         	5              	DUP       
chr18       	15577561    	15694692    	15577562       	15694692       	4         	0         	4              	DUP       
chr18       	15577561    	15694692    	15654121       	15752599       	5         	0         	5              	DEL       
chr18       	15577561    	15694692    	15596703       	15759253       	5         	0         	5              	DUP       
chr18       	15577561    	15694692    	15679491       	15764432       	4         	0         	4              	DEL       
chr18       	15577561    	15694692    	15577931       	15776463       	11        	0         	11             	DEL       
chr18       	15577930    	15776463    	15537679       	15596979       	8         	0         	8              	DUP       
chr18       	15577930    	15776463    	15504205       	15604804       	6         	0         	6              	DUP       
chr18       	15577930    	15776463    	15624590       	15679284       	4         	0         	4              	DEL       
chr18       	15577930    	15776463    	15656784       	15684608       	6         	0         	6              	DEL       
chr18       	15577930    	15776463    	15470460       	15686656       	5         	0         	5              	DUP       
chr18       	15577930    	15776463    	15577562       	15694692       	4         	0         	4              	DUP       
chr18       	15577930    	15776463    	15548437       	15699735       	9         	0         	9              	DUP       
chr18       	15577930    	15776463    	15564793       	15699539       	4         	0         	4              	DEL       
chr18       	15577930    	15776463    	15654121       	15752599       	5         	0         	5              	DEL       
chr18       	15577930    	15776463    	15512165       	15755069       	4         	0         	4              	DUP       
chr18       	15577930    	15776463    	15730140       	15755134       	12        	0         	12             	DUP       
chr18       	15577930    	15776463    	15466245       	15758827       	8         	0         	8              	DEL       
chr18       	15577930    	15776463    	15596703       	15759253       	5         	0         	5              	DUP       
chr18       	15577930    	15776463    	15679491       	15764432       	4         	0         	4              	DEL       
chr18       	15577930    	15776463    	15573580       	15770517       	6         	0         	6              	DEL       
chr18       	15577930    	15776463    	15470722       	15772083       	4         	0         	4              	DEL       
chr18       	15577930    	15776463    	15577931       	15776463       	11        	0         	11             	DEL       
chr18       	15577930    	15776463    	15745670       	20631091       	5         	0         	5              	DEL       
chr18       	15577930    	15776463    	15754786       	20640668       	26        	0         	26             	DUP       
chr18       	15596702    	15759253    	15537679       	15596979       	8         	0         	8              	DUP       
chr18       	15596702    	15759253    	15504205       	15604804       	6         	0         	6              	DUP       
chr18       	15596702    	15759253    	15624590       	15679284       	4         	0         	4              	DEL       
chr18       	15596702    	15759253    	15656784       	15684608       	6         	0         	6              	DEL       
chr18       	15596702    	15759253    	15470460       	15686656       	5         	0         	5              	DUP       
chr18       	15596702    	15759253    	15577562       	15694692       	4         	0         	4              	DUP       
chr18       	15596702    	15759253    	15548437       	15699735       	9         	0         	9              	DUP       
chr18       	15596702    	15759253    	15564793       	15699539       	4         	0         	4              	DEL       
chr18       	15596702    	15759253    	15654121       	15752599       	5         	0         	5              	DEL       
chr18       	15596702    	15759253    	15512165       	15755069       	4         	0         	4              	DUP       
chr18       	15596702    	15759253    	15730140       	15755134       	12        	0         	12             	DUP       
chr18       	15596702    	15759253    	15466245       	15758827       	8         	0         	8              	DEL       
chr18       	15596702    	15759253    	15596703       	15759253       	5         	0         	5              	DUP       
chr18       	15596702    	15759253    	15679491       	15764432       	4         	0         	4              	DEL       
chr18       	15596702    	15759253    	15745670       	20631091       	5         	0         	5              	DEL       
chr18       	15596702    	15759253    	15754786       	20640668       	26        	0         	26             	DUP       
chr18       	15624589    	15679284    	15624590       	15679284       	4         	0         	4              	DEL       
chr18       	15624589    	15679284    	15656784       	15684608       	6         	0         	6              	DEL       
chr18       	15624589    	15679284    	15654121       	15752599       	5         	0         	5              	DEL       
chr18       	15654356    	15752410    	15624590       	15679284       	4         	0         	4              	DEL       
chr18       	15654356    	15752410    	15656784       	15684608       	6         	0         	6              	DEL       
chr18       	15654356    	15752410    	15470460       	15686656       	5         	0         	5              	DUP       
chr18       	15654356    	15752410    	15577562       	15694692       	4         	0         	4              	DUP       
chr18       	15654356    	15752410    	15548437       	15699735       	9         	0         	9              	DUP       
chr18       	15654356    	15752410    	15564793       	15699539       	4         	0         	4              	DEL       
chr18       	15654356    	15752410    	15730140       	15755134       	12        	0         	12             	DUP       
chr18       	15654356    	15752410    	15679491       	15764432       	4         	0         	4              	DEL       
chr18       	15654356    	15752410    	15745670       	20631091       	5         	0         	5              	DEL       
chr18       	15656916    	15684414    	15624590       	15679284       	4         	0         	4              	DEL       
chr18       	15656916    	15684414    	15679491       	15764432       	4         	0         	4              	DEL       
chr18       	15679490    	15764432    	15656784       	15684608       	6         	0         	6              	DEL       
chr18       	15679490    	15764432    	15470460       	15686656       	5         	0         	5              	DUP       
chr18       	15679490    	15764432    	15577562       	15694692       	4         	0         	4              	DUP       
chr18       	15679490    	15764432    	15548437       	15699735       	9         	0         	9              	DUP       
chr18       	15679490    	15764432    	15564793       	15699539       	4         	0         	4              	DEL       
chr18       	15679490    	15764432    	15654121       	15752599       	5         	0         	5              	DEL       
chr18       	15679490    	15764432    	15512165       	15755069       	4         	0         	4              	DUP       
chr18       	15679490    	15764432    	15730140       	15755134       	12        	0         	12             	DUP       
chr18       	15679490    	15764432    	15466245       	15758827       	8         	0         	8              	DEL       
chr18       	15679490    	15764432    	15596703       	15759253       	5         	0         	5              	DUP       
chr18       	15679490    	15764432    	15679491       	15764432       	4         	0         	4              	DEL       
chr18       	15679490    	15764432    	15745670       	20631091       	5         	0         	5              	DEL       
chr18       	15679490    	15764432    	15754786       	20640668       	26        	0         	26             	DUP       
chr18       	15729995    	15755234    	15654121       	15752599       	5         	0         	5              	DEL       
chr18       	15729995    	15755234    	15512165       	15755069       	4         	0         	4              	DUP       
chr18       	15729995    	15755234    	15730140       	15755134       	12        	0         	12             	DUP       
chr18       	15729995    	15755234    	15745670       	20631091       	5         	0         	5              	DEL       
chr18       	15729995    	15755234    	15754786       	20640668       	26        	0         	26             	DUP       
chr18       	15745866    	20630860    	15654121       	15752599       	5         	0         	5              	DEL       
chr18       	15745866    	20630860    	15512165       	15755069       	4         	0         	4              	DUP       
chr18       	15745866    	20630860    	15730140       	15755134       	12        	0         	12             	DUP       
chr18       	15745866    	20630860    	15466245       	15758827       	8         	0         	8              	DEL       
chr18       	15745866    	20630860    	15596703       	15759253       	5         	0         	5              	DUP       
chr18       	15745866    	20630860    	15679491       	15764432       	4         	0         	4              	DEL       
chr18       	15745866    	20630860    	15573580       	15770517       	6         	0         	6              	DEL       
chr18       	15745866    	20630860    	15470722       	15772083       	4         	0         	4              	DEL       
chr18       	15745866    	20630860    	15577931       	15776463       	11        	0         	11             	DEL       
chr18       	15745866    	20630860    	17538974       	18038659       	7         	0         	7              	DUP       
chr18       	15745866    	20630860    	16047098       	17093063       	4         	0         	4              	DUP       
chr18       	15745866    	20630860    	16073838       	17539365       	6         	0         	6              	DUP       
chr18       	15745866    	20630860    	17598323       	19761187       	4         	0         	4              	DUP       
chr18       	15745866    	20630860    	15859118       	20211478       	4         	0         	4              	DEL       
chr18       	15745866    	20630860    	18040717       	20469976       	6         	0         	6              	DUP       
chr18       	15745866    	20630860    	20611746       	20631115       	11        	0         	11             	DEL       
chr18       	15745866    	20630860    	15754786       	20640668       	26        	0         	26             	DUP       
chr18       	15754686    	20640836    	15512165       	15755069       	4         	0         	4              	DUP       
chr18       	15754686    	20640836    	15730140       	15755134       	12        	0         	12             	DUP       
chr18       	15754686    	20640836    	15466245       	15758827       	8         	0         	8              	DEL       
chr18       	15754686    	20640836    	15596703       	15759253       	5         	0         	5              	DUP       
chr18       	15754686    	20640836    	15679491       	15764432       	4         	0         	4              	DEL       
chr18       	15754686    	20640836    	15573580       	15770517       	6         	0         	6              	DEL       
chr18       	15754686    	20640836    	15470722       	15772083       	4         	0         	4              	DEL       
chr18       	15754686    	20640836    	15577931       	15776463       	11        	0         	11             	DEL       
chr18       	15754686    	20640836    	17538974       	18038659       	7         	0         	7              	DUP       
chr18       	15754686    	20640836    	16047098       	17093063       	4         	0         	4              	DUP       
chr18       	15754686    	20640836    	16073838       	17539365       	6         	0         	6              	DUP       
chr18       	15754686    	20640836    	17598323       	19761187       	4         	0         	4              	DUP       
chr18       	15754686    	20640836    	15859118       	20211478       	4         	0         	4              	DEL       
chr18       	15754686    	20640836    	18040717       	20469976       	6         	0         	6              	DUP       
chr18       	15754686    	20640836    	15745670       	20631091       	5         	0         	5              	DEL       
chr18       	15754686    	20640836    	20611746       	20631115       	11        	0         	11             	DEL       
chr18       	15754686    	20640836    	20631442       	20635512       	10        	0         	10             	DEL       
chr18       	15754686    	20640836    	15754786       	20640668       	26        	0         	26             	DUP       
chr18       	15859117    	20211478    	17538974       	18038659       	7         	0         	7              	DUP       
chr18       	15859117    	20211478    	16047098       	17093063       	4         	0         	4              	DUP       
chr18       	15859117    	20211478    	16073838       	17539365       	6         	0         	6              	DUP       
chr18       	15859117    	20211478    	17598323       	19761187       	4         	0         	4              	DUP       
chr18       	15859117    	20211478    	15859118       	20211478       	4         	0         	4              	DEL       
chr18       	15859117    	20211478    	18040717       	20469976       	6         	0         	6              	DUP       
chr18       	16047097    	17093063    	16047098       	17093063       	4         	0         	4              	DUP       
chr18       	16047097    	17093063    	16073838       	17539365       	6         	0         	6              	DUP       
chr18       	16073683    	17539495    	17538974       	18038659       	7         	0         	7              	DUP       
chr18       	16073683    	17539495    	16047098       	17093063       	4         	0         	4              	DUP       
chr18       	16073683    	17539495    	16073838       	17539365       	6         	0         	6              	DUP       
chr18       	17538973    	18038659    	17538974       	18038659       	7         	0         	7              	DUP       
chr18       	17538973    	18038659    	16073838       	17539365       	6         	0         	6              	DUP       
chr18       	17538973    	18038659    	17598323       	19761187       	4         	0         	4              	DUP       
chr18       	17598322    	19761187    	17538974       	18038659       	7         	0         	7              	DUP       
chr18       	17598322    	19761187    	17598323       	19761187       	4         	0         	4              	DUP       
chr18       	17598322    	19761187    	18040717       	20469976       	6         	0         	6              	DUP       
chr18       	18040696    	20470263    	17598323       	19761187       	4         	0         	4              	DUP       
chr18       	18040696    	20470263    	15859118       	20211478       	4         	0         	4              	DEL       
chr18       	18040696    	20470263    	18040717       	20469976       	6         	0         	6              	DUP       
chr18       	20611928    	20631010    	15745670       	20631091       	5         	0         	5              	DEL       
chr18       	20631540    	20635444    	20631442       	20635512       	10        	0         	10             	DEL       
chr18       	20711510    	20721329    	20711511       	20721329       	4         	0         	4              	DUP       
chr18       	20711510    	20721329    	20711782       	20735697       	6         	0         	6              	DEL       
chr18       	20711781    	20735697    	20711511       	20721329       	4         	0         	4              	DUP       
chr18       	20711781    	20735697    	20711782       	20735697       	6         	0         	6              	DEL       
chr18       	20738103    	20802857    	20737947       	20802935       	10        	0         	10             	DEL       
chr18       	20803153    	20914742    	20803154       	20914742       	5         	0         	5              	DEL       
chr18       	22592085    	22592148    	22592086       	22592153       	2         	13        	15             	DEL       
chr18       	24323397    	24324629    	24323408       	24324629       	46        	2         	48             	DEL       
chr18       	24410777    	24412083    	24410778       	24412083       	14        	5         	19             	DEL       
chr18       	25045851    	25045932    	25045857       	25045929       	0         	9         	9              	DEL       
chr18       	25312515    	25312840    	25312530       	25312840       	1         	7         	8              	DEL       
chr18       	25893616    	25893686    	25893617       	25893686       	0         	10        	10             	DEL       
chr18       	26247910    	26248848    	26247911       	26248848       	6         	0         	6              	DEL       
chr18       	26991655    	26992377    	26991656       	26992377       	19        	7         	26             	DEL       
chr18       	27149387    	27159057    	27149387       	27159055       	10        	0         	10             	DUP       
chr18       	27379472    	27379729    	27379481       	27379729       	0         	5         	5              	DEL       
chr18       	28247911    	28248245    	28247928       	28248245       	1         	7         	8              	DEL       
chr18       	28693106    	28698449    	28693105       	28698448       	12        	0         	12             	DEL       
chr18       	28783778    	28784100    	28783794       	28784100       	1         	27        	28             	DEL       
chr18       	29997099    	69940479    	30292620       	30292933       	2         	13        	15             	DEL       
chr18       	29997099    	69940479    	31940584       	31940910       	0         	4         	4              	DUP       
chr18       	29997099    	69940479    	34950995       	34951272       	0         	16        	16             	DEL       
chr18       	29997099    	69940479    	37726097       	37726669       	13        	8         	21             	DEL       
chr18       	29997099    	69940479    	37735673       	37735976       	0         	7         	7              	DEL       
chr18       	29997099    	69940479    	38565696       	38565847       	0         	4         	4              	DUP       
chr18       	29997099    	69940479    	39481682       	39481998       	1         	14        	15             	DEL       
chr18       	29997099    	69940479    	39487050       	39487108       	0         	6         	6              	DEL       
chr18       	29997099    	69940479    	41284815       	41288379       	54        	28        	82             	DEL       
chr18       	29997099    	69940479    	41563440       	41563517       	0         	15        	15             	DEL       
chr18       	29997099    	69940479    	43451587       	43452563       	23        	6         	29             	DEL       
chr18       	29997099    	69940479    	43801606       	43801656       	0         	4         	4              	DEL       
chr18       	29997099    	69940479    	44396742       	44402109       	17        	6         	23             	DEL       
chr18       	29997099    	69940479    	45681049       	45681363       	2         	15        	17             	DEL       
chr18       	29997099    	69940479    	45765236       	45765316       	0         	11        	11             	DEL       
chr18       	29997099    	69940479    	46758470       	46758791       	0         	10        	10             	DEL       
chr18       	29997099    	69940479    	46802760       	46803096       	5         	12        	17             	DEL       
chr18       	29997099    	69940479    	47188800       	47188872       	0         	9         	9              	DEL       
chr18       	29997099    	69940479    	47573537       	47573835       	0         	10        	10             	DEL       
chr18       	29997099    	69940479    	48469791       	48470089       	1         	23        	24             	DEL       
chr18       	29997099    	69940479    	48632980       	48633058       	0         	6         	6              	DEL       
chr18       	29997099    	69940479    	50168603       	50172016       	15        	8         	23             	DEL       
chr18       	29997099    	69940479    	51198755       	51199189       	0         	5         	5              	DEL       
chr18       	29997099    	69940479    	53086016       	53086655       	4         	0         	4              	DEL       
chr18       	29997099    	69940479    	53399622       	53399930       	2         	21        	23             	DEL       
chr18       	29997099    	69940479    	53909684       	53910049       	0         	9         	9              	DEL       
chr18       	29997099    	69940479    	54426598       	54430589       	39        	13        	52             	DEL       
chr18       	29997099    	69940479    	54536573       	54537628       	12        	0         	12             	DEL       
chr18       	29997099    	69940479    	54537528       	54538311       	7         	0         	7              	DUP       
chr18       	29997099    	69940479    	54536574       	54539428       	2         	6         	8              	DEL       
chr18       	29997099    	69940479    	56826056       	56826276       	0         	8         	8              	DUP       
chr18       	29997099    	69940479    	57279506       	57281486       	20        	9         	29             	DEL       
chr18       	29997099    	69940479    	57509960       	57510685       	15        	0         	15             	DEL       
chr18       	29997099    	69940479    	58003904       	58004196       	1         	16        	17             	DEL       
chr18       	29997099    	69940479    	58134360       	58134671       	1         	24        	25             	DEL       
chr18       	29997099    	69940479    	61616642       	61616865       	0         	11        	11             	DEL       
chr18       	29997099    	69940479    	62580594       	62581764       	4         	0         	4              	DEL       
chr18       	29997099    	69940479    	64822717       	64822828       	0         	12        	12             	DEL       
chr18       	29997099    	69940479    	65329610       	65329690       	0         	15        	15             	DEL       
chr18       	29997099    	69940479    	65866018       	65866346       	2         	21        	23             	DEL       
chr18       	29997099    	69940479    	66672001       	66672229       	0         	8         	8              	DEL       
chr18       	29997099    	69940479    	66871569       	66871646       	0         	11        	11             	DEL       
chr18       	29997099    	69940479    	66875709       	66876014       	2         	21        	23             	DEL       
chr18       	29997099    	69940479    	67371028       	67931543       	4         	0         	4              	DEL       
chr18       	29997099    	69940479    	68280092       	68280211       	0         	10        	10             	DEL       
chr18       	29997099    	69940479    	68554091       	68554404       	0         	13        	13             	DEL       
chr18       	29997099    	69940479    	29997115       	69940478       	0         	4         	4              	DEL       
chr18       	30292603    	30292933    	30292620       	30292933       	2         	13        	15             	DEL       
chr18       	31940583    	31940910    	31940584       	31940910       	0         	4         	4              	DUP       
chr18       	34950994    	34951272    	34950995       	34951272       	0         	16        	16             	DEL       
chr18       	37726096    	37726669    	37726097       	37726669       	13        	8         	21             	DEL       
chr18       	37735657    	37735976    	37735673       	37735976       	0         	7         	7              	DEL       
chr18       	38565696    	38565843    	38565696       	38565847       	0         	4         	4              	DUP       
chr18       	39481667    	39481998    	39481682       	39481998       	1         	14        	15             	DEL       
chr18       	39487049    	39487108    	39487050       	39487108       	0         	6         	6              	DEL       
chr18       	41284819    	41288379    	41284815       	41288379       	54        	28        	82             	DEL       
chr18       	41563437    	41563517    	41563440       	41563517       	0         	15        	15             	DEL       
chr18       	43451578    	43452564    	43451587       	43452563       	23        	6         	29             	DEL       
chr18       	44396741    	44402109    	44396742       	44402109       	17        	6         	23             	DEL       
chr18       	45681037    	45681363    	45681049       	45681363       	2         	15        	17             	DEL       
chr18       	45765235    	45765316    	45765236       	45765316       	0         	11        	11             	DEL       
chr18       	46758453    	46758791    	46758470       	46758791       	0         	10        	10             	DEL       
chr18       	46802745    	46803097    	46802760       	46803096       	5         	12        	17             	DEL       
chr18       	47188794    	47188872    	47188800       	47188872       	0         	9         	9              	DEL       
chr18       	47573522    	47573835    	47573537       	47573835       	0         	10        	10             	DEL       
chr18       	48469771    	48470089    	48469791       	48470089       	1         	23        	24             	DEL       
chr18       	48632979    	48633058    	48632980       	48633058       	0         	6         	6              	DEL       
chr18       	50168602    	50172016    	50168603       	50172016       	15        	8         	23             	DEL       
chr18       	53085987    	53086585    	53086016       	53086655       	4         	0         	4              	DEL       
chr18       	53399606    	53399930    	53399622       	53399930       	2         	21        	23             	DEL       
chr18       	53909687    	53910049    	53909684       	53910049       	0         	9         	9              	DEL       
chr18       	54426592    	54430589    	54426598       	54430589       	39        	13        	52             	DEL       
chr18       	54536435    	54537629    	54536573       	54537628       	12        	0         	12             	DEL       
chr18       	54536435    	54537629    	54537528       	54538311       	7         	0         	7              	DUP       
chr18       	54536435    	54537629    	54536574       	54539428       	2         	6         	8              	DEL       
chr18       	54537477    	54538617    	54536573       	54537628       	12        	0         	12             	DEL       
chr18       	54537477    	54538617    	54537528       	54538311       	7         	0         	7              	DUP       
chr18       	54536573    	54539427    	54536573       	54537628       	12        	0         	12             	DEL       
chr18       	54536573    	54539427    	54537528       	54538311       	7         	0         	7              	DUP       
chr18       	54536573    	54539427    	54536574       	54539428       	2         	6         	8              	DEL       
chr18       	56826055    	56826275    	56826056       	56826276       	0         	8         	8              	DUP       
chr18       	57279505    	57281486    	57279506       	57281486       	20        	9         	29             	DEL       
chr18       	57509939    	57510255    	57509960       	57510685       	15        	0         	15             	DEL       
chr18       	58003889    	58004196    	58003904       	58004196       	1         	16        	17             	DEL       
chr18       	58134344    	58134671    	58134360       	58134671       	1         	24        	25             	DEL       
chr18       	61616628    	61616865    	61616642       	61616865       	0         	11        	11             	DEL       
chr18       	62580593    	62581764    	62580594       	62581764       	4         	0         	4              	DEL       
chr18       	64822714    	64822828    	64822717       	64822828       	0         	12        	12             	DEL       
chr18       	65329608    	65329690    	65329610       	65329690       	0         	15        	15             	DEL       
chr18       	65866001    	65866347    	65866018       	65866346       	2         	21        	23             	DEL       
chr18       	66671996    	66672229    	66672001       	66672229       	0         	8         	8              	DEL       
chr18       	66871545    	66871656    	66871569       	66871646       	0         	11        	11             	DEL       
chr18       	66875692    	66876014    	66875709       	66876014       	2         	21        	23             	DEL       
chr18       	67371027    	67931543    	67371028       	67931543       	4         	0         	4              	DEL       
chr18       	68280091    	68280236    	68280092       	68280211       	0         	10        	10             	DEL       
chr18       	68554080    	68554404    	68554091       	68554404       	0         	13        	13             	DEL       
chr18       	70282361    	70282687    	70282374       	70282687       	2         	7         	9              	DEL       
chr18       	71179487    	71179822    	71179505       	71179822       	3         	14        	17             	DEL       
chr18       	71411026    	71411856    	71411027       	71411856       	14        	0         	14             	DEL       
chr18       	72229533    	72229854    	72229535       	72229854       	1         	14        	15             	DEL       
chr18       	73606160    	73606482    	73606179       	73606482       	1         	5         	6              	DEL       
chr18       	73776971    	73777307    	73776989       	73777307       	0         	14        	14             	DEL       
chr18       	74485192    	74485534    	74485207       	74485533       	2         	22        	24             	DEL       
chr18       	76508872    	76509005    	76508898       	76509005       	0         	4         	4              	DEL       
chr18       	76585335    	76585994    	76585336       	76585994       	7         	0         	7              	DEL       
chr18       	77057813    	77058115    	77057830       	77058115       	0         	18        	18             	DEL       
chr18       	77440553    	77681153    	77555042       	77556203       	28        	9         	37             	DEL       
chr18       	77440553    	77681153    	77440554       	77681153       	25        	5         	30             	DEL       
chr18       	77554766    	77556204    	77555042       	77556203       	28        	9         	37             	DEL       
chr18       	78041169    	78041224    	78041170       	78041224       	0         	9         	9              	DEL       
chr18       	78232378    	78232484    	78232379       	78232484       	0         	7         	7              	DEL       
chr18       	78237282    	78237615    	78237296       	78237615       	1         	13        	14             	DEL       
chr18       	78370067    	78373137    	78370040       	78373218       	8         	0         	8              	DEL       
chr18       	78442118    	78443340    	78442137       	78443340       	18        	11        	29             	DEL       
chr18       	78613648    	78614366    	78613649       	78614366       	10        	0         	10             	DEL       
chr18       	79549949    	79552091    	79549973       	79552075       	27        	0         	27             	DEL       
chr18       	79764521    	79765514    	79764522       	79765514       	11        	0         	11             	DEL       
chr18       	79885838    	79886975    	79885839       	79886975       	6         	0         	6              	DEL       
chr19       	350797      	351862      	350797         	351948         	13        	0         	13             	DUP       
chr19       	566148      	569357      	566221         	569347         	39        	0         	39             	DEL       
chr19       	878431      	879492      	878432         	879492         	4         	0         	4              	DUP       
chr19       	1182641     	1183160     	1182574        	1183135        	7         	0         	7              	DEL       
chr19       	2033040     	2033183     	2033041        	2033183        	0         	8         	8              	DEL       
chr19       	2397800     	2397997     	2397807        	2397997        	0         	5         	5              	DEL       
chr19       	2674195     	2674284     	2674197        	2674284        	1         	14        	15             	DEL       
chr19       	2713338     	2714401     	2713339        	2714401        	6         	0         	6              	DEL       
chr19       	2909319     	2910500     	2909399        	2910523        	18        	0         	18             	DEL       
chr19       	3173330     	3175771     	3173331        	3175786        	26        	0         	26             	DEL       
chr19       	3310173     	3311017     	3310212        	3311045        	12        	0         	12             	DUP       
chr19       	3581046     	3581378     	3581084        	3581378        	1         	8         	9              	DEL       
chr19       	4511268     	4512457     	4511238        	4511911        	7         	0         	7              	DUP       
chr19       	4618598     	4619587     	4618599        	4619587        	8         	0         	8              	DEL       
chr19       	5761462     	5761618     	5761467        	5761619        	0         	11        	11             	DUP       
chr19       	5849779     	5851939     	5849779        	5852005        	19        	0         	19             	DUP       
chr19       	6987451     	6987781     	6987467        	6987781        	1         	3         	4              	DEL       
chr19       	7153124     	7153367     	7153125        	7153367        	0         	6         	6              	DEL       
chr19       	7153124     	7153367     	7153223        	7153499        	3         	5         	8              	DUP       
chr19       	7153222     	7153499     	7153125        	7153367        	0         	6         	6              	DEL       
chr19       	7153222     	7153499     	7153223        	7153499        	3         	5         	8              	DUP       
chr19       	7321856     	7322366     	7321876        	7322530        	26        	0         	26             	INV       
chr19       	7331319     	7331573     	7331319        	7331581        	0         	8         	8              	DUP       
chr19       	8178126     	8180073     	8178159        	8180036        	10        	0         	10             	DEL       
chr19       	8449525     	8449833     	8449541        	8449833        	0         	17        	17             	DEL       
chr19       	9408966     	9409025     	9408967        	9409025        	0         	13        	13             	DEL       
chr19       	12388282    	12427645    	12388282       	12427643       	4         	0         	4              	DUP       
chr19       	12388282    	12427645    	12388545       	12428015       	4         	0         	4              	DEL       
chr19       	12446881    	12447171    	12446897       	12447171       	0         	11        	11             	DEL       
chr19       	12504256    	12504600    	12504265       	12504600       	0         	4         	4              	DEL       
chr19       	12584061    	12588116    	12584093       	12588116       	34        	0         	34             	DEL       
chr19       	12989475    	12989808    	12989556       	12989806       	7         	0         	7              	DUP       
chr19       	13664872    	13666036    	13664893       	13665991       	17        	0         	17             	DEL       
chr19       	14621532    	14623317    	14621532       	14623316       	23        	2         	25             	DEL       
chr19       	14935578    	14938665    	14935580       	14938665       	21        	16        	37             	DEL       
chr19       	15212086    	15213366    	15212302       	15213439       	14        	0         	14             	DEL       
chr19       	15651125    	15651599    	15651164       	15651599       	4         	1         	5              	DEL       
chr19       	15873259    	15873395    	15873274       	15873378       	1         	5         	6              	DEL       
chr19       	17463771    	17463958    	17463792       	17463948       	1         	13        	14             	DEL       
chr19       	17722271    	17722438    	17722272       	17722449       	0         	4         	4              	DUP       
chr19       	19147208    	19147483    	19147213       	19147483       	0         	16        	16             	DEL       
chr19       	19723633    	19728853    	19723637       	19728853       	18        	1         	19             	DEL       
chr19       	21089968    	21151950    	21089641       	21151751       	7         	0         	7              	DEL       
chr19       	21089968    	21151950    	21089968       	21151948       	8         	0         	8              	DUP       
chr19       	21567921    	21569010    	21567922       	21569010       	6         	0         	6              	DEL       
chr19       	21720247    	21722765    	21720254       	21722765       	48        	31        	79             	DEL       
chr19       	22957980    	22960157    	22957998       	22960117       	21        	0         	21             	DEL       
chr19       	23137985    	23138303    	23138001       	23138303       	0         	11        	11             	DEL       
chr19       	23299160    	27819211    	27340635       	27345668       	83        	0         	83             	DEL       
chr19       	23299160    	27819211    	27377170       	27377475       	13        	0         	13             	DEL       
chr19       	23299160    	27819211    	23299254       	27819209       	4         	0         	4              	DUP       
chr19       	23299160    	27819211    	23322941       	23465898       	4         	0         	4              	DEL       
chr19       	23299160    	27819211    	23466452       	23466551       	0         	5         	5              	DEL       
chr19       	23299160    	27819211    	23635830       	23635882       	0         	5         	5              	DEL       
chr19       	23299160    	27819211    	23753116       	23753635       	8         	0         	8              	DUP       
chr19       	23299160    	27819211    	23803607       	23803914       	1         	14        	15             	DEL       
chr19       	23299160    	27819211    	23872721       	23967771       	29        	0         	29             	DEL       
chr19       	23299160    	27819211    	23873152       	23968306       	27        	0         	27             	DUP       
chr19       	23299160    	27819211    	24354820       	24355502       	4         	0         	4              	DEL       
chr19       	23299160    	27819211    	24358987       	24359110       	0         	17        	17             	DEL       
chr19       	23299160    	27819211    	24390814       	24391406       	35        	0         	35             	DEL       
chr19       	23299160    	27819211    	24401466       	24402174       	7         	0         	7              	DEL       
chr19       	23299160    	27819211    	24419506       	24420477       	4         	0         	4              	DEL       
chr19       	23299160    	27819211    	24896952       	24897911       	41        	0         	41             	DUP       
chr19       	23299160    	27819211    	24896575       	24897659       	8         	0         	8              	DEL       
chr19       	23299160    	27819211    	24905578       	24906506       	4         	0         	4              	DEL       
chr19       	23299160    	27819211    	27242018       	27242604       	9         	0         	9              	DEL       
chr19       	23299160    	27819211    	27310792       	27315693       	15        	0         	15             	DUP       
chr19       	23299160    	27819211    	27310576       	27315282       	22        	0         	22             	DEL       
chr19       	23299160    	27819211    	27358127       	27359161       	4         	0         	4              	DEL       
chr19       	23299160    	27819211    	27350698       	27364437       	22        	0         	22             	DEL       
chr19       	23299160    	27819211    	27377762       	27378741       	56        	0         	56             	DUP       
chr19       	23299160    	27819211    	27389327       	27389734       	28        	0         	28             	DEL       
chr19       	23299160    	27819211    	27390906       	27391454       	69        	0         	69             	DEL       
chr19       	23299160    	27819211    	27363743       	27398105       	9         	0         	9              	DUP       
chr19       	23299160    	27819211    	27363378       	27397919       	9         	0         	9              	DEL       
chr19       	23299160    	27819211    	27397464       	27398458       	5         	0         	5              	DEL       
chr19       	23299160    	27819211    	27470474       	27472294       	41        	0         	41             	DEL       
chr19       	23322998    	23465757    	23322941       	23465898       	4         	0         	4              	DEL       
chr19       	23466580    	23467235    	23466452       	23466551       	0         	5         	5              	DEL       
chr19       	23635813    	23635905    	23635830       	23635882       	0         	5         	5              	DEL       
chr19       	23753135    	23753600    	23753116       	23753635       	8         	0         	8              	DUP       
chr19       	23803590    	23803914    	23803607       	23803914       	1         	14        	15             	DEL       
chr19       	23872634    	23967723    	23872721       	23967771       	29        	0         	29             	DEL       
chr19       	23872634    	23967723    	23873152       	23968306       	27        	0         	27             	DUP       
chr19       	23873181    	23968360    	23872721       	23967771       	29        	0         	29             	DEL       
chr19       	23873181    	23968360    	23873152       	23968306       	27        	0         	27             	DUP       
chr19       	24358953    	24359111    	24358987       	24359110       	0         	17        	17             	DEL       
chr19       	24390813    	24391406    	24390814       	24391406       	35        	0         	35             	DEL       
chr19       	24896574    	24897659    	24896952       	24897911       	41        	0         	41             	DUP       
chr19       	24896574    	24897659    	24896575       	24897659       	8         	0         	8              	DEL       
chr19       	24896951    	24897911    	24896952       	24897911       	41        	0         	41             	DUP       
chr19       	24896951    	24897911    	24896575       	24897659       	8         	0         	8              	DEL       
chr19       	27242017    	27242604    	27242018       	27242604       	9         	0         	9              	DEL       
chr19       	27310519    	27315299    	27310792       	27315693       	15        	0         	15             	DUP       
chr19       	27310519    	27315299    	27310576       	27315282       	22        	0         	22             	DEL       
chr19       	27310536    	27315657    	27310792       	27315693       	15        	0         	15             	DUP       
chr19       	27310536    	27315657    	27310576       	27315282       	22        	0         	22             	DEL       
chr19       	27340626    	27345657    	27340635       	27345668       	83        	0         	83             	DEL       
chr19       	27350796    	27364438    	27358127       	27359161       	4         	0         	4              	DEL       
chr19       	27350796    	27364438    	27350698       	27364437       	22        	0         	22             	DEL       
chr19       	27350796    	27364438    	27363743       	27398105       	9         	0         	9              	DUP       
chr19       	27350796    	27364438    	27363378       	27397919       	9         	0         	9              	DEL       
chr19       	27377762    	27378743    	27377762       	27378741       	56        	0         	56             	DUP       
chr19       	27389326    	27389734    	27389327       	27389734       	28        	0         	28             	DEL       
chr19       	27390905    	27391454    	27390906       	27391454       	69        	0         	69             	DEL       
chr19       	27470454    	27472338    	27470474       	27472294       	41        	0         	41             	DEL       
chr19       	29459276    	29465260    	29459290       	29465260       	27        	8         	35             	DEL       
chr19       	29719333    	29719793    	29719334       	29719793       	5         	0         	5              	DEL       
chr19       	29895610    	29895834    	29895626       	29895834       	0         	14        	14             	DEL       
chr19       	29897882    	29902193    	29897897       	29902193       	46        	17        	63             	DEL       
chr19       	30796564    	30798838    	30796597       	30798815       	15        	0         	15             	DEL       
chr19       	33081873    	33082138    	33081874       	33082138       	0         	8         	8              	DEL       
chr19       	33250159    	33250314    	33250160       	33250314       	0         	6         	6              	DEL       
chr19       	33825461    	33825673    	33825462       	33825673       	0         	4         	4              	DEL       
chr19       	35170175    	35174894    	35170178       	35174894       	21        	4         	25             	DEL       
chr19       	36171771    	36172069    	36171784       	36172061       	2         	6         	8              	DEL       
chr19       	36349848    	36356170    	36349851       	36356170       	27        	5         	32             	DEL       
chr19       	36555278    	36555595    	36555293       	36555595       	0         	13        	13             	DEL       
chr19       	36793414    	36793725    	36793433       	36793725       	1         	7         	8              	DEL       
chr19       	36972539    	36972608    	36972541       	36972608       	0         	7         	7              	DEL       
chr19       	37788468    	37789623    	37788468       	37789621       	7         	0         	7              	DUP       
chr19       	38171273    	38171681    	38171282       	38171681       	0         	8         	8              	DEL       
chr19       	40563589    	40563823    	40563599       	40563823       	1         	12        	13             	DEL       
chr19       	40838477    	40869094    	40838477       	40869092       	9         	0         	9              	DUP       
chr19       	40838477    	40869094    	40843585       	40875576       	6         	0         	6              	DEL       
chr19       	40843586    	40875577    	40838477       	40869092       	9         	0         	9              	DUP       
chr19       	40843586    	40875577    	40843585       	40875576       	6         	0         	6              	DEL       
chr19       	41503532    	41510089    	41503532       	41510087       	9         	0         	9              	DUP       
chr19       	41503532    	41510089    	41503569       	41510088       	6         	0         	6              	DEL       
chr19       	41503570    	41510089    	41503532       	41510087       	9         	0         	9              	DUP       
chr19       	41503570    	41510089    	41503569       	41510088       	6         	0         	6              	DEL       
chr19       	41643856    	41646304    	41643872       	41646304       	38        	21        	59             	DEL       
chr19       	41803699    	41807213    	41803700       	41807206       	1         	4         	5              	DEL       
chr19       	41803699    	41807213    	41803755       	41807383       	6         	3         	9              	DUP       
chr19       	41803754    	41807380    	41803700       	41807206       	1         	4         	5              	DEL       
chr19       	41803754    	41807380    	41803755       	41807383       	6         	3         	9              	DUP       
chr19       	42663277    	42663671    	42663278       	42663671       	6         	0         	6              	DEL       
chr19       	43196841    	43260654    	43196840       	43260653       	8         	0         	8              	DEL       
chr19       	43679332    	43679921    	43679316       	43679927       	17        	0         	17             	DUP       
chr19       	44337323    	44337426    	44337324       	44337426       	0         	9         	9              	DEL       
chr19       	44546226    	44546891    	44546246       	44546890       	31        	17        	48             	DEL       
chr19       	44969847    	44970991    	44969908       	44970983       	19        	0         	19             	DEL       
chr19       	45400748    	45401074    	45400766       	45401074       	0         	8         	8              	DEL       
chr19       	45594720    	45594856    	45594735       	45594856       	0         	5         	5              	DEL       
chr19       	45775393    	45776370    	45775402       	45776357       	45        	7         	52             	DEL       
chr19       	46314066    	46315468    	46314169       	46315540       	18        	0         	18             	DEL       
chr19       	47024972    	47025445    	47024973       	47025445       	4         	0         	4              	DEL       
chr19       	50574631    	50579254    	50574634       	50579254       	21        	5         	26             	DEL       
chr19       	50903509    	50905116    	50903568       	50905044       	42        	0         	42             	DEL       
chr19       	51273152    	51273465    	51273153       	51273447       	0         	5         	5              	DEL       
chr19       	51672675    	51674260    	51672684       	51674260       	26        	3         	29             	DEL       
chr19       	52385562    	52388133    	52385563       	52388133       	8         	3         	11             	DEL       
chr19       	52445715    	52445822    	52445718       	52445822       	1         	12        	13             	DEL       
chr19       	52580857    	52580993    	52580875       	52580993       	0         	9         	9              	DEL       
chr19       	52683260    	52978632    	52918958       	52920953       	15        	4         	19             	DEL       
chr19       	52683260    	52978632    	52820415       	52856280       	4         	0         	4              	DUP       
chr19       	52683260    	52978632    	52683728       	52978815       	8         	0         	8              	DUP       
chr19       	52683260    	52978632    	52683259       	52978631       	4         	0         	4              	DEL       
chr19       	52683529    	52978766    	52918958       	52920953       	15        	4         	19             	DEL       
chr19       	52683529    	52978766    	52820415       	52856280       	4         	0         	4              	DUP       
chr19       	52683529    	52978766    	52683728       	52978815       	8         	0         	8              	DUP       
chr19       	52683529    	52978766    	52683259       	52978631       	4         	0         	4              	DEL       
chr19       	52820415    	52856282    	52820415       	52856280       	4         	0         	4              	DUP       
chr19       	52918943    	52920953    	52918958       	52920953       	15        	4         	19             	DEL       
chr19       	53113210    	53113529    	53113226       	53113529       	0         	25        	25             	DEL       
chr19       	53185915    	53188698    	53185933       	53188698       	38        	7         	45             	DEL       
chr19       	53438326    	53475626    	53437793       	53475380       	4         	0         	4              	DEL       
chr19       	53438326    	53475626    	53438326       	53475624       	9         	0         	9              	DUP       
chr19       	53438326    	53475626    	53442798       	53480290       	6         	0         	6              	DUP       
chr19       	53442798    	53480292    	53437793       	53475380       	4         	0         	4              	DEL       
chr19       	53442798    	53480292    	53438326       	53475624       	9         	0         	9              	DUP       
chr19       	53442798    	53480292    	53442798       	53480290       	6         	0         	6              	DUP       
chr19       	54219882    	54239639    	54219881       	54239638       	6         	0         	6              	DEL       
chr19       	54219882    	54239639    	54221536       	54241678       	5         	0         	5              	DUP       
chr19       	54221535    	54241678    	54219881       	54239638       	6         	0         	6              	DEL       
chr19       	54221535    	54241678    	54221536       	54241678       	5         	0         	5              	DUP       
chr19       	54749124    	54844896    	54819194       	54853448       	15        	0         	15             	DUP       
chr19       	54749124    	54844896    	54755187       	54770007       	6         	0         	6              	DEL       
chr19       	54749124    	54844896    	54743031       	54774582       	4         	0         	4              	DEL       
chr19       	54749124    	54844896    	54749123       	54844895       	8         	0         	8              	DEL       
chr19       	54749124    	54844896    	54784095       	54848194       	8         	0         	8              	DUP       
chr19       	54749124    	54844896    	54752818       	54848212       	5         	0         	5              	DUP       
chr19       	54749124    	54844896    	54819266       	54852994       	6         	0         	6              	DEL       
chr19       	54752818    	54848214    	54819194       	54853448       	15        	0         	15             	DUP       
chr19       	54752818    	54848214    	54755187       	54770007       	6         	0         	6              	DEL       
chr19       	54752818    	54848214    	54743031       	54774582       	4         	0         	4              	DEL       
chr19       	54752818    	54848214    	54749123       	54844895       	8         	0         	8              	DEL       
chr19       	54752818    	54848214    	54784095       	54848194       	8         	0         	8              	DUP       
chr19       	54752818    	54848214    	54752818       	54848212       	5         	0         	5              	DUP       
chr19       	54752818    	54848214    	54819266       	54852994       	6         	0         	6              	DEL       
chr19       	54784095    	54848196    	54819194       	54853448       	15        	0         	15             	DUP       
chr19       	54784095    	54848196    	54749123       	54844895       	8         	0         	8              	DEL       
chr19       	54784095    	54848196    	54784095       	54848194       	8         	0         	8              	DUP       
chr19       	54784095    	54848196    	54752818       	54848212       	5         	0         	5              	DUP       
chr19       	54784095    	54848196    	54819266       	54852994       	6         	0         	6              	DEL       
chr19       	54819313    	54852995    	54749123       	54844895       	8         	0         	8              	DEL       
chr19       	54819313    	54852995    	54784095       	54848194       	8         	0         	8              	DUP       
chr19       	54819313    	54852995    	54752818       	54848212       	5         	0         	5              	DUP       
chr19       	54819313    	54852995    	54819266       	54852994       	6         	0         	6              	DEL       
chr19       	54819377    	54853534    	54819194       	54853448       	15        	0         	15             	DUP       
chr19       	54819377    	54853534    	54749123       	54844895       	8         	0         	8              	DEL       
chr19       	54819377    	54853534    	54784095       	54848194       	8         	0         	8              	DUP       
chr19       	54819377    	54853534    	54752818       	54848212       	5         	0         	5              	DUP       
chr19       	54819377    	54853534    	54819266       	54852994       	6         	0         	6              	DEL       
chr19       	54964383    	54965555    	54964383       	54965553       	9         	0         	9              	DUP       
chr19       	55093382    	55094225    	55093383       	55094225       	17        	0         	17             	DEL       
chr19       	55207682    	55208942    	55207683       	55208942       	4         	0         	4              	DEL       
chr19       	55761085    	55771456    	55761085       	55771454       	14        	0         	14             	DUP       
chr19       	55761085    	55771456    	55760928       	55771079       	7         	0         	7              	DEL       
chr19       	56200889    	56238926    	56200888       	56238925       	7         	0         	7              	DEL       
chr19       	56355087    	56358553    	56355089       	56358553       	20        	2         	22             	DEL       
chr19       	56600175    	56600494    	56600192       	56600494       	0         	4         	4              	DEL       
chr19       	56963536    	56964241    	56963539       	56964241       	11        	5         	16             	DEL       
chr19       	57523224    	57523452    	57523227       	57523452       	0         	11        	11             	DEL       
chr19       	58106420    	58106761    	58106421       	58106733       	1         	9         	10             	DEL       
chr19       	58523837    	58523932    	58523838       	58523932       	0         	8         	8              	DEL       
chr19       	58585097    	58585253    	58585100       	58585253       	0         	10        	10             	DEL       
chr2        	487945      	488587      	487946         	488587         	4         	0         	4              	DEL       
chr2        	1093942     	1094895     	1093943        	1094895        	9         	0         	9              	DEL       
chr2        	1316702     	1317495     	1316773        	1317732        	9         	0         	9              	DEL       
chr2        	1354236     	1354680     	1354256        	1354725        	6         	0         	6              	DEL       
chr2        	1525551     	1532620     	1525670        	1532598        	17        	0         	17             	DUP       
chr2        	1525551     	1532620     	1530206        	1532818        	7         	0         	7              	DEL       
chr2        	1530193     	1532725     	1525670        	1532598        	17        	0         	17             	DUP       
chr2        	1530193     	1532725     	1530206        	1532818        	7         	0         	7              	DEL       
chr2        	1595924     	1597755     	1596458        	1597661        	5         	0         	5              	DEL       
chr2        	1595924     	1597755     	1595946        	1597920        	6         	0         	6              	DUP       
chr2        	1595946     	1597922     	1596458        	1597661        	5         	0         	5              	DEL       
chr2        	1595946     	1597922     	1595946        	1597920        	6         	0         	6              	DUP       
chr2        	2794999     	2795470     	2795002        	2795470        	2         	9         	11             	DEL       
chr2        	3180397     	3181204     	3180414        	3180887        	4         	0         	4              	DUP       
chr2        	3837621     	3837743     	3837622        	3837743        	0         	9         	9              	DEL       
chr2        	4165172     	4175826     	4165085        	4175888        	13        	0         	13             	DEL       
chr2        	4733700     	4739766     	4733720        	4739766        	28        	17        	45             	DEL       
chr2        	5069042     	5069369     	5069057        	5069369        	3         	16        	19             	DEL       
chr2        	5347634     	5347902     	5347649        	5347902        	0         	11        	11             	DEL       
chr2        	6260375     	6262061     	6260376        	6262061        	23        	8         	31             	DEL       
chr2        	8476663     	8476971     	8476683        	8476971        	1         	22        	23             	DEL       
chr2        	9305151     	9305939     	9305151        	9305937        	4         	0         	4              	DUP       
chr2        	9785342     	9788919     	9785344        	9788919        	46        	16        	62             	DEL       
chr2        	9819091     	9819442     	9819108        	9819442        	1         	18        	19             	DEL       
chr2        	10013340    	10015257    	10012933       	10015255       	13        	0         	13             	DUP       
chr2        	10013340    	10015257    	10013339       	10014869       	9         	0         	9              	DEL       
chr2        	10012784    	10015168    	10012933       	10015255       	13        	0         	13             	DUP       
chr2        	10012784    	10015168    	10013339       	10014869       	9         	0         	9              	DEL       
chr2        	11288653    	11288735    	11288654       	11288735       	0         	6         	6              	DEL       
chr2        	11334625    	11334978    	11334626       	11334978       	0         	8         	8              	DEL       
chr2        	11380446    	11380727    	11380465       	11380714       	2         	19        	21             	DEL       
chr2        	12664284    	12664499    	12664285       	12664501       	0         	5         	5              	DUP       
chr2        	14391166    	14391494    	14391167       	14391494       	1         	6         	7              	DEL       
chr2        	15026160    	15026487    	15026175       	15026487       	2         	5         	7              	DEL       
chr2        	16110982    	16111309    	16110998       	16111309       	1         	5         	6              	DEL       
chr2        	16131403    	16133838    	16131530       	16133708       	20        	0         	20             	DEL       
chr2        	16225141    	16225237    	16225142       	16225237       	2         	6         	8              	INV       
chr2        	16225141    	16225237    	16225124       	16226720       	6         	3         	9              	DUP       
chr2        	16225157    	16226289    	16225142       	16225237       	2         	6         	8              	INV       
chr2        	16225157    	16226289    	16225124       	16226720       	6         	3         	9              	DUP       
chr2        	16225123    	16226720    	16225142       	16225237       	2         	6         	8              	INV       
chr2        	16225123    	16226720    	16224958       	16226496       	6         	0         	6              	DEL       
chr2        	16225123    	16226720    	16225124       	16226720       	6         	3         	9              	DUP       
chr2        	18635927    	18636008    	18635929       	18636007       	0         	7         	7              	DEL       
chr2        	18821607    	18822125    	18821608       	18822125       	3         	3         	6              	DEL       
chr2        	20466903    	20467211    	20466917       	20467211       	0         	5         	5              	DEL       
chr2        	25004750    	25005066    	25004760       	25005066       	2         	10        	12             	DEL       
chr2        	27091022    	27091157    	27091030       	27091157       	0         	11        	11             	DEL       
chr2        	28131052    	28131380    	28131060       	28131380       	1         	4         	5              	DEL       
chr2        	28438797    	28438851    	28438799       	28438851       	0         	4         	4              	DEL       
chr2        	28458473    	28459259    	28458474       	28459259       	4         	0         	4              	DEL       
chr2        	29776357    	29776433    	29776361       	29776433       	0         	22        	22             	DEL       
chr2        	31119858    	31120174    	31119875       	31120174       	0         	12        	12             	DEL       
chr2        	34418562    	34418870    	34418581       	34418870       	0         	14        	14             	DEL       
chr2        	34470761    	34511500    	34470762       	34511500       	16        	1         	17             	DEL       
chr2        	34809369    	34809615    	34809384       	34809615       	0         	16        	16             	DEL       
chr2        	35547199    	35547253    	35547200       	35547253       	0         	9         	9              	DEL       
chr2        	35750951    	35772084    	35750952       	35772084       	4         	0         	4              	DEL       
chr2        	36728516    	36728833    	36728531       	36728833       	2         	17        	19             	DEL       
chr2        	37813767    	37813824    	37813769       	37813824       	0         	10        	10             	DEL       
chr2        	38844334    	38844678    	38844348       	38844679       	3         	20        	23             	DEL       
chr2        	40219805    	40219933    	40219807       	40219933       	0         	24        	24             	DEL       
chr2        	40655354    	40655418    	40655358       	40655418       	0         	12        	12             	DEL       
chr2        	41548825    	41554143    	41548826       	41554143       	37        	21        	58             	DEL       
chr2        	41746000    	41748725    	41746016       	41748725       	51        	18        	69             	DEL       
chr2        	42119118    	42120178    	42119118       	42120178       	45        	0         	45             	DEL       
chr2        	44257088    	44264174    	44257166       	44264187       	20        	0         	20             	DEL       
chr2        	44409094    	44409184    	44409100       	44409168       	0         	19        	19             	DEL       
chr2        	44556461    	44556769    	44556462       	44556769       	2         	2         	4              	DEL       
chr2        	45221268    	45221702    	45221176       	45221703       	7         	5         	12             	INV       
chr2        	46085556    	46085808    	46085558       	46085808       	1         	11        	12             	DEL       
chr2        	46206642    	46206805    	46206658       	46206805       	0         	6         	6              	DEL       
chr2        	46682992    	46683309    	46683011       	46683309       	0         	16        	16             	DEL       
chr2        	48554695    	48557728    	48554713       	48557728       	16        	12        	28             	DEL       
chr2        	48763386    	48764025    	48763387       	48764025       	14        	5         	19             	DEL       
chr2        	49305544    	49317035    	49305543       	49317034       	5         	0         	5              	DEL       
chr2        	49334342    	49334487    	49334345       	49334487       	1         	8         	9              	DEL       
chr2        	49385742    	49386066    	49385759       	49386066       	3         	14        	17             	DEL       
chr2        	51699445    	51700629    	51699449       	51700629       	13        	5         	18             	DEL       
chr2        	52598613    	52598687    	52598614       	52598687       	0         	6         	6              	DEL       
chr2        	53398623    	53400861    	53398634       	53400861       	39        	15        	54             	DEL       
chr2        	53671694    	53671893    	53671695       	53671893       	0         	5         	5              	DEL       
chr2        	54338355    	54340336    	54338356       	54340336       	21        	12        	33             	DEL       
chr2        	54466340    	54466605    	54466357       	54466605       	1         	21        	22             	DEL       
chr2        	60467196    	60468075    	60467197       	60468075       	4         	0         	4              	DEL       
chr2        	61653037    	61653971    	61653039       	61653971       	25        	16        	41             	DEL       
chr2        	62183148    	62183223    	62183161       	62183223       	0         	5         	5              	DEL       
chr2        	65580370    	65580683    	65580385       	65580683       	2         	16        	18             	DEL       
chr2        	67747742    	67747936    	67747745       	67747936       	0         	12        	12             	DEL       
chr2        	67906467    	67906664    	67906497       	67906663       	0         	5         	5              	DEL       
chr2        	69897911    	69898433    	69897921       	69898433       	5         	13        	18             	DEL       
chr2        	70434185    	70435456    	70434207       	70435323       	17        	0         	17             	DEL       
chr2        	74330221    	74331255    	74330248       	74331280       	8         	0         	8              	DUP       
chr2        	76299371    	76301767    	76299386       	76301767       	25        	12        	37             	DEL       
chr2        	76329929    	76330164    	76329931       	76330164       	0         	16        	16             	DEL       
chr2        	76546426    	76548326    	76546427       	76548326       	61        	17        	78             	DEL       
chr2        	76719489    	76719552    	76719478       	76719552       	0         	14        	14             	DEL       
chr2        	77749640    	77749965    	77749658       	77749965       	1         	9         	10             	DEL       
chr2        	77890763    	77891231    	77890765       	77891231       	7         	4         	11             	DEL       
chr2        	78558859    	78558993    	78558876       	78558993       	1         	9         	10             	DEL       
chr2        	78830520    	78830857    	78830532       	78830857       	1         	3         	4              	DEL       
chr2        	78849443    	78854080    	78849446       	78854080       	24        	11        	35             	DEL       
chr2        	80309646    	80309931    	80309657       	80309931       	0         	7         	7              	DEL       
chr2        	82113320    	82113641    	82113337       	82113641       	3         	17        	20             	DEL       
chr2        	84531315    	84531610    	84531329       	84531609       	2         	12        	14             	DEL       
chr2        	85291981    	85292320    	85291998       	85292319       	3         	18        	21             	DEL       
chr2        	87363080    	87364501    	87363080       	87364499       	5         	0         	5              	DUP       
chr2        	88130318    	88130634    	88130329       	88130423       	0         	7         	7              	DEL       
chr2        	88522438    	88522971    	88522439       	88522971       	13        	17        	30             	DEL       
chr2        	88729709    	88732765    	88729728       	88732765       	31        	6         	37             	DEL       
chr2        	88832768    	88859609    	88832769       	88859609       	21        	6         	27             	DEL       
chr2        	88832768    	88859609    	88832768       	89234182       	6         	5         	11             	DEL       
chr2        	88832767    	89234182    	88832769       	88859609       	21        	6         	27             	DEL       
chr2        	88832767    	89234182    	88860919       	89142610       	10        	0         	10             	DEL       
chr2        	88832767    	89234182    	88832768       	89234182       	6         	5         	11             	DEL       
chr2        	88860919    	89142573    	88860919       	89142610       	10        	0         	10             	DEL       
chr2        	89790711    	89795517    	89790765       	89795501       	52        	0         	52             	DEL       
chr2        	89813034    	89819136    	89815309       	89817758       	67        	1         	68             	DEL       
chr2        	89813034    	89819136    	89813045       	89819135       	22        	4         	26             	DUP       
chr2        	89815309    	89817738    	89815309       	89817758       	67        	1         	68             	DEL       
chr2        	91409067    	91411145    	91409066       	91411144       	8         	0         	8              	DEL       
chr2        	92198457    	94052530    	92674310       	92978993       	5         	0         	5              	DUP       
chr2        	92198457    	94052530    	92527024       	93094560       	6         	0         	6              	DEL       
chr2        	92198457    	94052530    	92285643       	93880716       	8         	0         	8              	DEL       
chr2        	92198457    	94052530    	92651173       	92867418       	4         	0         	4              	DEL       
chr2        	92198457    	94052530    	92875179       	92997851       	5         	0         	5              	DEL       
chr2        	92198457    	94052530    	92918554       	93122612       	11        	0         	11             	DEL       
chr2        	92198457    	94052530    	92867157       	93142010       	6         	0         	6              	DUP       
chr2        	92198457    	94052530    	92814310       	93265707       	4         	0         	4              	DEL       
chr2        	92198457    	94052530    	92974999       	93285239       	8         	0         	8              	DUP       
chr2        	92198457    	94052530    	92734869       	93313295       	8         	0         	8              	DUP       
chr2        	92198457    	94052530    	92774788       	93332511       	4         	0         	4              	DEL       
chr2        	92198457    	94052530    	92650917       	93339984       	6         	0         	6              	DUP       
chr2        	92198457    	94052530    	92667695       	93468060       	4         	0         	4              	DUP       
chr2        	92198457    	94052530    	92522712       	93556907       	8         	0         	8              	DUP       
chr2        	92198457    	94052530    	92918455       	93594553       	4         	0         	4              	DEL       
chr2        	92198457    	94052530    	92743177       	93722213       	4         	0         	4              	DUP       
chr2        	92198457    	94052530    	93680570       	93754215       	4         	0         	4              	DEL       
chr2        	92198457    	94052530    	93459667       	93809958       	26        	0         	26             	DEL       
chr2        	92198457    	94052530    	92874984       	93810366       	4         	0         	4              	DUP       
chr2        	92198457    	94052530    	93680284       	93880918       	4         	0         	4              	DUP       
chr2        	92198457    	94052530    	92198458       	94052530       	4         	0         	4              	DEL       
chr2        	92198457    	94052530    	94038881       	94087238       	4         	0         	4              	DUP       
chr2        	92285829    	93880496    	92674310       	92978993       	5         	0         	5              	DUP       
chr2        	92285829    	93880496    	92527024       	93094560       	6         	0         	6              	DEL       
chr2        	92285829    	93880496    	92651173       	92867418       	4         	0         	4              	DEL       
chr2        	92285829    	93880496    	92875179       	92997851       	5         	0         	5              	DEL       
chr2        	92285829    	93880496    	92918554       	93122612       	11        	0         	11             	DEL       
chr2        	92285829    	93880496    	92867157       	93142010       	6         	0         	6              	DUP       
chr2        	92285829    	93880496    	92814310       	93265707       	4         	0         	4              	DEL       
chr2        	92285829    	93880496    	92974999       	93285239       	8         	0         	8              	DUP       
chr2        	92285829    	93880496    	92734869       	93313295       	8         	0         	8              	DUP       
chr2        	92285829    	93880496    	92774788       	93332511       	4         	0         	4              	DEL       
chr2        	92285829    	93880496    	92650917       	93339984       	6         	0         	6              	DUP       
chr2        	92285829    	93880496    	92667695       	93468060       	4         	0         	4              	DUP       
chr2        	92285829    	93880496    	92522712       	93556907       	8         	0         	8              	DUP       
chr2        	92285829    	93880496    	92918455       	93594553       	4         	0         	4              	DEL       
chr2        	92285829    	93880496    	92743177       	93722213       	4         	0         	4              	DUP       
chr2        	92285829    	93880496    	93680570       	93754215       	4         	0         	4              	DEL       
chr2        	92285829    	93880496    	93459667       	93809958       	26        	0         	26             	DEL       
chr2        	92285829    	93880496    	92874984       	93810366       	4         	0         	4              	DUP       
chr2        	92285829    	93880496    	93680284       	93880918       	4         	0         	4              	DUP       
chr2        	92522711    	93556907    	92674310       	92978993       	5         	0         	5              	DUP       
chr2        	92522711    	93556907    	92527024       	93094560       	6         	0         	6              	DEL       
chr2        	92522711    	93556907    	92651173       	92867418       	4         	0         	4              	DEL       
chr2        	92522711    	93556907    	92875179       	92997851       	5         	0         	5              	DEL       
chr2        	92522711    	93556907    	92918554       	93122612       	11        	0         	11             	DEL       
chr2        	92522711    	93556907    	92867157       	93142010       	6         	0         	6              	DUP       
chr2        	92522711    	93556907    	92814310       	93265707       	4         	0         	4              	DEL       
chr2        	92522711    	93556907    	92974999       	93285239       	8         	0         	8              	DUP       
chr2        	92522711    	93556907    	92734869       	93313295       	8         	0         	8              	DUP       
chr2        	92522711    	93556907    	92774788       	93332511       	4         	0         	4              	DEL       
chr2        	92522711    	93556907    	92650917       	93339984       	6         	0         	6              	DUP       
chr2        	92522711    	93556907    	92667695       	93468060       	4         	0         	4              	DUP       
chr2        	92522711    	93556907    	92522712       	93556907       	8         	0         	8              	DUP       
chr2        	92522711    	93556907    	92918455       	93594553       	4         	0         	4              	DEL       
chr2        	92522711    	93556907    	92743177       	93722213       	4         	0         	4              	DUP       
chr2        	92522711    	93556907    	93459667       	93809958       	26        	0         	26             	DEL       
chr2        	92522711    	93556907    	92874984       	93810366       	4         	0         	4              	DUP       
chr2        	92527023    	93094560    	92674310       	92978993       	5         	0         	5              	DUP       
chr2        	92527023    	93094560    	92527024       	93094560       	6         	0         	6              	DEL       
chr2        	92527023    	93094560    	92651173       	92867418       	4         	0         	4              	DEL       
chr2        	92527023    	93094560    	92875179       	92997851       	5         	0         	5              	DEL       
chr2        	92527023    	93094560    	92918554       	93122612       	11        	0         	11             	DEL       
chr2        	92527023    	93094560    	92867157       	93142010       	6         	0         	6              	DUP       
chr2        	92527023    	93094560    	92814310       	93265707       	4         	0         	4              	DEL       
chr2        	92527023    	93094560    	92974999       	93285239       	8         	0         	8              	DUP       
chr2        	92527023    	93094560    	92734869       	93313295       	8         	0         	8              	DUP       
chr2        	92527023    	93094560    	92774788       	93332511       	4         	0         	4              	DEL       
chr2        	92527023    	93094560    	92650917       	93339984       	6         	0         	6              	DUP       
chr2        	92527023    	93094560    	92667695       	93468060       	4         	0         	4              	DUP       
chr2        	92527023    	93094560    	92918455       	93594553       	4         	0         	4              	DEL       
chr2        	92527023    	93094560    	92743177       	93722213       	4         	0         	4              	DUP       
chr2        	92527023    	93094560    	92874984       	93810366       	4         	0         	4              	DUP       
chr2        	92651209    	92867318    	92674310       	92978993       	5         	0         	5              	DUP       
chr2        	92651209    	92867318    	92651173       	92867418       	4         	0         	4              	DEL       
chr2        	92651209    	92867318    	92867157       	93142010       	6         	0         	6              	DUP       
chr2        	92651209    	92867318    	92814310       	93265707       	4         	0         	4              	DEL       
chr2        	92651209    	92867318    	92734869       	93313295       	8         	0         	8              	DUP       
chr2        	92651209    	92867318    	92774788       	93332511       	4         	0         	4              	DEL       
chr2        	92651209    	92867318    	92667695       	93468060       	4         	0         	4              	DUP       
chr2        	92651209    	92867318    	92743177       	93722213       	4         	0         	4              	DUP       
chr2        	92650916    	93339984    	92674310       	92978993       	5         	0         	5              	DUP       
chr2        	92650916    	93339984    	92527024       	93094560       	6         	0         	6              	DEL       
chr2        	92650916    	93339984    	92651173       	92867418       	4         	0         	4              	DEL       
chr2        	92650916    	93339984    	92875179       	92997851       	5         	0         	5              	DEL       
chr2        	92650916    	93339984    	92918554       	93122612       	11        	0         	11             	DEL       
chr2        	92650916    	93339984    	92867157       	93142010       	6         	0         	6              	DUP       
chr2        	92650916    	93339984    	92814310       	93265707       	4         	0         	4              	DEL       
chr2        	92650916    	93339984    	92974999       	93285239       	8         	0         	8              	DUP       
chr2        	92650916    	93339984    	92734869       	93313295       	8         	0         	8              	DUP       
chr2        	92650916    	93339984    	92774788       	93332511       	4         	0         	4              	DEL       
chr2        	92650916    	93339984    	92650917       	93339984       	6         	0         	6              	DUP       
chr2        	92650916    	93339984    	92667695       	93468060       	4         	0         	4              	DUP       
chr2        	92650916    	93339984    	92918455       	93594553       	4         	0         	4              	DEL       
chr2        	92650916    	93339984    	92743177       	93722213       	4         	0         	4              	DUP       
chr2        	92650916    	93339984    	92874984       	93810366       	4         	0         	4              	DUP       
chr2        	92667694    	93468060    	92674310       	92978993       	5         	0         	5              	DUP       
chr2        	92667694    	93468060    	92527024       	93094560       	6         	0         	6              	DEL       
chr2        	92667694    	93468060    	92651173       	92867418       	4         	0         	4              	DEL       
chr2        	92667694    	93468060    	92875179       	92997851       	5         	0         	5              	DEL       
chr2        	92667694    	93468060    	92918554       	93122612       	11        	0         	11             	DEL       
chr2        	92667694    	93468060    	92867157       	93142010       	6         	0         	6              	DUP       
chr2        	92667694    	93468060    	92814310       	93265707       	4         	0         	4              	DEL       
chr2        	92667694    	93468060    	92974999       	93285239       	8         	0         	8              	DUP       
chr2        	92667694    	93468060    	92734869       	93313295       	8         	0         	8              	DUP       
chr2        	92667694    	93468060    	92774788       	93332511       	4         	0         	4              	DEL       
chr2        	92667694    	93468060    	92650917       	93339984       	6         	0         	6              	DUP       
chr2        	92667694    	93468060    	92667695       	93468060       	4         	0         	4              	DUP       
chr2        	92667694    	93468060    	92918455       	93594553       	4         	0         	4              	DEL       
chr2        	92667694    	93468060    	92743177       	93722213       	4         	0         	4              	DUP       
chr2        	92667694    	93468060    	93459667       	93809958       	26        	0         	26             	DEL       
chr2        	92667694    	93468060    	92874984       	93810366       	4         	0         	4              	DUP       
chr2        	92674309    	92978993    	92674310       	92978993       	5         	0         	5              	DUP       
chr2        	92674309    	92978993    	92651173       	92867418       	4         	0         	4              	DEL       
chr2        	92674309    	92978993    	92875179       	92997851       	5         	0         	5              	DEL       
chr2        	92674309    	92978993    	92918554       	93122612       	11        	0         	11             	DEL       
chr2        	92674309    	92978993    	92867157       	93142010       	6         	0         	6              	DUP       
chr2        	92674309    	92978993    	92814310       	93265707       	4         	0         	4              	DEL       
chr2        	92674309    	92978993    	92974999       	93285239       	8         	0         	8              	DUP       
chr2        	92674309    	92978993    	92734869       	93313295       	8         	0         	8              	DUP       
chr2        	92674309    	92978993    	92774788       	93332511       	4         	0         	4              	DEL       
chr2        	92674309    	92978993    	92918455       	93594553       	4         	0         	4              	DEL       
chr2        	92674309    	92978993    	92743177       	93722213       	4         	0         	4              	DUP       
chr2        	92674309    	92978993    	92874984       	93810366       	4         	0         	4              	DUP       
chr2        	92734868    	93313295    	92674310       	92978993       	5         	0         	5              	DUP       
chr2        	92734868    	93313295    	92527024       	93094560       	6         	0         	6              	DEL       
chr2        	92734868    	93313295    	92651173       	92867418       	4         	0         	4              	DEL       
chr2        	92734868    	93313295    	92875179       	92997851       	5         	0         	5              	DEL       
chr2        	92734868    	93313295    	92918554       	93122612       	11        	0         	11             	DEL       
chr2        	92734868    	93313295    	92867157       	93142010       	6         	0         	6              	DUP       
chr2        	92734868    	93313295    	92814310       	93265707       	4         	0         	4              	DEL       
chr2        	92734868    	93313295    	92974999       	93285239       	8         	0         	8              	DUP       
chr2        	92734868    	93313295    	92734869       	93313295       	8         	0         	8              	DUP       
chr2        	92734868    	93313295    	92774788       	93332511       	4         	0         	4              	DEL       
chr2        	92734868    	93313295    	92918455       	93594553       	4         	0         	4              	DEL       
chr2        	92734868    	93313295    	92743177       	93722213       	4         	0         	4              	DUP       
chr2        	92734868    	93313295    	92874984       	93810366       	4         	0         	4              	DUP       
chr2        	92743176    	93722213    	92674310       	92978993       	5         	0         	5              	DUP       
chr2        	92743176    	93722213    	92527024       	93094560       	6         	0         	6              	DEL       
chr2        	92743176    	93722213    	92651173       	92867418       	4         	0         	4              	DEL       
chr2        	92743176    	93722213    	92875179       	92997851       	5         	0         	5              	DEL       
chr2        	92743176    	93722213    	92918554       	93122612       	11        	0         	11             	DEL       
chr2        	92743176    	93722213    	92867157       	93142010       	6         	0         	6              	DUP       
chr2        	92743176    	93722213    	92814310       	93265707       	4         	0         	4              	DEL       
chr2        	92743176    	93722213    	92974999       	93285239       	8         	0         	8              	DUP       
chr2        	92743176    	93722213    	92734869       	93313295       	8         	0         	8              	DUP       
chr2        	92743176    	93722213    	92774788       	93332511       	4         	0         	4              	DEL       
chr2        	92743176    	93722213    	92650917       	93339984       	6         	0         	6              	DUP       
chr2        	92743176    	93722213    	92667695       	93468060       	4         	0         	4              	DUP       
chr2        	92743176    	93722213    	92522712       	93556907       	8         	0         	8              	DUP       
chr2        	92743176    	93722213    	92918455       	93594553       	4         	0         	4              	DEL       
chr2        	92743176    	93722213    	92743177       	93722213       	4         	0         	4              	DUP       
chr2        	92743176    	93722213    	93680570       	93754215       	4         	0         	4              	DEL       
chr2        	92743176    	93722213    	93459667       	93809958       	26        	0         	26             	DEL       
chr2        	92743176    	93722213    	92874984       	93810366       	4         	0         	4              	DUP       
chr2        	92743176    	93722213    	93680284       	93880918       	4         	0         	4              	DUP       
chr2        	92774787    	93332511    	92674310       	92978993       	5         	0         	5              	DUP       
chr2        	92774787    	93332511    	92527024       	93094560       	6         	0         	6              	DEL       
chr2        	92774787    	93332511    	92651173       	92867418       	4         	0         	4              	DEL       
chr2        	92774787    	93332511    	92875179       	92997851       	5         	0         	5              	DEL       
chr2        	92774787    	93332511    	92918554       	93122612       	11        	0         	11             	DEL       
chr2        	92774787    	93332511    	92867157       	93142010       	6         	0         	6              	DUP       
chr2        	92774787    	93332511    	92814310       	93265707       	4         	0         	4              	DEL       
chr2        	92774787    	93332511    	92974999       	93285239       	8         	0         	8              	DUP       
chr2        	92774787    	93332511    	92734869       	93313295       	8         	0         	8              	DUP       
chr2        	92774787    	93332511    	92774788       	93332511       	4         	0         	4              	DEL       
chr2        	92774787    	93332511    	92918455       	93594553       	4         	0         	4              	DEL       
chr2        	92774787    	93332511    	92874984       	93810366       	4         	0         	4              	DUP       
chr2        	92814309    	93265707    	92674310       	92978993       	5         	0         	5              	DUP       
chr2        	92814309    	93265707    	92527024       	93094560       	6         	0         	6              	DEL       
chr2        	92814309    	93265707    	92651173       	92867418       	4         	0         	4              	DEL       
chr2        	92814309    	93265707    	92875179       	92997851       	5         	0         	5              	DEL       
chr2        	92814309    	93265707    	92918554       	93122612       	11        	0         	11             	DEL       
chr2        	92814309    	93265707    	92867157       	93142010       	6         	0         	6              	DUP       
chr2        	92814309    	93265707    	92814310       	93265707       	4         	0         	4              	DEL       
chr2        	92814309    	93265707    	92974999       	93285239       	8         	0         	8              	DUP       
chr2        	92814309    	93265707    	92918455       	93594553       	4         	0         	4              	DEL       
chr2        	92814309    	93265707    	92874984       	93810366       	4         	0         	4              	DUP       
chr2        	92867156    	93142010    	92674310       	92978993       	5         	0         	5              	DUP       
chr2        	92867156    	93142010    	92527024       	93094560       	6         	0         	6              	DEL       
chr2        	92867156    	93142010    	92651173       	92867418       	4         	0         	4              	DEL       
chr2        	92867156    	93142010    	92875179       	92997851       	5         	0         	5              	DEL       
chr2        	92867156    	93142010    	92918554       	93122612       	11        	0         	11             	DEL       
chr2        	92867156    	93142010    	92867157       	93142010       	6         	0         	6              	DUP       
chr2        	92867156    	93142010    	92974999       	93285239       	8         	0         	8              	DUP       
chr2        	92867156    	93142010    	92918455       	93594553       	4         	0         	4              	DEL       
chr2        	92867156    	93142010    	92874984       	93810366       	4         	0         	4              	DUP       
chr2        	92875178    	92997851    	92674310       	92978993       	5         	0         	5              	DUP       
chr2        	92875178    	92997851    	92875179       	92997851       	5         	0         	5              	DEL       
chr2        	92875178    	92997851    	92918554       	93122612       	11        	0         	11             	DEL       
chr2        	92875178    	92997851    	92974999       	93285239       	8         	0         	8              	DUP       
chr2        	92875178    	92997851    	92918455       	93594553       	4         	0         	4              	DEL       
chr2        	92874983    	93810366    	92674310       	92978993       	5         	0         	5              	DUP       
chr2        	92874983    	93810366    	92527024       	93094560       	6         	0         	6              	DEL       
chr2        	92874983    	93810366    	92875179       	92997851       	5         	0         	5              	DEL       
chr2        	92874983    	93810366    	92918554       	93122612       	11        	0         	11             	DEL       
chr2        	92874983    	93810366    	92867157       	93142010       	6         	0         	6              	DUP       
chr2        	92874983    	93810366    	92814310       	93265707       	4         	0         	4              	DEL       
chr2        	92874983    	93810366    	92974999       	93285239       	8         	0         	8              	DUP       
chr2        	92874983    	93810366    	92734869       	93313295       	8         	0         	8              	DUP       
chr2        	92874983    	93810366    	92774788       	93332511       	4         	0         	4              	DEL       
chr2        	92874983    	93810366    	92650917       	93339984       	6         	0         	6              	DUP       
chr2        	92874983    	93810366    	92667695       	93468060       	4         	0         	4              	DUP       
chr2        	92874983    	93810366    	92522712       	93556907       	8         	0         	8              	DUP       
chr2        	92874983    	93810366    	92918455       	93594553       	4         	0         	4              	DEL       
chr2        	92874983    	93810366    	92743177       	93722213       	4         	0         	4              	DUP       
chr2        	92874983    	93810366    	93680570       	93754215       	4         	0         	4              	DEL       
chr2        	92874983    	93810366    	93459667       	93809958       	26        	0         	26             	DEL       
chr2        	92874983    	93810366    	92874984       	93810366       	4         	0         	4              	DUP       
chr2        	92874983    	93810366    	93680284       	93880918       	4         	0         	4              	DUP       
chr2        	92918553    	93122612    	92674310       	92978993       	5         	0         	5              	DUP       
chr2        	92918553    	93122612    	92527024       	93094560       	6         	0         	6              	DEL       
chr2        	92918553    	93122612    	92875179       	92997851       	5         	0         	5              	DEL       
chr2        	92918553    	93122612    	92918554       	93122612       	11        	0         	11             	DEL       
chr2        	92918553    	93122612    	92974999       	93285239       	8         	0         	8              	DUP       
chr2        	92918553    	93122612    	92918455       	93594553       	4         	0         	4              	DEL       
chr2        	92918454    	93594553    	92674310       	92978993       	5         	0         	5              	DUP       
chr2        	92918454    	93594553    	92527024       	93094560       	6         	0         	6              	DEL       
chr2        	92918454    	93594553    	92875179       	92997851       	5         	0         	5              	DEL       
chr2        	92918454    	93594553    	92918554       	93122612       	11        	0         	11             	DEL       
chr2        	92918454    	93594553    	92867157       	93142010       	6         	0         	6              	DUP       
chr2        	92918454    	93594553    	92814310       	93265707       	4         	0         	4              	DEL       
chr2        	92918454    	93594553    	92974999       	93285239       	8         	0         	8              	DUP       
chr2        	92918454    	93594553    	92734869       	93313295       	8         	0         	8              	DUP       
chr2        	92918454    	93594553    	92774788       	93332511       	4         	0         	4              	DEL       
chr2        	92918454    	93594553    	92650917       	93339984       	6         	0         	6              	DUP       
chr2        	92918454    	93594553    	92667695       	93468060       	4         	0         	4              	DUP       
chr2        	92918454    	93594553    	92522712       	93556907       	8         	0         	8              	DUP       
chr2        	92918454    	93594553    	92918455       	93594553       	4         	0         	4              	DEL       
chr2        	92918454    	93594553    	93459667       	93809958       	26        	0         	26             	DEL       
chr2        	92974998    	93285239    	92674310       	92978993       	5         	0         	5              	DUP       
chr2        	92974998    	93285239    	92527024       	93094560       	6         	0         	6              	DEL       
chr2        	92974998    	93285239    	92875179       	92997851       	5         	0         	5              	DEL       
chr2        	92974998    	93285239    	92918554       	93122612       	11        	0         	11             	DEL       
chr2        	92974998    	93285239    	92867157       	93142010       	6         	0         	6              	DUP       
chr2        	92974998    	93285239    	92814310       	93265707       	4         	0         	4              	DEL       
chr2        	92974998    	93285239    	92974999       	93285239       	8         	0         	8              	DUP       
chr2        	93459666    	93809958    	92667695       	93468060       	4         	0         	4              	DUP       
chr2        	93459666    	93809958    	92522712       	93556907       	8         	0         	8              	DUP       
chr2        	93459666    	93809958    	92918455       	93594553       	4         	0         	4              	DEL       
chr2        	93459666    	93809958    	92743177       	93722213       	4         	0         	4              	DUP       
chr2        	93459666    	93809958    	93680570       	93754215       	4         	0         	4              	DEL       
chr2        	93459666    	93809958    	93459667       	93809958       	26        	0         	26             	DEL       
chr2        	93459666    	93809958    	93680284       	93880918       	4         	0         	4              	DUP       
chr2        	93680569    	93754215    	92743177       	93722213       	4         	0         	4              	DUP       
chr2        	93680569    	93754215    	93680570       	93754215       	4         	0         	4              	DEL       
chr2        	93680106    	93881089    	92285643       	93880716       	8         	0         	8              	DEL       
chr2        	93680106    	93881089    	92743177       	93722213       	4         	0         	4              	DUP       
chr2        	93680106    	93881089    	93680570       	93754215       	4         	0         	4              	DEL       
chr2        	93680106    	93881089    	93459667       	93809958       	26        	0         	26             	DEL       
chr2        	93680106    	93881089    	92874984       	93810366       	4         	0         	4              	DUP       
chr2        	93680106    	93881089    	93680284       	93880918       	4         	0         	4              	DUP       
chr2        	94038772    	94087430    	92198458       	94052530       	4         	0         	4              	DEL       
chr2        	94038772    	94087430    	94038881       	94087238       	4         	0         	4              	DUP       
chr2        	94176439    	94186902    	94176427       	94186882       	7         	0         	7              	DUP       
chr2        	94517060    	94517399    	94517061       	94517364       	1         	11        	12             	DEL       
chr2        	94520426    	94537150    	94520447       	94537218       	9         	0         	9              	DEL       
chr2        	94538063    	94539497    	94538064       	94539497       	8         	0         	8              	DEL       
chr2        	94646822    	203251784   	97188515       	97190371       	10        	0         	10             	DEL       
chr2        	94646822    	203251784   	96679099       	96679524       	0         	6         	6              	DEL       
chr2        	94646822    	203251784   	88777883       	97168975       	7         	0         	7              	DUP       
chr2        	94646822    	203251784   	97204347       	97208166       	7         	0         	7              	DEL       
chr2        	94646822    	203251784   	95981476       	97579790       	5         	0         	5              	DEL       
chr2        	94646822    	203251784   	99136517       	99136837       	0         	22        	22             	DEL       
chr2        	94646822    	203251784   	101023110      	101023217      	0         	4         	4              	DEL       
chr2        	94646822    	203251784   	101358752      	101359074      	3         	14        	17             	DEL       
chr2        	94646822    	203251784   	101481391      	101481703      	1         	11        	12             	DEL       
chr2        	94646822    	203251784   	102350692      	102352886      	4         	0         	4              	DEL       
chr2        	94646822    	203251784   	102706037      	102706359      	1         	17        	18             	DEL       
chr2        	94646822    	203251784   	103331756      	103331907      	0         	11        	11             	DEL       
chr2        	94646822    	203251784   	104824496      	104824668      	0         	4         	4              	DUP       
chr2        	94646822    	203251784   	106078622      	106079438      	30        	15        	45             	DEL       
chr2        	94646822    	203251784   	106314086      	106314173      	0         	15        	15             	DEL       
chr2        	94646822    	203251784   	106322018      	106322331      	1         	3         	4              	DEL       
chr2        	94646822    	203251784   	109186997      	109187155      	0         	13        	13             	DEL       
chr2        	94646822    	203251784   	109520610      	109520914      	3         	4         	7              	DEL       
chr2        	94646822    	203251784   	110818831      	110819059      	0         	7         	7              	DEL       
chr2        	94646822    	203251784   	113393764      	113396038      	14        	0         	14             	DEL       
chr2        	94646822    	203251784   	114870530      	114871266      	18        	6         	24             	DEL       
chr2        	94646822    	203251784   	116301762      	116302085      	2         	10        	12             	DEL       
chr2        	94646822    	203251784   	116482201      	116482270      	0         	12        	12             	DEL       
chr2        	94646822    	203251784   	117135487      	117135813      	1         	8         	9              	DEL       
chr2        	94646822    	203251784   	117568026      	117568787      	12        	0         	12             	DUP       
chr2        	94646822    	203251784   	117982092      	117982198      	0         	4         	4              	DEL       
chr2        	94646822    	203251784   	119659503      	119660919      	5         	5         	10             	DUP       
chr2        	94646822    	203251784   	119659624      	119660919      	6         	13        	19             	DEL       
chr2        	94646822    	203251784   	121299296      	121300430      	15        	0         	15             	DEL       
chr2        	94646822    	203251784   	121384048      	121384145      	0         	5         	5              	DEL       
chr2        	94646822    	203251784   	121866179      	121866233      	0         	4         	4              	DEL       
chr2        	94646822    	203251784   	122526667      	122536997      	19        	11        	30             	DUP       
chr2        	94646822    	203251784   	123412680      	123413010      	2         	12        	14             	DEL       
chr2        	94646822    	203251784   	125685674      	125694254      	37        	20        	57             	DEL       
chr2        	94646822    	203251784   	126917182      	126919696      	41        	19        	60             	DEL       
chr2        	94646822    	203251784   	127979504      	127979588      	0         	21        	21             	DEL       
chr2        	94646822    	203251784   	154039258      	154042665      	29        	10        	39             	DEL       
chr2        	94646822    	203251784   	169785008      	169787441      	34        	10        	44             	DEL       
chr2        	94646822    	203251784   	128113698      	128113995      	2         	22        	24             	DEL       
chr2        	94646822    	203251784   	128768668      	128768768      	0         	4         	4              	DEL       
chr2        	94646822    	203251784   	129937450      	129937683      	0         	6         	6              	DEL       
chr2        	94646822    	203251784   	130062646      	130063790      	5         	0         	5              	DEL       
chr2        	94646822    	203251784   	130066572      	130067435      	6         	0         	6              	DEL       
chr2        	94646822    	203251784   	130665154      	130668251      	5         	0         	5              	DUP       
chr2        	94646822    	203251784   	131129003      	131129733      	6         	5         	11             	INV       
chr2        	94646822    	203251784   	131577661      	131577758      	0         	7         	7              	DEL       
chr2        	94646822    	203251784   	133702708      	133703000      	1         	11        	12             	DEL       
chr2        	94646822    	203251784   	134209146      	134212559      	18        	10        	28             	DEL       
chr2        	94646822    	203251784   	137089329      	137089423      	0         	4         	4              	DEL       
chr2        	94646822    	203251784   	137487734      	137488062      	0         	18        	18             	DEL       
chr2        	94646822    	203251784   	137732552      	137732922      	0         	12        	12             	DEL       
chr2        	94646822    	203251784   	141129952      	141130128      	0         	8         	8              	DUP       
chr2        	94646822    	203251784   	141593434      	141593754      	3         	19        	22             	DEL       
chr2        	94646822    	203251784   	141638488      	141639138      	12        	0         	12             	DEL       
chr2        	94646822    	203251784   	146084836      	146084981      	1         	4         	5              	DEL       
chr2        	94646822    	203251784   	146105053      	146119294      	32        	11        	43             	DEL       
chr2        	94646822    	203251784   	149902795      	149903107      	0         	7         	7              	DEL       
chr2        	94646822    	203251784   	151046575      	151046845      	0         	19        	19             	DEL       
chr2        	94646822    	203251784   	151184691      	151184978      	1         	8         	9              	DEL       
chr2        	94646822    	203251784   	151760787      	151761089      	1         	18        	19             	DEL       
chr2        	94646822    	203251784   	152120171      	152120257      	0         	5         	5              	DEL       
chr2        	94646822    	203251784   	152296892      	152296974      	0         	20        	20             	DEL       
chr2        	94646822    	203251784   	153208066      	153208158      	0         	14        	14             	DEL       
chr2        	94646822    	203251784   	153555194      	153555493      	1         	19        	20             	DEL       
chr2        	94646822    	203251784   	153638422      	153638639      	0         	8         	8              	DEL       
chr2        	94646822    	203251784   	156415874      	156416043      	0         	22        	22             	DEL       
chr2        	94646822    	203251784   	157576837      	157577154      	2         	21        	23             	DEL       
chr2        	94646822    	203251784   	157862588      	157862884      	0         	23        	23             	DEL       
chr2        	94646822    	203251784   	159283568      	159283663      	0         	5         	5              	DEL       
chr2        	94646822    	203251784   	159292615      	159295137      	48        	16        	64             	DEL       
chr2        	94646822    	203251784   	159999352      	159999663      	2         	17        	19             	DEL       
chr2        	94646822    	203251784   	160939099      	160939413      	1         	15        	16             	DEL       
chr2        	94646822    	203251784   	161475760      	161477530      	45        	17        	62             	DEL       
chr2        	94646822    	203251784   	162809911      	162810213      	0         	14        	14             	DEL       
chr2        	94646822    	203251784   	165411013      	165411321      	0         	24        	24             	DEL       
chr2        	94646822    	203251784   	166689431      	166690612      	12        	0         	12             	DEL       
chr2        	94646822    	203251784   	168039311      	168039616      	2         	24        	26             	DEL       
chr2        	94646822    	203251784   	168538967      	168539264      	3         	19        	22             	DEL       
chr2        	94646822    	203251784   	168547485      	168547544      	0         	8         	8              	DEL       
chr2        	94646822    	203251784   	168749623      	168749697      	0         	6         	6              	DEL       
chr2        	94646822    	203251784   	169890550      	169891076      	7         	10        	17             	DEL       
chr2        	94646822    	203251784   	170135515      	170135811      	3         	27        	30             	DEL       
chr2        	94646822    	203251784   	170483378      	170483647      	1         	12        	13             	DEL       
chr2        	94646822    	203251784   	172139535      	172142746      	12        	8         	20             	DEL       
chr2        	94646822    	203251784   	172283311      	172283371      	0         	10        	10             	DEL       
chr2        	94646822    	203251784   	172315268      	172321376      	29        	6         	35             	DEL       
chr2        	94646822    	203251784   	174225912      	174226217      	1         	22        	23             	DEL       
chr2        	94646822    	203251784   	176400917      	176407312      	20        	9         	29             	DEL       
chr2        	94646822    	203251784   	177422909      	177423333      	0         	20        	20             	DEL       
chr2        	94646822    	203251784   	177990732      	177992485      	24        	3         	27             	DEL       
chr2        	94646822    	203251784   	178432112      	178436144      	11        	0         	11             	DEL       
chr2        	94646822    	203251784   	178432088      	178441609      	4         	0         	4              	DEL       
chr2        	94646822    	203251784   	178432255      	178443265      	14        	0         	14             	DEL       
chr2        	94646822    	203251784   	178432255      	178444420      	4         	0         	4              	DEL       
chr2        	94646822    	203251784   	178436318      	178450239      	4         	0         	4              	DEL       
chr2        	94646822    	203251784   	181123328      	181123511      	0         	6         	6              	DUP       
chr2        	94646822    	203251784   	181491256      	181491559      	1         	21        	22             	DEL       
chr2        	94646822    	203251784   	181700528      	181700841      	0         	17        	17             	DEL       
chr2        	94646822    	203251784   	181992189      	181992870      	14        	9         	23             	DEL       
chr2        	94646822    	203251784   	182451095      	182451394      	1         	13        	14             	DEL       
chr2        	94646822    	203251784   	183385253      	183385581      	2         	17        	19             	DEL       
chr2        	94646822    	203251784   	187351003      	187351298      	0         	16        	16             	DEL       
chr2        	94646822    	203251784   	187640459      	187640812      	1         	7         	8              	DEL       
chr2        	94646822    	203251784   	187807161      	187807223      	0         	21        	21             	DEL       
chr2        	94646822    	203251784   	190816068      	190816148      	1         	16        	17             	DEL       
chr2        	94646822    	203251784   	191694688      	191694998      	0         	7         	7              	DEL       
chr2        	94646822    	203251784   	191697479      	191697797      	3         	16        	19             	DEL       
chr2        	94646822    	203251784   	192490688      	192490982      	1         	25        	26             	DEL       
chr2        	94646822    	203251784   	193533783      	193534108      	2         	13        	15             	DEL       
chr2        	94646822    	203251784   	193824778      	193834041      	14        	8         	22             	DEL       
chr2        	94646822    	203251784   	194048804      	194048888      	0         	8         	8              	DEL       
chr2        	94646822    	203251784   	194432414      	194433720      	31        	3         	34             	DEL       
chr2        	94646822    	203251784   	194612914      	194613010      	0         	10        	10             	DEL       
chr2        	94646822    	203251784   	194703208      	194703975      	6         	0         	6              	DEL       
chr2        	94646822    	203251784   	195166596      	195166890      	2         	19        	21             	DEL       
chr2        	94646822    	203251784   	195187107      	195187360      	0         	17        	17             	DEL       
chr2        	94646822    	203251784   	195350092      	195350502      	3         	18        	21             	DEL       
chr2        	94646822    	203251784   	195871703      	195871966      	0         	11        	11             	DEL       
chr2        	94646822    	203251784   	196749908      	196750224      	0         	12        	12             	DEL       
chr2        	94646822    	203251784   	198029790      	198029925      	0         	4         	4              	DEL       
chr2        	94646822    	203251784   	199447732      	199447956      	2         	12        	14             	DEL       
chr2        	94646822    	203251784   	199624894      	199625346      	5         	10        	15             	DEL       
chr2        	94646822    	203251784   	199665677      	199665756      	0         	17        	17             	DEL       
chr2        	94646822    	203251784   	200826632      	200826720      	0         	6         	6              	DEL       
chr2        	94646822    	203251784   	201281935      	201284717      	71        	28        	99             	DEL       
chr2        	94646822    	203251784   	201856941      	201857246      	1         	15        	16             	DEL       
chr2        	94646822    	203251784   	94646821       	203251783      	5         	0         	5              	DEL       
chr2        	97188516    	97190372    	97188515       	97190371       	10        	0         	10             	DEL       
chr2        	99136500    	99136837    	99136517       	99136837       	0         	22        	22             	DEL       
chr2        	101023081   	101023196   	101023110      	101023217      	0         	4         	4              	DEL       
chr2        	101358740   	101359074   	101358752      	101359074      	3         	14        	17             	DEL       
chr2        	101481375   	101481703   	101481391      	101481703      	1         	11        	12             	DEL       
chr2        	102350688   	102352750   	102350692      	102352886      	4         	0         	4              	DEL       
chr2        	102706023   	102706359   	102706037      	102706359      	1         	17        	18             	DEL       
chr2        	103331740   	103331907   	103331756      	103331907      	0         	11        	11             	DEL       
chr2        	104824495   	104824668   	104824496      	104824668      	0         	4         	4              	DUP       
chr2        	106078620   	106079438   	106078622      	106079438      	30        	15        	45             	DEL       
chr2        	106314070   	106314173   	106314086      	106314173      	0         	15        	15             	DEL       
chr2        	106321994   	106322331   	106322018      	106322331      	1         	3         	4              	DEL       
chr2        	109186995   	109187155   	109186997      	109187155      	0         	13        	13             	DEL       
chr2        	109520576   	109520914   	109520610      	109520914      	3         	4         	7              	DEL       
chr2        	110818826   	110819059   	110818831      	110819059      	0         	7         	7              	DEL       
chr2        	113393748   	113396034   	113393764      	113396038      	14        	0         	14             	DEL       
chr2        	114870526   	114871266   	114870530      	114871266      	18        	6         	24             	DEL       
chr2        	116301761   	116302085   	116301762      	116302085      	2         	10        	12             	DEL       
chr2        	116482199   	116482270   	116482201      	116482270      	0         	12        	12             	DEL       
chr2        	117135473   	117135814   	117135487      	117135813      	1         	8         	9              	DEL       
chr2        	117568026   	117568789   	117568026      	117568787      	12        	0         	12             	DUP       
chr2        	119659502   	119660912   	119659503      	119660919      	5         	5         	10             	DUP       
chr2        	119659502   	119660912   	119659624      	119660919      	6         	13        	19             	DEL       
chr2        	121299295   	121300430   	121299296      	121300430      	15        	0         	15             	DEL       
chr2        	121384018   	121384145   	121384048      	121384145      	0         	5         	5              	DEL       
chr2        	121866178   	121866233   	121866179      	121866233      	0         	4         	4              	DEL       
chr2        	122526666   	122536995   	122526667      	122536997      	19        	11        	30             	DUP       
chr2        	123412679   	123413010   	123412680      	123413010      	2         	12        	14             	DEL       
chr2        	125685669   	125694254   	125685674      	125694254      	37        	20        	57             	DEL       
chr2        	126917179   	126919696   	126917182      	126919696      	41        	19        	60             	DEL       
chr2        	127979498   	127979588   	127979504      	127979588      	0         	21        	21             	DEL       
chr2        	128113684   	128113995   	128113698      	128113995      	2         	22        	24             	DEL       
chr2        	129937442   	129937683   	129937450      	129937683      	0         	6         	6              	DEL       
chr2        	130062645   	130063790   	130062646      	130063790      	5         	0         	5              	DEL       
chr2        	130066571   	130067435   	130066572      	130067435      	6         	0         	6              	DEL       
chr2        	130665154   	130668253   	130665154      	130668251      	5         	0         	5              	DUP       
chr2        	131129002   	131129733   	131129003      	131129733      	6         	5         	11             	INV       
chr2        	131577651   	131577758   	131577661      	131577758      	0         	7         	7              	DEL       
chr2        	133702692   	133703000   	133702708      	133703000      	1         	11        	12             	DEL       
chr2        	134209128   	134212560   	134209146      	134212559      	18        	10        	28             	DEL       
chr2        	137487717   	137488062   	137487734      	137488062      	0         	18        	18             	DEL       
chr2        	137732549   	137732922   	137732552      	137732922      	0         	12        	12             	DEL       
chr2        	141129951   	141130128   	141129952      	141130128      	0         	8         	8              	DUP       
chr2        	141593428   	141593754   	141593434      	141593754      	3         	19        	22             	DEL       
chr2        	141638487   	141639138   	141638488      	141639138      	12        	0         	12             	DEL       
chr2        	146084833   	146084981   	146084836      	146084981      	1         	4         	5              	DEL       
chr2        	146105050   	146119294   	146105053      	146119294      	32        	11        	43             	DEL       
chr2        	149902785   	149903107   	149902795      	149903107      	0         	7         	7              	DEL       
chr2        	151046568   	151046845   	151046575      	151046845      	0         	19        	19             	DEL       
chr2        	151184689   	151184978   	151184691      	151184978      	1         	8         	9              	DEL       
chr2        	151760773   	151761089   	151760787      	151761089      	1         	18        	19             	DEL       
chr2        	152120155   	152120257   	152120171      	152120257      	0         	5         	5              	DEL       
chr2        	152296886   	152296974   	152296892      	152296974      	0         	20        	20             	DEL       
chr2        	153208060   	153208164   	153208066      	153208158      	0         	14        	14             	DEL       
chr2        	153555177   	153555493   	153555194      	153555493      	1         	19        	20             	DEL       
chr2        	153638421   	153638639   	153638422      	153638639      	0         	8         	8              	DEL       
chr2        	154039257   	154042665   	154039258      	154042665      	29        	10        	39             	DEL       
chr2        	156415863   	156416043   	156415874      	156416043      	0         	22        	22             	DEL       
chr2        	157576824   	157577154   	157576837      	157577154      	2         	21        	23             	DEL       
chr2        	157862572   	157862884   	157862588      	157862884      	0         	23        	23             	DEL       
chr2        	159283567   	159283663   	159283568      	159283663      	0         	5         	5              	DEL       
chr2        	159292605   	159295137   	159292615      	159295137      	48        	16        	64             	DEL       
chr2        	159999339   	159999663   	159999352      	159999663      	2         	17        	19             	DEL       
chr2        	160939088   	160939413   	160939099      	160939413      	1         	15        	16             	DEL       
chr2        	161475755   	161477530   	161475760      	161477530      	45        	17        	62             	DEL       
chr2        	162809897   	162810213   	162809911      	162810213      	0         	14        	14             	DEL       
chr2        	165410997   	165411321   	165411013      	165411321      	0         	24        	24             	DEL       
chr2        	166689454   	166690614   	166689431      	166690612      	12        	0         	12             	DEL       
chr2        	168039295   	168039616   	168039311      	168039616      	2         	24        	26             	DEL       
chr2        	168538951   	168539264   	168538967      	168539264      	3         	19        	22             	DEL       
chr2        	168547482   	168547544   	168547485      	168547544      	0         	8         	8              	DEL       
chr2        	168749620   	168749697   	168749623      	168749697      	0         	6         	6              	DEL       
chr2        	169784996   	169787441   	169785008      	169787441      	34        	10        	44             	DEL       
chr2        	169890549   	169891076   	169890550      	169891076      	7         	10        	17             	DEL       
chr2        	170135501   	170135811   	170135515      	170135811      	3         	27        	30             	DEL       
chr2        	170483368   	170483647   	170483378      	170483647      	1         	12        	13             	DEL       
chr2        	172139519   	172142752   	172139535      	172142746      	12        	8         	20             	DEL       
chr2        	172283310   	172283371   	172283311      	172283371      	0         	10        	10             	DEL       
chr2        	172315250   	172321376   	172315268      	172321376      	29        	6         	35             	DEL       
chr2        	174225896   	174226217   	174225912      	174226217      	1         	22        	23             	DEL       
chr2        	176400912   	176407312   	176400917      	176407312      	20        	9         	29             	DEL       
chr2        	177422908   	177423333   	177422909      	177423333      	0         	20        	20             	DEL       
chr2        	177990727   	177992485   	177990732      	177992485      	24        	3         	27             	DEL       
chr2        	178432253   	178436144   	178432112      	178436144      	11        	0         	11             	DEL       
chr2        	178432253   	178436144   	178432255      	178443265      	14        	0         	14             	DEL       
chr2        	178432253   	178436144   	178432255      	178444420      	4         	0         	4              	DEL       
chr2        	178432256   	178443266   	178432112      	178436144      	11        	0         	11             	DEL       
chr2        	178432256   	178443266   	178432088      	178441609      	4         	0         	4              	DEL       
chr2        	178432256   	178443266   	178432255      	178443265      	14        	0         	14             	DEL       
chr2        	178432256   	178443266   	178432255      	178444420      	4         	0         	4              	DEL       
chr2        	178432256   	178443266   	178436318      	178450239      	4         	0         	4              	DEL       
chr2        	181123339   	181123511   	181123328      	181123511      	0         	6         	6              	DUP       
chr2        	181491243   	181491559   	181491256      	181491559      	1         	21        	22             	DEL       
chr2        	181700512   	181700841   	181700528      	181700841      	0         	17        	17             	DEL       
chr2        	181992186   	181992870   	181992189      	181992870      	14        	9         	23             	DEL       
chr2        	182451078   	182451394   	182451095      	182451394      	1         	13        	14             	DEL       
chr2        	183385237   	183385581   	183385253      	183385581      	2         	17        	19             	DEL       
chr2        	187350990   	187351298   	187351003      	187351298      	0         	16        	16             	DEL       
chr2        	187640458   	187640812   	187640459      	187640812      	1         	7         	8              	DEL       
chr2        	187807159   	187807223   	187807161      	187807223      	0         	21        	21             	DEL       
chr2        	190816052   	190816148   	190816068      	190816148      	1         	16        	17             	DEL       
chr2        	191694676   	191695005   	191694688      	191694998      	0         	7         	7              	DEL       
chr2        	191697461   	191697797   	191697479      	191697797      	3         	16        	19             	DEL       
chr2        	192490677   	192490982   	192490688      	192490982      	1         	25        	26             	DEL       
chr2        	193533767   	193534108   	193533783      	193534108      	2         	13        	15             	DEL       
chr2        	193824776   	193834041   	193824778      	193834041      	14        	8         	22             	DEL       
chr2        	194048803   	194048883   	194048804      	194048888      	0         	8         	8              	DEL       
chr2        	194432410   	194433720   	194432414      	194433720      	31        	3         	34             	DEL       
chr2        	194612902   	194613010   	194612914      	194613010      	0         	10        	10             	DEL       
chr2        	194703207   	194703975   	194703208      	194703975      	6         	0         	6              	DEL       
chr2        	195166584   	195166890   	195166596      	195166890      	2         	19        	21             	DEL       
chr2        	195187089   	195187360   	195187107      	195187360      	0         	17        	17             	DEL       
chr2        	195350089   	195350502   	195350092      	195350502      	3         	18        	21             	DEL       
chr2        	195871686   	195871966   	195871703      	195871966      	0         	11        	11             	DEL       
chr2        	196749891   	196750224   	196749908      	196750224      	0         	12        	12             	DEL       
chr2        	198029787   	198029925   	198029790      	198029925      	0         	4         	4              	DEL       
chr2        	199447731   	199447956   	199447732      	199447956      	2         	12        	14             	DEL       
chr2        	199624893   	199625346   	199624894      	199625346      	5         	10        	15             	DEL       
chr2        	199665662   	199665756   	199665677      	199665756      	0         	17        	17             	DEL       
chr2        	200826626   	200826720   	200826632      	200826720      	0         	6         	6              	DEL       
chr2        	201281924   	201284717   	201281935      	201284717      	71        	28        	99             	DEL       
chr2        	201856924   	201857246   	201856941      	201857246      	1         	15        	16             	DEL       
chr2        	205866457   	205866781   	205866475      	205866781      	1         	7         	8              	DEL       
chr2        	205980473   	205980590   	205980476      	205980590      	0         	5         	5              	DEL       
chr2        	205988744   	205988924   	205988775      	205988924      	0         	7         	7              	DEL       
chr2        	207609626   	207612024   	207609771      	207612060      	37        	10        	47             	DEL       
chr2        	207702499   	207702805   	207702500      	207702805      	1         	14        	15             	DEL       
chr2        	208094398   	208094726   	208094399      	208094726      	2         	2         	4              	DEL       
chr2        	208196432   	208196753   	208196444      	208196753      	1         	23        	24             	DEL       
chr2        	209050817   	209050917   	209050832      	209050917      	0         	10        	10             	DEL       
chr2        	209078121   	209084215   	209078120      	209084214      	4         	0         	4              	DEL       
chr2        	211686519   	211686817   	211686535      	211686817      	0         	15        	15             	DEL       
chr2        	212709946   	212710253   	212709962      	212710253      	2         	20        	22             	DEL       
chr2        	214009978   	214011489   	214009981      	214011489      	27        	13        	40             	DEL       
chr2        	214864036   	214866107   	214864039      	214866107      	29        	12        	41             	DEL       
chr2        	218309198   	218309484   	218309202      	218309484      	0         	6         	6              	DEL       
chr2        	219456892   	219456961   	219456893      	219456961      	0         	23        	23             	DEL       
chr2        	220481210   	220481539   	220481216      	220481532      	0         	5         	5              	DEL       
chr2        	221018253   	221018450   	221018256      	221018450      	0         	7         	7              	DEL       
chr2        	222616970   	222617260   	222616987      	222617260      	0         	9         	9              	DEL       
chr2        	222895459   	222897953   	222895473      	222897953      	29        	17        	46             	DEL       
chr2        	222932639   	222932957   	222932649      	222932957      	3         	17        	20             	DEL       
chr2        	223000370   	223005159   	223000372      	223005159      	14        	7         	21             	DEL       
chr2        	224428232   	224429234   	224428233      	224429234      	4         	0         	4              	DEL       
chr2        	224858362   	224858435   	224858365      	224858435      	0         	14        	14             	DEL       
chr2        	226300707   	226306453   	226300710      	226306453      	14        	8         	22             	DEL       
chr2        	226469498   	226470756   	226469499      	226470756      	7         	0         	7              	DEL       
chr2        	228399627   	228403620   	228399630      	228403620      	56        	25        	81             	DEL       
chr2        	230343094   	230343662   	230343095      	230343662      	16        	14        	30             	DEL       
chr2        	230460578   	230460922   	230460594      	230460922      	4         	17        	21             	DEL       
chr2        	230536748   	230536805   	230536750      	230536805      	0         	11        	11             	DEL       
chr2        	231131461   	231131786   	231131481      	231131786      	3         	27        	30             	DEL       
chr2        	232380230   	232408116   	232380230      	232408114      	10        	0         	10             	DUP       
chr2        	232468007   	232468770   	232468008      	232468770      	31        	13        	44             	DEL       
chr2        	232499835   	232500029   	232499838      	232500029      	0         	8         	8              	DEL       
chr2        	232803660   	232803966   	232803676      	232803966      	2         	20        	22             	DEL       
chr2        	235038237   	235038395   	235038257      	235038395      	0         	17        	17             	DEL       
chr2        	238053985   	238054082   	238053994      	238054082      	0         	15        	15             	DEL       
chr2        	238500729   	238501056   	238500740      	238501056      	0         	21        	21             	DEL       
chr2        	238870929   	238871643   	238870930      	238871643      	4         	0         	4              	DEL       
chr2        	239719041   	239719555   	239719041      	239719553      	4         	0         	4              	DUP       
chr2        	240019521   	240019844   	240019537      	240019844      	0         	7         	7              	DEL       
chr2        	240042080   	240042739   	240042081      	240042739      	10        	0         	10             	DEL       
chr2        	240308841   	240309711   	240308828      	240309657      	17        	0         	17             	DUP       
chr2        	240843014   	240843501   	240842607      	240843488      	10        	0         	10             	DEL       
chr2        	241471926   	241472107   	241471927      	241472107      	0         	7         	7              	DEL       
chr2        	241590236   	241591227   	241590319      	241591225      	4         	0         	4              	DUP       
chr2        	242046606   	242047576   	242046607      	242047576      	10        	0         	10             	DEL       
chr20       	1301713     	1302521     	1301714        	1302521        	5         	0         	5              	DEL       
chr20       	1580520     	1613456     	1580451        	1613491        	18        	0         	18             	DEL       
chr20       	2014854     	2016886     	2014855        	2016886        	31        	14        	45             	DEL       
chr20       	2822500     	2825763     	2822516        	2825763        	46        	24        	70             	DEL       
chr20       	2883354     	2883677     	2883370        	2883677        	1         	29        	30             	DEL       
chr20       	3057219     	3057536     	3057234        	3057536        	0         	5         	5              	DEL       
chr20       	5553898     	5554275     	5553901        	5554275        	4         	12        	16             	DEL       
chr20       	5962340     	5962670     	5962354        	5962670        	0         	7         	7              	DEL       
chr20       	6044986     	6046980     	6045043        	6046896        	17        	0         	17             	DEL       
chr20       	6170297     	6170630     	6170312        	6170630        	2         	20        	22             	DEL       
chr20       	7293688     	7294002     	7293703        	7294002        	1         	17        	18             	DEL       
chr20       	7718402     	7722233     	7718236        	7722233        	6         	0         	6              	DEL       
chr20       	8206969     	8207153     	8206975        	8207153        	0         	12        	12             	DEL       
chr20       	10807562    	10808699    	10807563       	10808699       	9         	0         	9              	INV       
chr20       	14548421    	14548735    	14548436       	14548735       	2         	14        	16             	DEL       
chr20       	15021164    	15021278    	15021165       	15021248       	0         	5         	5              	DEL       
chr20       	16098403    	16104724    	16098357       	16104724       	27        	5         	32             	DEL       
chr20       	17122805    	17123153    	17122806       	17123128       	0         	14        	14             	DEL       
chr20       	17303441    	17303526    	17303455       	17303516       	0         	11        	11             	DEL       
chr20       	19080771    	19081085    	19080786       	19081085       	1         	6         	7              	DEL       
chr20       	21305451    	21308134    	21305488       	21308111       	40        	0         	40             	DEL       
chr20       	21869263    	21869551    	21869265       	21869551       	0         	16        	16             	DEL       
chr20       	24923060    	24923779    	24923063       	24923779       	21        	1         	22             	DEL       
chr20       	26279947    	26281142    	26279995       	26281107       	21        	0         	21             	DEL       
chr20       	26316950    	26322074    	26317014       	26322066       	24        	0         	24             	DEL       
chr20       	26364011    	26365977    	26364240       	26366087       	5         	0         	5              	DEL       
chr20       	26364011    	26365977    	26365418       	26369240       	5         	0         	5              	DUP       
chr20       	26365414    	26369276    	26364240       	26366087       	5         	0         	5              	DEL       
chr20       	26365414    	26369276    	26365418       	26369240       	5         	0         	5              	DUP       
chr20       	26381869    	28318184    	26544632       	26554987       	5         	0         	5              	DUP       
chr20       	26381869    	28318184    	26545205       	26556910       	8         	0         	8              	DEL       
chr20       	26381869    	28318184    	26437431       	26557028       	7         	0         	7              	DEL       
chr20       	26381869    	28318184    	26517127       	26557370       	5         	0         	5              	DUP       
chr20       	26381869    	28318184    	26517691       	26596364       	4         	0         	4              	DEL       
chr20       	26381869    	28318184    	26486386       	26599840       	15        	0         	15             	DEL       
chr20       	26381869    	28318184    	26608346       	26631424       	15        	0         	15             	DEL       
chr20       	26381869    	28318184    	26631783       	26634151       	5         	0         	5              	DEL       
chr20       	26381869    	28318184    	28044430       	28214032       	4         	0         	4              	DUP       
chr20       	26381869    	28318184    	26381870       	28318184       	5         	0         	5              	DEL       
chr20       	26381869    	28318184    	26382672       	28318425       	6         	0         	6              	DUP       
chr20       	26382671    	28318425    	26544632       	26554987       	5         	0         	5              	DUP       
chr20       	26382671    	28318425    	26545205       	26556910       	8         	0         	8              	DEL       
chr20       	26382671    	28318425    	26437431       	26557028       	7         	0         	7              	DEL       
chr20       	26382671    	28318425    	26517127       	26557370       	5         	0         	5              	DUP       
chr20       	26382671    	28318425    	26517691       	26596364       	4         	0         	4              	DEL       
chr20       	26382671    	28318425    	26486386       	26599840       	15        	0         	15             	DEL       
chr20       	26382671    	28318425    	26608346       	26631424       	15        	0         	15             	DEL       
chr20       	26382671    	28318425    	26631783       	26634151       	5         	0         	5              	DEL       
chr20       	26382671    	28318425    	28044430       	28214032       	4         	0         	4              	DUP       
chr20       	26382671    	28318425    	26381870       	28318184       	5         	0         	5              	DEL       
chr20       	26382671    	28318425    	26382672       	28318425       	6         	0         	6              	DUP       
chr20       	26437650    	26556835    	26544632       	26554987       	5         	0         	5              	DUP       
chr20       	26437650    	26556835    	26545205       	26556910       	8         	0         	8              	DEL       
chr20       	26437650    	26556835    	26517127       	26557370       	5         	0         	5              	DUP       
chr20       	26437650    	26556835    	26517691       	26596364       	4         	0         	4              	DEL       
chr20       	26437650    	26556835    	26486386       	26599840       	15        	0         	15             	DEL       
chr20       	26486385    	26599840    	26544632       	26554987       	5         	0         	5              	DUP       
chr20       	26486385    	26599840    	26545205       	26556910       	8         	0         	8              	DEL       
chr20       	26486385    	26599840    	26437431       	26557028       	7         	0         	7              	DEL       
chr20       	26486385    	26599840    	26517127       	26557370       	5         	0         	5              	DUP       
chr20       	26486385    	26599840    	26517691       	26596364       	4         	0         	4              	DEL       
chr20       	26486385    	26599840    	26486386       	26599840       	15        	0         	15             	DEL       
chr20       	26517126    	26557370    	26544632       	26554987       	5         	0         	5              	DUP       
chr20       	26517126    	26557370    	26545205       	26556910       	8         	0         	8              	DEL       
chr20       	26517126    	26557370    	26437431       	26557028       	7         	0         	7              	DEL       
chr20       	26517126    	26557370    	26517127       	26557370       	5         	0         	5              	DUP       
chr20       	26517126    	26557370    	26517691       	26596364       	4         	0         	4              	DEL       
chr20       	26517793    	26596398    	26544632       	26554987       	5         	0         	5              	DUP       
chr20       	26517793    	26596398    	26545205       	26556910       	8         	0         	8              	DEL       
chr20       	26517793    	26596398    	26437431       	26557028       	7         	0         	7              	DEL       
chr20       	26517793    	26596398    	26517127       	26557370       	5         	0         	5              	DUP       
chr20       	26517793    	26596398    	26517691       	26596364       	4         	0         	4              	DEL       
chr20       	26544631    	26554987    	26544632       	26554987       	5         	0         	5              	DUP       
chr20       	26544631    	26554987    	26545205       	26556910       	8         	0         	8              	DEL       
chr20       	26545355    	26556862    	26544632       	26554987       	5         	0         	5              	DUP       
chr20       	26545355    	26556862    	26545205       	26556910       	8         	0         	8              	DEL       
chr20       	26608345    	26631424    	26608346       	26631424       	15        	0         	15             	DEL       
chr20       	26631782    	26634151    	26631783       	26634151       	5         	0         	5              	DEL       
chr20       	28044429    	28214032    	28044430       	28214032       	4         	0         	4              	DUP       
chr20       	28754913    	28757851    	28754934       	28757851       	4         	1         	5              	DEL       
chr20       	28769369    	28771412    	28769364       	28771452       	22        	0         	22             	DUP       
chr20       	28786673    	28787931    	28786674       	28787931       	25        	0         	25             	DEL       
chr20       	28809547    	28817510    	28809529       	28814590       	16        	0         	16             	DEL       
chr20       	28809547    	28817510    	28814626       	28817883       	35        	0         	35             	DUP       
chr20       	28809547    	28817510    	28809548       	28817510       	44        	0         	44             	DEL       
chr20       	28809547    	28817510    	28809536       	28817976       	61        	0         	61             	DUP       
chr20       	28809547    	28817510    	28810459       	28819235       	33        	0         	33             	DEL       
chr20       	28809547    	28817510    	28809749       	28821101       	14        	0         	14             	DEL       
chr20       	28809547    	28817510    	28815244       	28824440       	16        	0         	16             	DEL       
chr20       	28809547    	28817510    	28815854       	28824753       	10        	0         	10             	DUP       
chr20       	28809535    	28817976    	28809529       	28814590       	16        	0         	16             	DEL       
chr20       	28809535    	28817976    	28814626       	28817883       	35        	0         	35             	DUP       
chr20       	28809535    	28817976    	28809548       	28817510       	44        	0         	44             	DEL       
chr20       	28809535    	28817976    	28809536       	28817976       	61        	0         	61             	DUP       
chr20       	28809535    	28817976    	28810459       	28819235       	33        	0         	33             	DEL       
chr20       	28809535    	28817976    	28817977       	28821015       	17        	0         	17             	DEL       
chr20       	28809535    	28817976    	28809749       	28821101       	14        	0         	14             	DEL       
chr20       	28809535    	28817976    	28815244       	28824440       	16        	0         	16             	DEL       
chr20       	28809535    	28817976    	28815854       	28824753       	10        	0         	10             	DUP       
chr20       	28810458    	28819235    	28809529       	28814590       	16        	0         	16             	DEL       
chr20       	28810458    	28819235    	28814626       	28817883       	35        	0         	35             	DUP       
chr20       	28810458    	28819235    	28809548       	28817510       	44        	0         	44             	DEL       
chr20       	28810458    	28819235    	28809536       	28817976       	61        	0         	61             	DUP       
chr20       	28810458    	28819235    	28810459       	28819235       	33        	0         	33             	DEL       
chr20       	28810458    	28819235    	28817977       	28821015       	17        	0         	17             	DEL       
chr20       	28810458    	28819235    	28815244       	28824440       	16        	0         	16             	DEL       
chr20       	28810458    	28819235    	28815854       	28824753       	10        	0         	10             	DUP       
chr20       	28809748    	28821101    	28809529       	28814590       	16        	0         	16             	DEL       
chr20       	28809748    	28821101    	28814626       	28817883       	35        	0         	35             	DUP       
chr20       	28809748    	28821101    	28809548       	28817510       	44        	0         	44             	DEL       
chr20       	28809748    	28821101    	28809536       	28817976       	61        	0         	61             	DUP       
chr20       	28809748    	28821101    	28810459       	28819235       	33        	0         	33             	DEL       
chr20       	28809748    	28821101    	28817977       	28821015       	17        	0         	17             	DEL       
chr20       	28809748    	28821101    	28809749       	28821101       	14        	0         	14             	DEL       
chr20       	28809748    	28821101    	28820944       	28821872       	4         	0         	4              	DEL       
chr20       	28809748    	28821101    	28815244       	28824440       	16        	0         	16             	DEL       
chr20       	28809748    	28821101    	28815854       	28824753       	10        	0         	10             	DUP       
chr20       	28814625    	28817883    	28809529       	28814590       	16        	0         	16             	DEL       
chr20       	28814625    	28817883    	28814626       	28817883       	35        	0         	35             	DUP       
chr20       	28814625    	28817883    	28809548       	28817510       	44        	0         	44             	DEL       
chr20       	28814625    	28817883    	28809536       	28817976       	61        	0         	61             	DUP       
chr20       	28814625    	28817883    	28817977       	28821015       	17        	0         	17             	DEL       
chr20       	28814625    	28817883    	28815244       	28824440       	16        	0         	16             	DEL       
chr20       	28814625    	28817883    	28815854       	28824753       	10        	0         	10             	DUP       
chr20       	28817976    	28821015    	28814626       	28817883       	35        	0         	35             	DUP       
chr20       	28817976    	28821015    	28809536       	28817976       	61        	0         	61             	DUP       
chr20       	28817976    	28821015    	28810459       	28819235       	33        	0         	33             	DEL       
chr20       	28817976    	28821015    	28817977       	28821015       	17        	0         	17             	DEL       
chr20       	28817976    	28821015    	28809749       	28821101       	14        	0         	14             	DEL       
chr20       	28817976    	28821015    	28820944       	28821872       	4         	0         	4              	DEL       
chr20       	28839958    	28840522    	28839959       	28840522       	5         	0         	5              	DEL       
chr20       	28839958    	28840522    	28840004       	29187757       	12        	0         	12             	DEL       
chr20       	28838968    	29184385    	28861326       	28868476       	37        	0         	37             	DEL       
chr20       	28838968    	29184385    	28896363       	29130479       	6         	0         	6              	DUP       
chr20       	28838968    	29184385    	29094870       	30391482       	5         	0         	5              	DUP       
chr20       	28838968    	29184385    	28839315       	28840670       	26        	0         	26             	DUP       
chr20       	28838968    	29184385    	28835212       	28839508       	8         	0         	8              	DUP       
chr20       	28838968    	29184385    	28835588       	28839307       	19        	0         	19             	DEL       
chr20       	28838968    	29184385    	28839959       	28840522       	5         	0         	5              	DEL       
chr20       	28838968    	29184385    	28838888       	28842261       	6         	0         	6              	DEL       
chr20       	28838968    	29184385    	28859997       	28860195       	0         	5         	5              	DUP       
chr20       	28838968    	29184385    	28861678       	28897228       	6         	0         	6              	DUP       
chr20       	28838968    	29184385    	28925871       	28926449       	7         	0         	7              	DUP       
chr20       	28838968    	29184385    	28939930       	28940474       	6         	0         	6              	DEL       
chr20       	28838968    	29184385    	28862126       	29152392       	5         	0         	5              	DEL       
chr20       	28838968    	29184385    	28861494       	29152718       	7         	0         	7              	DUP       
chr20       	28838968    	29184385    	28840648       	29155623       	18        	0         	18             	DEL       
chr20       	28838968    	29184385    	29152275       	29174448       	4         	0         	4              	DUP       
chr20       	28838968    	29184385    	28897228       	29174262       	6         	0         	6              	DEL       
chr20       	28838968    	29184385    	28838969       	29184385       	20        	0         	20             	DUP       
chr20       	28838968    	29184385    	29156995       	29184358       	0         	21        	21             	DUP       
chr20       	28838968    	29184385    	28839344       	29187227       	4         	0         	4              	DUP       
chr20       	28838968    	29184385    	29155838       	29187760       	4         	0         	4              	DEL       
chr20       	28838968    	29184385    	28840004       	29187757       	12        	0         	12             	DEL       
chr20       	28838968    	29184385    	28897173       	29189808       	11        	0         	11             	DEL       
chr20       	28838968    	29184385    	29130297       	29193756       	7         	0         	7              	DUP       
chr20       	28838968    	29184385    	29152268       	29197160       	8         	0         	8              	DUP       
chr20       	28838968    	29184385    	28896531       	29200174       	5         	0         	5              	DUP       
chr20       	28838968    	29184385    	29056595       	30355573       	6         	0         	6              	DUP       
chr20       	28838968    	29184385    	29062512       	30360447       	5         	0         	5              	DUP       
chr20       	28838968    	29184385    	29125530       	30424501       	25        	0         	25             	DEL       
chr20       	28859996    	28860195    	28859997       	28860195       	0         	5         	5              	DUP       
chr20       	28861071    	28868608    	28861326       	28868476       	37        	0         	37             	DEL       
chr20       	28861071    	28868608    	28861678       	28897228       	6         	0         	6              	DUP       
chr20       	28861071    	28868608    	28862126       	29152392       	5         	0         	5              	DEL       
chr20       	28861071    	28868608    	28861494       	29152718       	7         	0         	7              	DUP       
chr20       	28861677    	28897228    	28861326       	28868476       	37        	0         	37             	DEL       
chr20       	28861677    	28897228    	28896363       	29130479       	6         	0         	6              	DUP       
chr20       	28861677    	28897228    	28861678       	28897228       	6         	0         	6              	DUP       
chr20       	28861677    	28897228    	28862126       	29152392       	5         	0         	5              	DEL       
chr20       	28861677    	28897228    	28897228       	29174262       	6         	0         	6              	DEL       
chr20       	28861677    	28897228    	28897173       	29189808       	11        	0         	11             	DEL       
chr20       	28861677    	28897228    	28896531       	29200174       	5         	0         	5              	DUP       
chr20       	28862125    	29152392    	28861326       	28868476       	37        	0         	37             	DEL       
chr20       	28862125    	29152392    	28896363       	29130479       	6         	0         	6              	DUP       
chr20       	28862125    	29152392    	29094870       	30391482       	5         	0         	5              	DUP       
chr20       	28862125    	29152392    	28861678       	28897228       	6         	0         	6              	DUP       
chr20       	28862125    	29152392    	28925871       	28926449       	7         	0         	7              	DUP       
chr20       	28862125    	29152392    	28939930       	28940474       	6         	0         	6              	DEL       
chr20       	28862125    	29152392    	28862126       	29152392       	5         	0         	5              	DEL       
chr20       	28862125    	29152392    	29152275       	29174448       	4         	0         	4              	DUP       
chr20       	28862125    	29152392    	28897228       	29174262       	6         	0         	6              	DEL       
chr20       	28862125    	29152392    	28897173       	29189808       	11        	0         	11             	DEL       
chr20       	28862125    	29152392    	29130297       	29193756       	7         	0         	7              	DUP       
chr20       	28862125    	29152392    	29152268       	29197160       	8         	0         	8              	DUP       
chr20       	28862125    	29152392    	28896531       	29200174       	5         	0         	5              	DUP       
chr20       	28862125    	29152392    	29056595       	30355573       	6         	0         	6              	DUP       
chr20       	28862125    	29152392    	29062512       	30360447       	5         	0         	5              	DUP       
chr20       	28862125    	29152392    	29125530       	30424501       	25        	0         	25             	DEL       
chr20       	28861493    	29152718    	28861326       	28868476       	37        	0         	37             	DEL       
chr20       	28861493    	29152718    	28896363       	29130479       	6         	0         	6              	DUP       
chr20       	28861493    	29152718    	29094870       	30391482       	5         	0         	5              	DUP       
chr20       	28861493    	29152718    	28861678       	28897228       	6         	0         	6              	DUP       
chr20       	28861493    	29152718    	28925871       	28926449       	7         	0         	7              	DUP       
chr20       	28861493    	29152718    	28939930       	28940474       	6         	0         	6              	DEL       
chr20       	28861493    	29152718    	28862126       	29152392       	5         	0         	5              	DEL       
chr20       	28861493    	29152718    	28861494       	29152718       	7         	0         	7              	DUP       
chr20       	28861493    	29152718    	29152275       	29174448       	4         	0         	4              	DUP       
chr20       	28861493    	29152718    	28897228       	29174262       	6         	0         	6              	DEL       
chr20       	28861493    	29152718    	28897173       	29189808       	11        	0         	11             	DEL       
chr20       	28861493    	29152718    	29130297       	29193756       	7         	0         	7              	DUP       
chr20       	28861493    	29152718    	29152268       	29197160       	8         	0         	8              	DUP       
chr20       	28861493    	29152718    	28896531       	29200174       	5         	0         	5              	DUP       
chr20       	28861493    	29152718    	29056595       	30355573       	6         	0         	6              	DUP       
chr20       	28861493    	29152718    	29062512       	30360447       	5         	0         	5              	DUP       
chr20       	28861493    	29152718    	29125530       	30424501       	25        	0         	25             	DEL       
chr20       	28896362    	29130479    	28896363       	29130479       	6         	0         	6              	DUP       
chr20       	28896362    	29130479    	29094870       	30391482       	5         	0         	5              	DUP       
chr20       	28896362    	29130479    	28861678       	28897228       	6         	0         	6              	DUP       
chr20       	28896362    	29130479    	28925871       	28926449       	7         	0         	7              	DUP       
chr20       	28896362    	29130479    	28939930       	28940474       	6         	0         	6              	DEL       
chr20       	28896362    	29130479    	28897228       	29174262       	6         	0         	6              	DEL       
chr20       	28896362    	29130479    	28897173       	29189808       	11        	0         	11             	DEL       
chr20       	28896362    	29130479    	29130297       	29193756       	7         	0         	7              	DUP       
chr20       	28896362    	29130479    	28896531       	29200174       	5         	0         	5              	DUP       
chr20       	28896362    	29130479    	29056595       	30355573       	6         	0         	6              	DUP       
chr20       	28896362    	29130479    	29062512       	30360447       	5         	0         	5              	DUP       
chr20       	28896362    	29130479    	29125530       	30424501       	25        	0         	25             	DEL       
chr20       	28897227    	29174262    	28896363       	29130479       	6         	0         	6              	DUP       
chr20       	28897227    	29174262    	29094870       	30391482       	5         	0         	5              	DUP       
chr20       	28897227    	29174262    	28861678       	28897228       	6         	0         	6              	DUP       
chr20       	28897227    	29174262    	28925871       	28926449       	7         	0         	7              	DUP       
chr20       	28897227    	29174262    	28939930       	28940474       	6         	0         	6              	DEL       
chr20       	28897227    	29174262    	28862126       	29152392       	5         	0         	5              	DEL       
chr20       	28897227    	29174262    	28861494       	29152718       	7         	0         	7              	DUP       
chr20       	28897227    	29174262    	28840648       	29155623       	18        	0         	18             	DEL       
chr20       	28897227    	29174262    	29152275       	29174448       	4         	0         	4              	DUP       
chr20       	28897227    	29174262    	28897228       	29174262       	6         	0         	6              	DEL       
chr20       	28897227    	29174262    	29156995       	29184358       	0         	21        	21             	DUP       
chr20       	28897227    	29174262    	29155838       	29187760       	4         	0         	4              	DEL       
chr20       	28897227    	29174262    	28897173       	29189808       	11        	0         	11             	DEL       
chr20       	28897227    	29174262    	29130297       	29193756       	7         	0         	7              	DUP       
chr20       	28897227    	29174262    	29152268       	29197160       	8         	0         	8              	DUP       
chr20       	28897227    	29174262    	29056595       	30355573       	6         	0         	6              	DUP       
chr20       	28897227    	29174262    	29062512       	30360447       	5         	0         	5              	DUP       
chr20       	28897227    	29174262    	29125530       	30424501       	25        	0         	25             	DEL       
chr20       	28897172    	29189808    	28896363       	29130479       	6         	0         	6              	DUP       
chr20       	28897172    	29189808    	29094870       	30391482       	5         	0         	5              	DUP       
chr20       	28897172    	29189808    	28861678       	28897228       	6         	0         	6              	DUP       
chr20       	28897172    	29189808    	28925871       	28926449       	7         	0         	7              	DUP       
chr20       	28897172    	29189808    	28939930       	28940474       	6         	0         	6              	DEL       
chr20       	28897172    	29189808    	28862126       	29152392       	5         	0         	5              	DEL       
chr20       	28897172    	29189808    	28861494       	29152718       	7         	0         	7              	DUP       
chr20       	28897172    	29189808    	28840648       	29155623       	18        	0         	18             	DEL       
chr20       	28897172    	29189808    	29152275       	29174448       	4         	0         	4              	DUP       
chr20       	28897172    	29189808    	28897228       	29174262       	6         	0         	6              	DEL       
chr20       	28897172    	29189808    	28838969       	29184385       	20        	0         	20             	DUP       
chr20       	28897172    	29189808    	29156995       	29184358       	0         	21        	21             	DUP       
chr20       	28897172    	29189808    	28839344       	29187227       	4         	0         	4              	DUP       
chr20       	28897172    	29189808    	29155838       	29187760       	4         	0         	4              	DEL       
chr20       	28897172    	29189808    	28840004       	29187757       	12        	0         	12             	DEL       
chr20       	28897172    	29189808    	28897173       	29189808       	11        	0         	11             	DEL       
chr20       	28897172    	29189808    	29130297       	29193756       	7         	0         	7              	DUP       
chr20       	28897172    	29189808    	29152268       	29197160       	8         	0         	8              	DUP       
chr20       	28897172    	29189808    	29187757       	29260656       	0         	4         	4              	DUP       
chr20       	28897172    	29189808    	29056595       	30355573       	6         	0         	6              	DUP       
chr20       	28897172    	29189808    	29062512       	30360447       	5         	0         	5              	DUP       
chr20       	28897172    	29189808    	29125530       	30424501       	25        	0         	25             	DEL       
chr20       	28896530    	29200174    	28896363       	29130479       	6         	0         	6              	DUP       
chr20       	28896530    	29200174    	29190007       	29196955       	5         	0         	5              	DEL       
chr20       	28896530    	29200174    	29094870       	30391482       	5         	0         	5              	DUP       
chr20       	28896530    	29200174    	28861678       	28897228       	6         	0         	6              	DUP       
chr20       	28896530    	29200174    	28925871       	28926449       	7         	0         	7              	DUP       
chr20       	28896530    	29200174    	28939930       	28940474       	6         	0         	6              	DEL       
chr20       	28896530    	29200174    	28862126       	29152392       	5         	0         	5              	DEL       
chr20       	28896530    	29200174    	28861494       	29152718       	7         	0         	7              	DUP       
chr20       	28896530    	29200174    	28840648       	29155623       	18        	0         	18             	DEL       
chr20       	28896530    	29200174    	29152275       	29174448       	4         	0         	4              	DUP       
chr20       	28896530    	29200174    	28897228       	29174262       	6         	0         	6              	DEL       
chr20       	28896530    	29200174    	28838969       	29184385       	20        	0         	20             	DUP       
chr20       	28896530    	29200174    	29156995       	29184358       	0         	21        	21             	DUP       
chr20       	28896530    	29200174    	28839344       	29187227       	4         	0         	4              	DUP       
chr20       	28896530    	29200174    	29155838       	29187760       	4         	0         	4              	DEL       
chr20       	28896530    	29200174    	28840004       	29187757       	12        	0         	12             	DEL       
chr20       	28896530    	29200174    	28897173       	29189808       	11        	0         	11             	DEL       
chr20       	28896530    	29200174    	29130297       	29193756       	7         	0         	7              	DUP       
chr20       	28896530    	29200174    	29152268       	29197160       	8         	0         	8              	DUP       
chr20       	28896530    	29200174    	28896531       	29200174       	5         	0         	5              	DUP       
chr20       	28896530    	29200174    	29187757       	29260656       	0         	4         	4              	DUP       
chr20       	28896530    	29200174    	29056595       	30355573       	6         	0         	6              	DUP       
chr20       	28896530    	29200174    	29062512       	30360447       	5         	0         	5              	DUP       
chr20       	28896530    	29200174    	29125530       	30424501       	25        	0         	25             	DEL       
chr20       	28925870    	28926449    	28925871       	28926449       	7         	0         	7              	DUP       
chr20       	28939929    	28940474    	28939930       	28940474       	6         	0         	6              	DEL       
chr20       	29062511    	30360447    	28896363       	29130479       	6         	0         	6              	DUP       
chr20       	29062511    	30360447    	29190007       	29196955       	5         	0         	5              	DEL       
chr20       	29062511    	30360447    	29538732       	29540290       	11        	0         	11             	DEL       
chr20       	29062511    	30360447    	29094870       	30391482       	5         	0         	5              	DUP       
chr20       	29062511    	30360447    	28862126       	29152392       	5         	0         	5              	DEL       
chr20       	29062511    	30360447    	28861494       	29152718       	7         	0         	7              	DUP       
chr20       	29062511    	30360447    	28840648       	29155623       	18        	0         	18             	DEL       
chr20       	29062511    	30360447    	29152275       	29174448       	4         	0         	4              	DUP       
chr20       	29062511    	30360447    	28897228       	29174262       	6         	0         	6              	DEL       
chr20       	29062511    	30360447    	28838969       	29184385       	20        	0         	20             	DUP       
chr20       	29062511    	30360447    	29156995       	29184358       	0         	21        	21             	DUP       
chr20       	29062511    	30360447    	28839344       	29187227       	4         	0         	4              	DUP       
chr20       	29062511    	30360447    	29155838       	29187760       	4         	0         	4              	DEL       
chr20       	29062511    	30360447    	28840004       	29187757       	12        	0         	12             	DEL       
chr20       	29062511    	30360447    	28897173       	29189808       	11        	0         	11             	DEL       
chr20       	29062511    	30360447    	29130297       	29193756       	7         	0         	7              	DUP       
chr20       	29062511    	30360447    	29152268       	29197160       	8         	0         	8              	DUP       
chr20       	29062511    	30360447    	28896531       	29200174       	5         	0         	5              	DUP       
chr20       	29062511    	30360447    	29253745       	29256245       	23        	0         	23             	DUP       
chr20       	29062511    	30360447    	29253729       	29256631       	5         	0         	5              	DEL       
chr20       	29062511    	30360447    	29187757       	29260656       	0         	4         	4              	DUP       
chr20       	29062511    	30360447    	29256941       	29260906       	28        	0         	28             	DUP       
chr20       	29062511    	30360447    	29273089       	29276544       	19        	0         	19             	DEL       
chr20       	29062511    	30360447    	29288019       	29290652       	25        	0         	25             	DEL       
chr20       	29062511    	30360447    	29412506       	29413578       	7         	0         	7              	DEL       
chr20       	29062511    	30360447    	29700036       	29703031       	24        	0         	24             	DEL       
chr20       	29062511    	30360447    	29704500       	29704951       	8         	0         	8              	DEL       
chr20       	29062511    	30360447    	29246881       	29729670       	5         	0         	5              	DEL       
chr20       	29062511    	30360447    	29892013       	29892571       	18        	0         	18             	DEL       
chr20       	29062511    	30360447    	29905837       	29906557       	4         	0         	4              	DEL       
chr20       	29062511    	30360447    	30159323       	30159798       	5         	0         	5              	DEL       
chr20       	29062511    	30360447    	30160600       	30162392       	36        	0         	36             	DEL       
chr20       	29062511    	30360447    	29056595       	30355573       	6         	0         	6              	DUP       
chr20       	29062511    	30360447    	29062512       	30360447       	5         	0         	5              	DUP       
chr20       	29062511    	30360447    	29125530       	30424501       	25        	0         	25             	DEL       
chr20       	29062511    	30360447    	29283506       	30462052       	4         	0         	4              	DEL       
chr20       	29062511    	30360447    	29280013       	30462008       	4         	0         	4              	DEL       
chr20       	29062511    	30360447    	29294687       	30482703       	9         	0         	9              	DEL       
chr20       	29062511    	30360447    	29221644       	30936850       	7         	0         	7              	INV       
chr20       	29094869    	30391482    	28896363       	29130479       	6         	0         	6              	DUP       
chr20       	29094869    	30391482    	29190007       	29196955       	5         	0         	5              	DEL       
chr20       	29094869    	30391482    	29538732       	29540290       	11        	0         	11             	DEL       
chr20       	29094869    	30391482    	29094870       	30391482       	5         	0         	5              	DUP       
chr20       	29094869    	30391482    	28862126       	29152392       	5         	0         	5              	DEL       
chr20       	29094869    	30391482    	28861494       	29152718       	7         	0         	7              	DUP       
chr20       	29094869    	30391482    	28840648       	29155623       	18        	0         	18             	DEL       
chr20       	29094869    	30391482    	29152275       	29174448       	4         	0         	4              	DUP       
chr20       	29094869    	30391482    	28897228       	29174262       	6         	0         	6              	DEL       
chr20       	29094869    	30391482    	28838969       	29184385       	20        	0         	20             	DUP       
chr20       	29094869    	30391482    	29156995       	29184358       	0         	21        	21             	DUP       
chr20       	29094869    	30391482    	28839344       	29187227       	4         	0         	4              	DUP       
chr20       	29094869    	30391482    	29155838       	29187760       	4         	0         	4              	DEL       
chr20       	29094869    	30391482    	28840004       	29187757       	12        	0         	12             	DEL       
chr20       	29094869    	30391482    	28897173       	29189808       	11        	0         	11             	DEL       
chr20       	29094869    	30391482    	29130297       	29193756       	7         	0         	7              	DUP       
chr20       	29094869    	30391482    	29152268       	29197160       	8         	0         	8              	DUP       
chr20       	29094869    	30391482    	28896531       	29200174       	5         	0         	5              	DUP       
chr20       	29094869    	30391482    	29253745       	29256245       	23        	0         	23             	DUP       
chr20       	29094869    	30391482    	29253729       	29256631       	5         	0         	5              	DEL       
chr20       	29094869    	30391482    	29187757       	29260656       	0         	4         	4              	DUP       
chr20       	29094869    	30391482    	29256941       	29260906       	28        	0         	28             	DUP       
chr20       	29094869    	30391482    	29273089       	29276544       	19        	0         	19             	DEL       
chr20       	29094869    	30391482    	29288019       	29290652       	25        	0         	25             	DEL       
chr20       	29094869    	30391482    	29412506       	29413578       	7         	0         	7              	DEL       
chr20       	29094869    	30391482    	29700036       	29703031       	24        	0         	24             	DEL       
chr20       	29094869    	30391482    	29704500       	29704951       	8         	0         	8              	DEL       
chr20       	29094869    	30391482    	29246881       	29729670       	5         	0         	5              	DEL       
chr20       	29094869    	30391482    	29892013       	29892571       	18        	0         	18             	DEL       
chr20       	29094869    	30391482    	29905837       	29906557       	4         	0         	4              	DEL       
chr20       	29094869    	30391482    	30159323       	30159798       	5         	0         	5              	DEL       
chr20       	29094869    	30391482    	30160600       	30162392       	36        	0         	36             	DEL       
chr20       	29094869    	30391482    	29056595       	30355573       	6         	0         	6              	DUP       
chr20       	29094869    	30391482    	29062512       	30360447       	5         	0         	5              	DUP       
chr20       	29094869    	30391482    	29125530       	30424501       	25        	0         	25             	DEL       
chr20       	29094869    	30391482    	29283506       	30462052       	4         	0         	4              	DEL       
chr20       	29094869    	30391482    	29280013       	30462008       	4         	0         	4              	DEL       
chr20       	29094869    	30391482    	29294687       	30482703       	9         	0         	9              	DEL       
chr20       	29094869    	30391482    	29221644       	30936850       	7         	0         	7              	INV       
chr20       	29125529    	30424501    	28896363       	29130479       	6         	0         	6              	DUP       
chr20       	29125529    	30424501    	29190007       	29196955       	5         	0         	5              	DEL       
chr20       	29125529    	30424501    	29538732       	29540290       	11        	0         	11             	DEL       
chr20       	29125529    	30424501    	29094870       	30391482       	5         	0         	5              	DUP       
chr20       	29125529    	30424501    	28862126       	29152392       	5         	0         	5              	DEL       
chr20       	29125529    	30424501    	28861494       	29152718       	7         	0         	7              	DUP       
chr20       	29125529    	30424501    	28840648       	29155623       	18        	0         	18             	DEL       
chr20       	29125529    	30424501    	29152275       	29174448       	4         	0         	4              	DUP       
chr20       	29125529    	30424501    	28897228       	29174262       	6         	0         	6              	DEL       
chr20       	29125529    	30424501    	28838969       	29184385       	20        	0         	20             	DUP       
chr20       	29125529    	30424501    	29156995       	29184358       	0         	21        	21             	DUP       
chr20       	29125529    	30424501    	28839344       	29187227       	4         	0         	4              	DUP       
chr20       	29125529    	30424501    	29155838       	29187760       	4         	0         	4              	DEL       
chr20       	29125529    	30424501    	28840004       	29187757       	12        	0         	12             	DEL       
chr20       	29125529    	30424501    	28897173       	29189808       	11        	0         	11             	DEL       
chr20       	29125529    	30424501    	29130297       	29193756       	7         	0         	7              	DUP       
chr20       	29125529    	30424501    	29152268       	29197160       	8         	0         	8              	DUP       
chr20       	29125529    	30424501    	28896531       	29200174       	5         	0         	5              	DUP       
chr20       	29125529    	30424501    	29253745       	29256245       	23        	0         	23             	DUP       
chr20       	29125529    	30424501    	29253729       	29256631       	5         	0         	5              	DEL       
chr20       	29125529    	30424501    	29187757       	29260656       	0         	4         	4              	DUP       
chr20       	29125529    	30424501    	29256941       	29260906       	28        	0         	28             	DUP       
chr20       	29125529    	30424501    	29273089       	29276544       	19        	0         	19             	DEL       
chr20       	29125529    	30424501    	29288019       	29290652       	25        	0         	25             	DEL       
chr20       	29125529    	30424501    	29412506       	29413578       	7         	0         	7              	DEL       
chr20       	29125529    	30424501    	29700036       	29703031       	24        	0         	24             	DEL       
chr20       	29125529    	30424501    	29704500       	29704951       	8         	0         	8              	DEL       
chr20       	29125529    	30424501    	29246881       	29729670       	5         	0         	5              	DEL       
chr20       	29125529    	30424501    	29892013       	29892571       	18        	0         	18             	DEL       
chr20       	29125529    	30424501    	29905837       	29906557       	4         	0         	4              	DEL       
chr20       	29125529    	30424501    	30159323       	30159798       	5         	0         	5              	DEL       
chr20       	29125529    	30424501    	30160600       	30162392       	36        	0         	36             	DEL       
chr20       	29125529    	30424501    	29056595       	30355573       	6         	0         	6              	DUP       
chr20       	29125529    	30424501    	29062512       	30360447       	5         	0         	5              	DUP       
chr20       	29125529    	30424501    	29125530       	30424501       	25        	0         	25             	DEL       
chr20       	29125529    	30424501    	29283506       	30462052       	4         	0         	4              	DEL       
chr20       	29125529    	30424501    	29280013       	30462008       	4         	0         	4              	DEL       
chr20       	29125529    	30424501    	29294687       	30482703       	9         	0         	9              	DEL       
chr20       	29125529    	30424501    	29221644       	30936850       	7         	0         	7              	INV       
chr20       	29130296    	29193756    	28896363       	29130479       	6         	0         	6              	DUP       
chr20       	29130296    	29193756    	29190007       	29196955       	5         	0         	5              	DEL       
chr20       	29130296    	29193756    	28862126       	29152392       	5         	0         	5              	DEL       
chr20       	29130296    	29193756    	28861494       	29152718       	7         	0         	7              	DUP       
chr20       	29130296    	29193756    	28840648       	29155623       	18        	0         	18             	DEL       
chr20       	29130296    	29193756    	29152275       	29174448       	4         	0         	4              	DUP       
chr20       	29130296    	29193756    	28897228       	29174262       	6         	0         	6              	DEL       
chr20       	29130296    	29193756    	28838969       	29184385       	20        	0         	20             	DUP       
chr20       	29130296    	29193756    	29156995       	29184358       	0         	21        	21             	DUP       
chr20       	29130296    	29193756    	28839344       	29187227       	4         	0         	4              	DUP       
chr20       	29130296    	29193756    	29155838       	29187760       	4         	0         	4              	DEL       
chr20       	29130296    	29193756    	28840004       	29187757       	12        	0         	12             	DEL       
chr20       	29130296    	29193756    	28897173       	29189808       	11        	0         	11             	DEL       
chr20       	29130296    	29193756    	29130297       	29193756       	7         	0         	7              	DUP       
chr20       	29130296    	29193756    	29152268       	29197160       	8         	0         	8              	DUP       
chr20       	29130296    	29193756    	29187757       	29260656       	0         	4         	4              	DUP       
chr20       	29152274    	29174448    	28862126       	29152392       	5         	0         	5              	DEL       
chr20       	29152274    	29174448    	28861494       	29152718       	7         	0         	7              	DUP       
chr20       	29152274    	29174448    	28840648       	29155623       	18        	0         	18             	DEL       
chr20       	29152274    	29174448    	29152275       	29174448       	4         	0         	4              	DUP       
chr20       	29152274    	29174448    	28897228       	29174262       	6         	0         	6              	DEL       
chr20       	29152274    	29174448    	29156995       	29184358       	0         	21        	21             	DUP       
chr20       	29152274    	29174448    	29155838       	29187760       	4         	0         	4              	DEL       
chr20       	29152274    	29174448    	29152268       	29197160       	8         	0         	8              	DUP       
chr20       	29152267    	29197160    	29190007       	29196955       	5         	0         	5              	DEL       
chr20       	29152267    	29197160    	28862126       	29152392       	5         	0         	5              	DEL       
chr20       	29152267    	29197160    	28861494       	29152718       	7         	0         	7              	DUP       
chr20       	29152267    	29197160    	28840648       	29155623       	18        	0         	18             	DEL       
chr20       	29152267    	29197160    	29152275       	29174448       	4         	0         	4              	DUP       
chr20       	29152267    	29197160    	28897228       	29174262       	6         	0         	6              	DEL       
chr20       	29152267    	29197160    	28838969       	29184385       	20        	0         	20             	DUP       
chr20       	29152267    	29197160    	29156995       	29184358       	0         	21        	21             	DUP       
chr20       	29152267    	29197160    	28839344       	29187227       	4         	0         	4              	DUP       
chr20       	29152267    	29197160    	29155838       	29187760       	4         	0         	4              	DEL       
chr20       	29152267    	29197160    	28840004       	29187757       	12        	0         	12             	DEL       
chr20       	29152267    	29197160    	28897173       	29189808       	11        	0         	11             	DEL       
chr20       	29152267    	29197160    	29130297       	29193756       	7         	0         	7              	DUP       
chr20       	29152267    	29197160    	29152268       	29197160       	8         	0         	8              	DUP       
chr20       	29152267    	29197160    	29187757       	29260656       	0         	4         	4              	DUP       
chr20       	29155837    	29187760    	29152275       	29174448       	4         	0         	4              	DUP       
chr20       	29155837    	29187760    	28897228       	29174262       	6         	0         	6              	DEL       
chr20       	29155837    	29187760    	28838969       	29184385       	20        	0         	20             	DUP       
chr20       	29155837    	29187760    	29156995       	29184358       	0         	21        	21             	DUP       
chr20       	29155837    	29187760    	28839344       	29187227       	4         	0         	4              	DUP       
chr20       	29155837    	29187760    	29155838       	29187760       	4         	0         	4              	DEL       
chr20       	29155837    	29187760    	28840004       	29187757       	12        	0         	12             	DEL       
chr20       	29155837    	29187760    	29187757       	29260656       	0         	4         	4              	DUP       
chr20       	29156994    	29184358    	29152275       	29174448       	4         	0         	4              	DUP       
chr20       	29156994    	29184358    	28897228       	29174262       	6         	0         	6              	DEL       
chr20       	29156994    	29184358    	28838969       	29184385       	20        	0         	20             	DUP       
chr20       	29156994    	29184358    	29156995       	29184358       	0         	21        	21             	DUP       
chr20       	29187756    	29260656    	29190007       	29196955       	5         	0         	5              	DEL       
chr20       	29187756    	29260656    	29155838       	29187760       	4         	0         	4              	DEL       
chr20       	29187756    	29260656    	28840004       	29187757       	12        	0         	12             	DEL       
chr20       	29187756    	29260656    	28897173       	29189808       	11        	0         	11             	DEL       
chr20       	29187756    	29260656    	29130297       	29193756       	7         	0         	7              	DUP       
chr20       	29187756    	29260656    	29152268       	29197160       	8         	0         	8              	DUP       
chr20       	29187756    	29260656    	28896531       	29200174       	5         	0         	5              	DUP       
chr20       	29187756    	29260656    	29253745       	29256245       	23        	0         	23             	DUP       
chr20       	29187756    	29260656    	29253729       	29256631       	5         	0         	5              	DEL       
chr20       	29187756    	29260656    	29187757       	29260656       	0         	4         	4              	DUP       
chr20       	29187756    	29260656    	29256941       	29260906       	28        	0         	28             	DUP       
chr20       	29187756    	29260656    	29246881       	29729670       	5         	0         	5              	DEL       
chr20       	29187756    	29260656    	29221644       	30936850       	7         	0         	7              	INV       
chr20       	29190006    	29196955    	29190007       	29196955       	5         	0         	5              	DEL       
chr20       	29190006    	29196955    	29130297       	29193756       	7         	0         	7              	DUP       
chr20       	29253751    	29256190    	29253745       	29256245       	23        	0         	23             	DUP       
chr20       	29253751    	29256190    	29253729       	29256631       	5         	0         	5              	DEL       
chr20       	29253728    	29256631    	29253745       	29256245       	23        	0         	23             	DUP       
chr20       	29253728    	29256631    	29253729       	29256631       	5         	0         	5              	DEL       
chr20       	29256940    	29260906    	29187757       	29260656       	0         	4         	4              	DUP       
chr20       	29256940    	29260906    	29256941       	29260906       	28        	0         	28             	DUP       
chr20       	29273092    	29276517    	29273089       	29276544       	19        	0         	19             	DEL       
chr20       	29280012    	30462008    	29538732       	29540290       	11        	0         	11             	DEL       
chr20       	29280012    	30462008    	29094870       	30391482       	5         	0         	5              	DUP       
chr20       	29280012    	30462008    	29288019       	29290652       	25        	0         	25             	DEL       
chr20       	29280012    	30462008    	29412506       	29413578       	7         	0         	7              	DEL       
chr20       	29280012    	30462008    	29700036       	29703031       	24        	0         	24             	DEL       
chr20       	29280012    	30462008    	29704500       	29704951       	8         	0         	8              	DEL       
chr20       	29280012    	30462008    	29246881       	29729670       	5         	0         	5              	DEL       
chr20       	29280012    	30462008    	29892013       	29892571       	18        	0         	18             	DEL       
chr20       	29280012    	30462008    	29905837       	29906557       	4         	0         	4              	DEL       
chr20       	29280012    	30462008    	30159323       	30159798       	5         	0         	5              	DEL       
chr20       	29280012    	30462008    	30160600       	30162392       	36        	0         	36             	DEL       
chr20       	29280012    	30462008    	29056595       	30355573       	6         	0         	6              	DUP       
chr20       	29280012    	30462008    	29062512       	30360447       	5         	0         	5              	DUP       
chr20       	29280012    	30462008    	29125530       	30424501       	25        	0         	25             	DEL       
chr20       	29280012    	30462008    	29283506       	30462052       	4         	0         	4              	DEL       
chr20       	29280012    	30462008    	29280013       	30462008       	4         	0         	4              	DEL       
chr20       	29280012    	30462008    	29294687       	30482703       	9         	0         	9              	DEL       
chr20       	29288018    	29290652    	29288019       	29290652       	25        	0         	25             	DEL       
chr20       	29294686    	30482703    	29538732       	29540290       	11        	0         	11             	DEL       
chr20       	29294686    	30482703    	29094870       	30391482       	5         	0         	5              	DUP       
chr20       	29294686    	30482703    	29412506       	29413578       	7         	0         	7              	DEL       
chr20       	29294686    	30482703    	29700036       	29703031       	24        	0         	24             	DEL       
chr20       	29294686    	30482703    	29704500       	29704951       	8         	0         	8              	DEL       
chr20       	29294686    	30482703    	29246881       	29729670       	5         	0         	5              	DEL       
chr20       	29294686    	30482703    	29892013       	29892571       	18        	0         	18             	DEL       
chr20       	29294686    	30482703    	29905837       	29906557       	4         	0         	4              	DEL       
chr20       	29294686    	30482703    	30159323       	30159798       	5         	0         	5              	DEL       
chr20       	29294686    	30482703    	30160600       	30162392       	36        	0         	36             	DEL       
chr20       	29294686    	30482703    	29056595       	30355573       	6         	0         	6              	DUP       
chr20       	29294686    	30482703    	29062512       	30360447       	5         	0         	5              	DUP       
chr20       	29294686    	30482703    	29125530       	30424501       	25        	0         	25             	DEL       
chr20       	29294686    	30482703    	29283506       	30462052       	4         	0         	4              	DEL       
chr20       	29294686    	30482703    	29280013       	30462008       	4         	0         	4              	DEL       
chr20       	29294686    	30482703    	30475302       	30475610       	4         	0         	4              	DEL       
chr20       	29294686    	30482703    	29294687       	30482703       	9         	0         	9              	DEL       
chr20       	29412505    	29413578    	29412506       	29413578       	7         	0         	7              	DEL       
chr20       	29538828    	29540437    	29538732       	29540290       	11        	0         	11             	DEL       
chr20       	29700017    	29703090    	29700036       	29703031       	24        	0         	24             	DEL       
chr20       	29704499    	29704951    	29704500       	29704951       	8         	0         	8              	DEL       
chr20       	29892012    	29892571    	29892013       	29892571       	18        	0         	18             	DEL       
chr20       	29905836    	29906557    	29905837       	29906557       	4         	0         	4              	DEL       
chr20       	30159322    	30159798    	30159323       	30159798       	5         	0         	5              	DEL       
chr20       	30160450    	30162499    	30160600       	30162392       	36        	0         	36             	DEL       
chr20       	31161625    	31162325    	31161625       	31162321       	37        	0         	37             	DUP       
chr20       	31170826    	31177630    	31170857       	31177629       	18        	8         	26             	DEL       
chr20       	32176445    	32177490    	32176446       	32177490       	5         	0         	5              	DEL       
chr20       	32311423    	32311729    	32311436       	32311729       	0         	15        	15             	DEL       
chr20       	32723064    	32724971    	32723065       	32724971       	31        	5         	36             	DEL       
chr20       	32739514    	32740212    	32739515       	32740212       	15        	0         	15             	DEL       
chr20       	32937679    	32941583    	32937680       	32941583       	22        	6         	28             	DEL       
chr20       	33736078    	33736170    	33736086       	33736170       	0         	4         	4              	DEL       
chr20       	34228121    	34231420    	34228095       	34231419       	50        	0         	50             	DEL       
chr20       	34528005    	34528339    	34528026       	34528339       	0         	21        	21             	DEL       
chr20       	34889368    	34889502    	34889400       	34889502       	1         	6         	7              	DEL       
chr20       	35033851    	35034174    	35033863       	35034167       	0         	10        	10             	DEL       
chr20       	35128253    	35129001    	35128270       	35129001       	25        	4         	29             	DEL       
chr20       	35564371    	35564521    	35564372       	35564522       	0         	5         	5              	DUP       
chr20       	37187205    	37187518    	37187220       	37187518       	0         	22        	22             	DEL       
chr20       	39708989    	39709128    	39709005       	39709127       	0         	15        	15             	DEL       
chr20       	41277710    	41278872    	41277734       	41278843       	16        	0         	16             	DEL       
chr20       	41912428    	41912485    	41912432       	41912485       	0         	5         	5              	DEL       
chr20       	43395953    	43397152    	43395972       	43397152       	47        	10        	57             	DEL       
chr20       	43643223    	43645948    	43643279       	43645931       	34        	0         	34             	DEL       
chr20       	43696485    	43696990    	43696475       	43697012       	8         	0         	8              	DUP       
chr20       	44047484    	44047885    	44047488       	44047884       	1         	18        	19             	DEL       
chr20       	45575421    	45578660    	45575425       	45578660       	26        	6         	32             	DEL       
chr20       	45730772    	45730885    	45730773       	45730885       	0         	4         	4              	DEL       
chr20       	49927197    	49927278    	49927200       	49927278       	0         	16        	16             	DEL       
chr20       	52167424    	52167493    	52167427       	52167493       	0         	12        	12             	DEL       
chr20       	54676111    	54676426    	54676126       	54676426       	2         	16        	18             	DEL       
chr20       	55859553    	55865561    	55859567       	55865560       	39        	24        	63             	DEL       
chr20       	55888163    	55888481    	55888178       	55888481       	1         	15        	16             	DEL       
chr20       	58695018    	58695341    	58695018       	58695339       	4         	3         	7              	DUP       
chr20       	60314366    	60314792    	60314367       	60314819       	8         	4         	12             	DUP       
chr20       	61101755    	61102417    	61101755       	61102415       	4         	0         	4              	DUP       
chr20       	61399109    	61399431    	61399124       	61399431       	0         	8         	8              	DEL       
chr20       	61995567    	61995887    	61995582       	61995887       	1         	7         	8              	DEL       
chr20       	62057714    	62058883    	62057715       	62058883       	5         	0         	5              	DEL       
chr20       	63093345    	63094245    	63093346       	63094245       	28        	16        	44             	DEL       
chr20       	63134561    	63135575    	63134562       	63135575       	8         	0         	8              	DEL       
chr20       	63553557    	63553658    	63553574       	63553644       	0         	7         	7              	DEL       
chr20       	63636198    	63636704    	63636199       	63636704       	8         	0         	8              	DEL       
chr20       	63964838    	63966118    	63964839       	63966118       	8         	0         	8              	DEL       
chr21       	5357763     	7292262     	5357763        	7292260        	5         	0         	5              	DUP       
chr21       	5357763     	7292262     	5384088        	10801208       	5         	0         	5              	DEL       
chr21       	5357763     	7292262     	6427483        	43035913       	4         	1         	5              	DUP       
chr21       	8995509     	8996707     	8995510        	8996707        	15        	0         	15             	DEL       
chr21       	10014849    	10015015    	10014855       	10015014       	0         	7         	7              	DEL       
chr21       	10769171    	10770077    	10769172       	10770077       	71        	0         	71             	DEL       
chr21       	13444518    	13445845    	13444482       	13445845       	17        	0         	17             	DEL       
chr21       	13878458    	13897881    	13871317       	13890673       	4         	0         	4              	DUP       
chr21       	13878458    	13897881    	13878458       	13897879       	10        	0         	10             	DUP       
chr21       	13878458    	13897881    	13878721       	13898308       	7         	0         	7              	DEL       
chr21       	14088066    	14089544    	14088468       	14089543       	15        	9         	24             	DEL       
chr21       	14902960    	14903040    	14902962       	14903040       	0         	7         	7              	DEL       
chr21       	15216057    	15219132    	15216060       	15219132       	19        	6         	25             	DEL       
chr21       	17240010    	17241315    	17240014       	17241315       	22        	7         	29             	DEL       
chr21       	17954353    	17956949    	17954411       	17956922       	19        	0         	19             	DEL       
chr21       	20226407    	20226520    	20226429       	20226520       	0         	7         	7              	DEL       
chr21       	21408855    	21409011    	21408856       	21409011       	6         	12        	18             	INV       
chr21       	22812935    	22812988    	22812933       	22812988       	0         	4         	4              	DEL       
chr21       	23002473    	23003098    	23002474       	23003098       	17        	10        	27             	DEL       
chr21       	23072417    	23072502    	23072437       	23072502       	0         	5         	5              	DEL       
chr21       	23369909    	23370224    	23369924       	23370224       	1         	11        	12             	DEL       
chr21       	24972163    	24973449    	24972168       	24973449       	17        	7         	24             	DEL       
chr21       	25452818    	25453086    	25452834       	25453086       	0         	18        	18             	DEL       
chr21       	26001835    	26002391    	26001842       	26002391       	89        	45        	134            	INV       
chr21       	26648355    	26649401    	26648363       	26649406       	79        	16        	95             	INV       
chr21       	28891328    	28891878    	28891329       	28891878       	15        	0         	15             	DEL       
chr21       	29179902    	29180257    	29179904       	29180257       	1         	5         	6              	DEL       
chr21       	29229494    	29229836    	29229504       	29229835       	0         	15        	15             	DEL       
chr21       	35642664    	35642870    	35642666       	35642870       	0         	16        	16             	DEL       
chr21       	38218603    	38218951    	38218620       	38218950       	5         	15        	20             	DEL       
chr21       	39554951    	39555034    	39554953       	39555034       	0         	5         	5              	DEL       
chr21       	40214937    	40215263    	40214952       	40215263       	3         	7         	10             	DEL       
chr21       	40585320    	40585440    	40585334       	40585440       	0         	4         	4              	DEL       
chr21       	41540010    	41540460    	41540015       	41540460       	5         	8         	13             	DEL       
chr21       	41844457    	41845446    	41844458       	41845446       	4         	0         	4              	DEL       
chr21       	44410146    	44410813    	44410147       	44410813       	19        	0         	19             	DEL       
chr21       	44430401    	44430728    	44430418       	44430728       	5         	27        	32             	DEL       
chr21       	45437110    	45437358    	45437050       	45437966       	4         	0         	4              	DEL       
chr21       	45510950    	45511011    	45510951       	45511020       	0         	5         	5              	DEL       
chr21       	45797819    	45798629    	45797819       	45798627       	19        	0         	19             	DUP       
chr21       	45844793    	45844871    	45844815       	45844875       	1         	4         	5              	DEL       
chr21       	45968106    	45969810    	45968115       	45969810       	15        	16        	31             	DEL       
chr21       	46034665    	46035424    	46034666       	46035424       	7         	0         	7              	DEL       
chr21       	46237436    	46238759    	46237438       	46238759       	20        	10        	30             	DEL       
chr22       	10710930    	10711693    	10710932       	10711692       	18        	17        	35             	DEL       
chr22       	10717411    	10722204    	10717159       	10722269       	4         	0         	4              	DEL       
chr22       	16071095    	16071580    	16071096       	16071580       	13        	0         	13             	DEL       
chr22       	17289459    	17298218    	17289460       	17298218       	20        	2         	22             	DEL       
chr22       	17616749    	17617060    	17616766       	17617060       	1         	18        	19             	DEL       
chr22       	17801129    	17801452    	17801149       	17801452       	0         	7         	7              	DEL       
chr22       	18105953    	18106653    	18105953       	18106610       	4         	0         	4              	DUP       
chr22       	18990061    	18990127    	18990060       	18990127       	0         	7         	7              	DEL       
chr22       	20075149    	20075615    	20075227       	20075613       	5         	0         	5              	DUP       
chr22       	20356429    	20361055    	20356430       	20361055       	4         	0         	4              	DUP       
chr22       	20356429    	20361055    	20356277       	20360576       	5         	0         	5              	DEL       
chr22       	20596334    	20599552    	20596336       	20599552       	17        	3         	20             	DEL       
chr22       	22353230    	22376007    	22349514       	22372659       	4         	0         	4              	DEL       
chr22       	22353230    	22376007    	22352906       	22375947       	5         	0         	5              	DUP       
chr22       	22353230    	22376007    	22353009       	22375685       	10        	0         	10             	DEL       
chr22       	22352703    	22375949    	22349514       	22372659       	4         	0         	4              	DEL       
chr22       	22352703    	22375949    	22352906       	22375947       	5         	0         	5              	DUP       
chr22       	22352703    	22375949    	22353009       	22375685       	10        	0         	10             	DEL       
chr22       	22672661    	22738212    	22672661       	22738210       	9         	0         	9              	DUP       
chr22       	22672661    	22738212    	22672871       	22738576       	8         	0         	8              	DEL       
chr22       	22672661    	22738212    	22707394       	22765496       	8         	0         	8              	DUP       
chr22       	22672872    	22738577    	22672661       	22738210       	9         	0         	9              	DUP       
chr22       	22672872    	22738577    	22672871       	22738576       	8         	0         	8              	DEL       
chr22       	22672872    	22738577    	22707394       	22765496       	8         	0         	8              	DUP       
chr22       	22707361    	22765498    	22759206       	22905093       	5         	0         	5              	DEL       
chr22       	22707361    	22765498    	22672661       	22738210       	9         	0         	9              	DUP       
chr22       	22707361    	22765498    	22672871       	22738576       	8         	0         	8              	DEL       
chr22       	22707361    	22765498    	22707394       	22765496       	8         	0         	8              	DUP       
chr22       	22759206    	22904987    	22759206       	22905093       	5         	0         	5              	DEL       
chr22       	22759206    	22904987    	22707394       	22765496       	8         	0         	8              	DUP       
chr22       	23136176    	23137402    	23136219       	23137394       	10        	0         	10             	DEL       
chr22       	23683429    	23685351    	23683431       	23685351       	18        	6         	24             	DEL       
chr22       	23712694    	23712766    	23712698       	23712766       	0         	9         	9              	DEL       
chr22       	23853745    	23856318    	23853754       	23856318       	56        	25        	81             	DEL       
chr22       	23931954    	23969108    	23936380       	23937905       	12        	0         	12             	DEL       
chr22       	23931954    	23969108    	23931957       	23969108       	25        	2         	27             	DEL       
chr22       	23936380    	23937901    	23936380       	23937905       	12        	0         	12             	DEL       
chr22       	25245952    	25470591    	25245951       	25470590       	6         	0         	6              	DEL       
chr22       	25245952    	25470591    	25415721       	25559958       	6         	0         	6              	DEL       
chr22       	25245952    	25470591    	25416521       	25560457       	6         	0         	6              	DUP       
chr22       	25245952    	25470591    	25287999       	25584518       	5         	0         	5              	DEL       
chr22       	25245952    	25470591    	25288724       	25585288       	18        	0         	18             	DUP       
chr22       	25245952    	25470591    	25290338       	25586739       	8         	0         	8              	DUP       
chr22       	25288645    	25585325    	25245951       	25470590       	6         	0         	6              	DEL       
chr22       	25288645    	25585325    	25415721       	25559958       	6         	0         	6              	DEL       
chr22       	25288645    	25585325    	25416521       	25560457       	6         	0         	6              	DUP       
chr22       	25288645    	25585325    	25287999       	25584518       	5         	0         	5              	DEL       
chr22       	25288645    	25585325    	25288724       	25585288       	18        	0         	18             	DUP       
chr22       	25288645    	25585325    	25290338       	25586739       	8         	0         	8              	DUP       
chr22       	25290338    	25586741    	25245951       	25470590       	6         	0         	6              	DEL       
chr22       	25290338    	25586741    	25415721       	25559958       	6         	0         	6              	DEL       
chr22       	25290338    	25586741    	25416521       	25560457       	6         	0         	6              	DUP       
chr22       	25290338    	25586741    	25287999       	25584518       	5         	0         	5              	DEL       
chr22       	25290338    	25586741    	25288724       	25585288       	18        	0         	18             	DUP       
chr22       	25290338    	25586741    	25290338       	25586739       	8         	0         	8              	DUP       
chr22       	25415722    	25559959    	25245951       	25470590       	6         	0         	6              	DEL       
chr22       	25415722    	25559959    	25415721       	25559958       	6         	0         	6              	DEL       
chr22       	25415722    	25559959    	25416521       	25560457       	6         	0         	6              	DUP       
chr22       	25416521    	25560459    	25245951       	25470590       	6         	0         	6              	DEL       
chr22       	25416521    	25560459    	25415721       	25559958       	6         	0         	6              	DEL       
chr22       	25416521    	25560459    	25416521       	25560457       	6         	0         	6              	DUP       
chr22       	26495547    	26495684    	26495553       	26495677       	1         	3         	4              	DEL       
chr22       	26772102    	26773829    	26772113       	26773829       	38        	25        	63             	DEL       
chr22       	26979711    	26979815    	26979733       	26979815       	0         	9         	9              	DEL       
chr22       	28781332    	28781651    	28781346       	28781650       	1         	8         	9              	DEL       
chr22       	29237096    	29239401    	29237100       	29239401       	22        	8         	30             	DEL       
chr22       	31023928    	31024864    	31023941       	31024841       	21        	0         	21             	DEL       
chr22       	32899771    	32900090    	32899786       	32900090       	3         	12        	15             	DEL       
chr22       	33355628    	33355780    	33355631       	33355780       	0         	25        	25             	DEL       
chr22       	33384460    	33387352    	33384461       	33387352       	9         	2         	11             	DEL       
chr22       	34278666    	34278798    	34278683       	34278797       	0         	4         	4              	DEL       
chr22       	34791777    	34819892    	34791776       	34819891       	8         	0         	8              	DEL       
chr22       	35249170    	35250146    	35249173       	35250146       	27        	7         	34             	DEL       
chr22       	35692411    	35698474    	35692410       	35698473       	7         	0         	7              	DEL       
chr22       	35692411    	35698474    	35692781       	35699225       	5         	0         	5              	DUP       
chr22       	35737459    	35738226    	35737477       	35738198       	17        	0         	17             	DEL       
chr22       	36731027    	36731201    	36731044       	36731200       	0         	11        	11             	DEL       
chr22       	36747124    	36751851    	36747141       	36751834       	35        	0         	35             	DEL       
chr22       	37509669    	37510148    	37509695       	37510148       	7         	7         	14             	DEL       
chr22       	40398218    	40399238    	40398265       	40399241       	21        	0         	21             	DEL       
chr22       	42705437    	42706320    	42705457       	42706183       	31        	0         	31             	DEL       
chr22       	43515102    	43515222    	43515103       	43515222       	0         	7         	7              	DEL       
chr22       	43834314    	43835107    	43834315       	43835107       	9         	0         	9              	DEL       
chr22       	45349191    	45350212    	45349604       	45350565       	9         	0         	9              	DUP       
chr22       	45349191    	45350212    	45349401       	45350320       	17        	0         	17             	DEL       
chr22       	45349557    	45350500    	45349604       	45350565       	9         	0         	9              	DUP       
chr22       	45349557    	45350500    	45349401       	45350320       	17        	0         	17             	DEL       
chr22       	45479138    	45479470    	45479153       	45479469       	1         	10        	11             	DEL       
chr22       	45568583    	45568803    	45568743       	45568803       	0         	4         	4              	DEL       
chr22       	47300712    	47301109    	47300719       	47301109       	3         	7         	10             	DEL       
chr22       	48249397    	48249716    	48249411       	48249716       	0         	13        	13             	DEL       
chr22       	48667790    	48668674    	48667791       	48668674       	9         	0         	9              	DEL       
chr22       	49226584    	49228372    	49226590       	49228371       	2         	6         	8              	DEL       
chr22       	49226584    	49228372    	49226585       	49228448       	5         	3         	8              	DUP       
chr22       	49226674    	49228449    	49226590       	49228371       	2         	6         	8              	DEL       
chr22       	49226674    	49228449    	49226585       	49228448       	5         	3         	8              	DUP       
chr22       	49319852    	49321518    	49319854       	49321518       	10        	3         	13             	DEL       
chr22       	49384117    	49386133    	49384026       	49386132       	5         	0         	5              	DEL       
chr22       	50681408    	50682823    	50681407       	50682436       	10        	0         	10             	DEL       
chr3        	134467      	135320      	134542         	135518         	20        	0         	20             	DEL       
chr3        	940904      	941221      	940913         	941221         	1         	8         	9              	DEL       
chr3        	1103136     	1987635     	1707799        	1708401        	4         	0         	4              	DEL       
chr3        	1103136     	1987635     	1102956        	1987583        	15        	0         	15             	DEL       
chr3        	1103136     	1987635     	1880168        	5919211        	5         	0         	5              	DEL       
chr3        	1103136     	1987635     	1880354        	5919400        	6         	0         	6              	DUP       
chr3        	1707798     	1708401     	1707799        	1708401        	4         	0         	4              	DEL       
chr3        	1880217     	5919239     	1102956        	1987583        	15        	0         	15             	DEL       
chr3        	1880217     	5919239     	2269905        	2270250        	4         	7         	11             	DEL       
chr3        	1880217     	5919239     	2980337        	2980427        	0         	7         	7              	DEL       
chr3        	1880217     	5919239     	3116976        	3117035        	0         	13        	13             	DEL       
chr3        	1880217     	5919239     	3831533        	3831849        	1         	11        	12             	DEL       
chr3        	1880217     	5919239     	4025253        	4027871        	59        	21        	80             	DEL       
chr3        	1880217     	5919239     	1880168        	5919211        	5         	0         	5              	DEL       
chr3        	1880217     	5919239     	1880354        	5919400        	6         	0         	6              	DUP       
chr3        	1880357     	5919371     	1102956        	1987583        	15        	0         	15             	DEL       
chr3        	1880357     	5919371     	2269905        	2270250        	4         	7         	11             	DEL       
chr3        	1880357     	5919371     	2980337        	2980427        	0         	7         	7              	DEL       
chr3        	1880357     	5919371     	3116976        	3117035        	0         	13        	13             	DEL       
chr3        	1880357     	5919371     	3831533        	3831849        	1         	11        	12             	DEL       
chr3        	1880357     	5919371     	4025253        	4027871        	59        	21        	80             	DEL       
chr3        	1880357     	5919371     	1880168        	5919211        	5         	0         	5              	DEL       
chr3        	1880357     	5919371     	1880354        	5919400        	6         	0         	6              	DUP       
chr3        	2269901     	2270250     	2269905        	2270250        	4         	7         	11             	DEL       
chr3        	2980333     	2980427     	2980337        	2980427        	0         	7         	7              	DEL       
chr3        	3116965     	3117035     	3116976        	3117035        	0         	13        	13             	DEL       
chr3        	3831519     	3831849     	3831533        	3831849        	1         	11        	12             	DEL       
chr3        	4025239     	4027871     	4025253        	4027871        	59        	21        	80             	DEL       
chr3        	5992541     	5993013     	5992554        	5993013        	0         	5         	5              	DEL       
chr3        	6608472     	6612945     	6608472        	6612950        	17        	0         	17             	DEL       
chr3        	6659182     	6659566     	6659187        	6659566        	4         	16        	20             	DEL       
chr3        	7305336     	7305635     	7305342        	7305635        	2         	15        	17             	DEL       
chr3        	7778823     	7778909     	7778824        	7778878        	0         	7         	7              	DEL       
chr3        	7864258     	7864463     	7864261        	7864463        	0         	8         	8              	DEL       
chr3        	8283950     	8285124     	8283952        	8285124        	22        	11        	33             	DEL       
chr3        	8678473     	8679350     	8678483        	8679350        	35        	1         	36             	DEL       
chr3        	10046581    	11870462    	10780072       	10780235       	0         	6         	6              	DEL       
chr3        	10046581    	11870462    	11604258       	11605253       	12        	0         	12             	DEL       
chr3        	10046581    	11870462    	10046555       	11870471       	5         	0         	5              	DUP       
chr3        	10780071    	10780235    	10780072       	10780235       	0         	6         	6              	DEL       
chr3        	11604257    	11605253    	11604258       	11605253       	12        	0         	12             	DEL       
chr3        	11914387    	12871878    	11914386       	12871877       	11        	0         	11             	DEL       
chr3        	11914387    	12871878    	11914671       	12872101       	4         	0         	4              	DUP       
chr3        	11914387    	12871878    	12563719       	18246074       	7         	0         	7              	DUP       
chr3        	11914670    	12872101    	11914386       	12871877       	11        	0         	11             	DEL       
chr3        	11914670    	12872101    	11914671       	12872101       	4         	0         	4              	DUP       
chr3        	11914670    	12872101    	12563719       	18246074       	7         	0         	7              	DUP       
chr3        	12563712    	18246076    	11914386       	12871877       	11        	0         	11             	DEL       
chr3        	12563712    	18246076    	11914671       	12872101       	4         	0         	4              	DUP       
chr3        	12563712    	18246076    	13931654       	14809268       	0         	5         	5              	DUP       
chr3        	12563712    	18246076    	12563719       	18246074       	7         	0         	7              	DUP       
chr3        	13931653    	14809268    	13931654       	14809268       	0         	5         	5              	DUP       
chr3        	18714324    	18714634    	18714338       	18714634       	1         	7         	8              	DEL       
chr3        	20968024    	20972011    	20968028       	20972011       	15        	6         	21             	DEL       
chr3        	21416004    	21416328    	21416016       	21416328       	2         	21        	23             	DEL       
chr3        	23722565    	23722896    	23722582       	23722896       	1         	10        	11             	DEL       
chr3        	24049294    	24049551    	24049307       	24049551       	1         	8         	9              	DEL       
chr3        	24989395    	24990758    	24989396       	24990758       	51        	11        	62             	DEL       
chr3        	26082355    	26082484    	26082357       	26082484       	0         	4         	4              	DEL       
chr3        	26409477    	26410807    	26409479       	26410807       	47        	17        	64             	DEL       
chr3        	27388825    	27388942    	27388822       	27388942       	0         	11        	11             	DEL       
chr3        	28125964    	28126291    	28125982       	28126291       	0         	16        	16             	DEL       
chr3        	32060557    	32066391    	32060560       	32066390       	48        	30        	78             	DEL       
chr3        	32162368    	32162651    	32162385       	32162651       	2         	6         	8              	DEL       
chr3        	32379088    	32379238    	32379095       	32379223       	0         	8         	8              	DEL       
chr3        	32765253    	32766569    	32765306       	32766537       	40        	0         	40             	DEL       
chr3        	32899265    	32899362    	32899269       	32899362       	0         	27        	27             	DEL       
chr3        	33511696    	33512584    	33511715       	33512583       	16        	8         	24             	DEL       
chr3        	35010164    	35010493    	35010179       	35010493       	2         	21        	23             	DEL       
chr3        	41295188    	41295738    	41295190       	41295738       	19        	16        	35             	DEL       
chr3        	42796863    	42799318    	42796881       	42799318       	37        	15        	52             	DEL       
chr3        	42989599    	42989928    	42989614       	42989928       	2         	14        	16             	DEL       
chr3        	44510749    	44510802    	44510750       	44510802       	0         	7         	7              	DEL       
chr3        	44699529    	44700806    	44699528       	44700774       	56        	0         	56             	INV       
chr3        	44833615    	44833692    	44833616       	44833692       	0         	8         	8              	DEL       
chr3        	45726858    	45727184    	45726869       	45727184       	0         	7         	7              	DEL       
chr3        	46004379    	46004637    	46004380       	46004637       	0         	8         	8              	DEL       
chr3        	47449176    	47451950    	47449179       	47451950       	17        	6         	23             	DEL       
chr3        	48920439    	48921404    	48920440       	48921404       	8         	0         	8              	DEL       
chr3        	49160315    	49160639    	49160330       	49160639       	1         	6         	7              	DEL       
chr3        	49456842    	49457172    	49456854       	49457172       	2         	16        	18             	DEL       
chr3        	49938791    	49939455    	49938792       	49939455       	17        	0         	17             	DEL       
chr3        	52675820    	52676157    	52675833       	52676156       	4         	16        	20             	DEL       
chr3        	55324417    	55324511    	55324420       	55324511       	0         	5         	5              	DEL       
chr3        	56570670    	56570927    	56570672       	56570927       	0         	13        	13             	DEL       
chr3        	57536919    	57538276    	57536919       	57538314       	5         	3         	8              	DUP       
chr3        	57536919    	57538276    	57536983       	57538324       	4         	4         	8              	DEL       
chr3        	57536982    	57538324    	57536919       	57538314       	5         	3         	8              	DUP       
chr3        	57536982    	57538324    	57536983       	57538324       	4         	4         	8              	DEL       
chr3        	59507334    	59507455    	59507335       	59507455       	1         	7         	8              	DEL       
chr3        	60131022    	60131096    	60131029       	60131082       	0         	7         	7              	DEL       
chr3        	60369068    	60369203    	60369095       	60369203       	0         	10        	10             	DEL       
chr3        	63149179    	63149633    	63149181       	63149633       	3         	12        	15             	DEL       
chr3        	66063568    	66063883    	66063585       	66063883       	0         	6         	6              	DEL       
chr3        	66074253    	66074861    	66074254       	66074905       	9         	0         	9              	DUP       
chr3        	66274529    	94795079    	90867452       	90964372       	6         	0         	6              	DEL       
chr3        	66274529    	94795079    	68690531       	68698712       	58        	18        	76             	DEL       
chr3        	66274529    	94795079    	90536618       	90537905       	27        	0         	27             	DEL       
chr3        	66274529    	94795079    	90996432       	91030454       	4         	0         	4              	DEL       
chr3        	66274529    	94795079    	90863008       	91078900       	12        	0         	12             	DEL       
chr3        	66274529    	94795079    	90986361       	91111418       	6         	0         	6              	DEL       
chr3        	66274529    	94795079    	90845332       	91144059       	4         	0         	4              	DUP       
chr3        	66274529    	94795079    	66712829       	66712895       	0         	7         	7              	DEL       
chr3        	66274529    	94795079    	67443284       	67446375       	36        	16        	52             	DEL       
chr3        	66274529    	94795079    	67903781       	68076796       	5         	0         	5              	DUP       
chr3        	66274529    	94795079    	67903284       	68076553       	10        	0         	10             	DEL       
chr3        	66274529    	94795079    	68585622       	68591102       	24        	8         	32             	DEL       
chr3        	66274529    	94795079    	68821339       	68821612       	2         	21        	23             	DEL       
chr3        	66274529    	94795079    	68841064       	68841344       	2         	23        	25             	DEL       
chr3        	66274529    	94795079    	69964325       	69964736       	3         	19        	22             	DEL       
chr3        	66274529    	94795079    	70365970       	70366289       	2         	23        	25             	DEL       
chr3        	66274529    	94795079    	72554832       	72555429       	0         	4         	4              	DEL       
chr3        	66274529    	94795079    	74716275       	74716584       	0         	19        	19             	DEL       
chr3        	66274529    	94795079    	74740734       	74740795       	0         	18        	18             	DEL       
chr3        	66274529    	94795079    	77290247       	77291073       	8         	0         	8              	DEL       
chr3        	66274529    	94795079    	77293557       	77294144       	4         	0         	4              	DUP       
chr3        	66274529    	94795079    	77293463       	77294439       	11        	0         	11             	DEL       
chr3        	66274529    	94795079    	78182670       	78182763       	1         	6         	7              	DEL       
chr3        	66274529    	94795079    	78373186       	78373304       	0         	6         	6              	DEL       
chr3        	66274529    	94795079    	79760749       	79760819       	0         	9         	9              	DEL       
chr3        	66274529    	94795079    	80013715       	80015319       	14        	0         	14             	DEL       
chr3        	66274529    	94795079    	80876163       	80877453       	54        	19        	73             	DEL       
chr3        	66274529    	94795079    	81296931       	81297229       	1         	13        	14             	DEL       
chr3        	66274529    	94795079    	81858356       	81858661       	4         	25        	29             	DEL       
chr3        	66274529    	94795079    	82464980       	82465632       	4         	0         	4              	DEL       
chr3        	66274529    	94795079    	82887507       	82887806       	3         	7         	10             	DEL       
chr3        	66274529    	94795079    	83803977       	83806198       	51        	11        	62             	DEL       
chr3        	66274529    	94795079    	84055791       	84058233       	23        	7         	30             	DEL       
chr3        	66274529    	94795079    	84650400       	84653672       	21        	0         	21             	DEL       
chr3        	66274529    	94795079    	86164256       	86164570       	0         	7         	7              	DEL       
chr3        	66274529    	94795079    	90072952       	90073044       	0         	5         	5              	DEL       
chr3        	66274529    	94795079    	90326536       	90327522       	4         	0         	4              	DEL       
chr3        	66274529    	94795079    	90350664       	90351555       	24        	0         	24             	DUP       
chr3        	66274529    	94795079    	90353301       	90353450       	4         	0         	4              	DEL       
chr3        	66274529    	94795079    	90402975       	90403697       	9         	0         	9              	DUP       
chr3        	66274529    	94795079    	90411306       	90411978       	4         	0         	4              	DEL       
chr3        	66274529    	94795079    	90496542       	90497496       	4         	0         	4              	DEL       
chr3        	66274529    	94795079    	90498503       	90499104       	10        	0         	10             	DUP       
chr3        	66274529    	94795079    	90498592       	90598131       	45        	0         	45             	DUP       
chr3        	66274529    	94795079    	90499061       	90597574       	38        	0         	38             	DEL       
chr3        	66274529    	94795079    	90784517       	90862986       	4         	0         	4              	DEL       
chr3        	66274529    	94795079    	90861626       	90863195       	6         	0         	6              	DUP       
chr3        	66274529    	94795079    	90810147       	90885534       	4         	0         	4              	DUP       
chr3        	66274529    	94795079    	90866608       	90886631       	4         	0         	4              	DUP       
chr3        	66274529    	94795079    	90870539       	90896165       	6         	0         	6              	DEL       
chr3        	66274529    	94795079    	90785208       	90900680       	4         	0         	4              	DEL       
chr3        	66274529    	94795079    	90824054       	90965956       	4         	0         	4              	DEL       
chr3        	66274529    	94795079    	90966616       	90982026       	5         	0         	5              	DEL       
chr3        	66274529    	94795079    	90963720       	90986129       	4         	0         	4              	DEL       
chr3        	66274529    	94795079    	90913556       	90989827       	4         	0         	4              	DUP       
chr3        	66274529    	94795079    	90913522       	91000042       	4         	0         	4              	DUP       
chr3        	66274529    	94795079    	90784906       	91066719       	6         	0         	6              	DUP       
chr3        	66274529    	94795079    	90925403       	91069725       	8         	0         	8              	DUP       
chr3        	66274529    	94795079    	90964718       	91070268       	8         	0         	8              	DEL       
chr3        	66274529    	94795079    	90845656       	91075959       	6         	0         	6              	DEL       
chr3        	66274529    	94795079    	90925708       	91087307       	6         	0         	6              	DEL       
chr3        	66274529    	94795079    	91042931       	91113828       	10        	0         	10             	DEL       
chr3        	66274529    	94795079    	91066677       	91114117       	7         	0         	7              	DUP       
chr3        	66274529    	94795079    	91060137       	91116965       	5         	0         	5              	DUP       
chr3        	66274529    	94795079    	91003932       	91123472       	6         	0         	6              	DUP       
chr3        	66274529    	94795079    	90903737       	91133802       	4         	0         	4              	DUP       
chr3        	66274529    	94795079    	91067092       	91159133       	6         	0         	6              	DEL       
chr3        	66274529    	94795079    	90840263       	91159539       	4         	0         	4              	DUP       
chr3        	66274529    	94795079    	91137007       	91166110       	4         	0         	4              	DEL       
chr3        	66274529    	94795079    	91116722       	91171050       	6         	0         	6              	DUP       
chr3        	66274529    	94795079    	91005152       	91193196       	4         	0         	4              	DEL       
chr3        	66274529    	94795079    	91042929       	91220692       	8         	0         	8              	DEL       
chr3        	66274529    	94795079    	90870921       	91221939       	8         	0         	8              	DEL       
chr3        	66274529    	94795079    	91557671       	91561028       	9         	0         	9              	DEL       
chr3        	66274529    	94795079    	92133504       	92647322       	4         	0         	4              	DEL       
chr3        	66274529    	94795079    	91561285       	92705447       	5         	0         	5              	DEL       
chr3        	66274529    	94795079    	92705767       	93135173       	4         	0         	4              	DEL       
chr3        	66274529    	94795079    	91579405       	93232972       	9         	0         	9              	DEL       
chr3        	66274529    	94795079    	93736486       	93737230       	11        	0         	11             	DUP       
chr3        	66274529    	94795079    	66274529       	94795077       	6         	0         	6              	DUP       
chr3        	66274529    	94795079    	94792985       	94795652       	13        	0         	13             	DUP       
chr3        	66712828    	66712895    	66712829       	66712895       	0         	7         	7              	DEL       
chr3        	67443270    	67446375    	67443284       	67446375       	36        	16        	52             	DEL       
chr3        	67903312    	68076379    	67903781       	68076796       	5         	0         	5              	DUP       
chr3        	67903312    	68076379    	67903284       	68076553       	10        	0         	10             	DEL       
chr3        	67903781    	68076798    	67903781       	68076796       	5         	0         	5              	DUP       
chr3        	67903781    	68076798    	67903284       	68076553       	10        	0         	10             	DEL       
chr3        	68585618    	68591102    	68585622       	68591102       	24        	8         	32             	DEL       
chr3        	68690530    	68698707    	68690531       	68698712       	58        	18        	76             	DEL       
chr3        	68821322    	68821612    	68821339       	68821612       	2         	21        	23             	DEL       
chr3        	68841052    	68841344    	68841064       	68841344       	2         	23        	25             	DEL       
chr3        	69964322    	69964736    	69964325       	69964736       	3         	19        	22             	DEL       
chr3        	70365953    	70366289    	70365970       	70366289       	2         	23        	25             	DEL       
chr3        	74716260    	74716584    	74716275       	74716584       	0         	19        	19             	DEL       
chr3        	74740719    	74740795    	74740734       	74740795       	0         	18        	18             	DEL       
chr3        	77290246    	77291073    	77290247       	77291073       	8         	0         	8              	DEL       
chr3        	77293557    	77294146    	77293557       	77294144       	4         	0         	4              	DUP       
chr3        	77293557    	77294146    	77293463       	77294439       	11        	0         	11             	DEL       
chr3        	77293462    	77294439    	77293557       	77294144       	4         	0         	4              	DUP       
chr3        	77293462    	77294439    	77293463       	77294439       	11        	0         	11             	DEL       
chr3        	78182669    	78182763    	78182670       	78182763       	1         	6         	7              	DEL       
chr3        	78373177    	78373319    	78373186       	78373304       	0         	6         	6              	DEL       
chr3        	79760748    	79760819    	79760749       	79760819       	0         	9         	9              	DEL       
chr3        	80013782    	80015257    	80013715       	80015319       	14        	0         	14             	DEL       
chr3        	80876159    	80877454    	80876163       	80877453       	54        	19        	73             	DEL       
chr3        	81296913    	81297229    	81296931       	81297229       	1         	13        	14             	DEL       
chr3        	81858340    	81858661    	81858356       	81858661       	4         	25        	29             	DEL       
chr3        	82465134    	82465628    	82464980       	82465632       	4         	0         	4              	DEL       
chr3        	82887504    	82887807    	82887507       	82887806       	3         	7         	10             	DEL       
chr3        	83803963    	83806198    	83803977       	83806198       	51        	11        	62             	DEL       
chr3        	84055790    	84058233    	84055791       	84058233       	23        	7         	30             	DEL       
chr3        	84650348    	84653793    	84650400       	84653672       	21        	0         	21             	DEL       
chr3        	86164252    	86164570    	86164256       	86164570       	0         	7         	7              	DEL       
chr3        	90350669    	90351524    	90350664       	90351555       	24        	0         	24             	DUP       
chr3        	90402954    	90403643    	90402975       	90403697       	9         	0         	9              	DUP       
chr3        	90498503    	90499106    	90498503       	90499104       	10        	0         	10             	DUP       
chr3        	90498503    	90499106    	90498592       	90598131       	45        	0         	45             	DUP       
chr3        	90498503    	90499106    	90499061       	90597574       	38        	0         	38             	DEL       
chr3        	90498678    	90597461    	90536618       	90537905       	27        	0         	27             	DEL       
chr3        	90498678    	90597461    	90498503       	90499104       	10        	0         	10             	DUP       
chr3        	90498678    	90597461    	90498592       	90598131       	45        	0         	45             	DUP       
chr3        	90498678    	90597461    	90499061       	90597574       	38        	0         	38             	DEL       
chr3        	90498691    	90598155    	90536618       	90537905       	27        	0         	27             	DEL       
chr3        	90498691    	90598155    	90498503       	90499104       	10        	0         	10             	DUP       
chr3        	90498691    	90598155    	90498592       	90598131       	45        	0         	45             	DUP       
chr3        	90498691    	90598155    	90499061       	90597574       	38        	0         	38             	DEL       
chr3        	90536619    	90537979    	90536618       	90537905       	27        	0         	27             	DEL       
chr3        	90784623    	90862960    	90863008       	91078900       	12        	0         	12             	DEL       
chr3        	90784623    	90862960    	90845332       	91144059       	4         	0         	4              	DUP       
chr3        	90784623    	90862960    	90784517       	90862986       	4         	0         	4              	DEL       
chr3        	90784623    	90862960    	90861626       	90863195       	6         	0         	6              	DUP       
chr3        	90784623    	90862960    	90810147       	90885534       	4         	0         	4              	DUP       
chr3        	90784623    	90862960    	90785208       	90900680       	4         	0         	4              	DEL       
chr3        	90784623    	90862960    	90824054       	90965956       	4         	0         	4              	DEL       
chr3        	90784623    	90862960    	90784906       	91066719       	6         	0         	6              	DUP       
chr3        	90784623    	90862960    	90845656       	91075959       	6         	0         	6              	DEL       
chr3        	90784623    	90862960    	90840263       	91159539       	4         	0         	4              	DUP       
chr3        	90785207    	90900680    	90867452       	90964372       	6         	0         	6              	DEL       
chr3        	90785207    	90900680    	90863008       	91078900       	12        	0         	12             	DEL       
chr3        	90785207    	90900680    	90845332       	91144059       	4         	0         	4              	DUP       
chr3        	90785207    	90900680    	90784517       	90862986       	4         	0         	4              	DEL       
chr3        	90785207    	90900680    	90861626       	90863195       	6         	0         	6              	DUP       
chr3        	90785207    	90900680    	90810147       	90885534       	4         	0         	4              	DUP       
chr3        	90785207    	90900680    	90866608       	90886631       	4         	0         	4              	DUP       
chr3        	90785207    	90900680    	90870539       	90896165       	6         	0         	6              	DEL       
chr3        	90785207    	90900680    	90785208       	90900680       	4         	0         	4              	DEL       
chr3        	90785207    	90900680    	90824054       	90965956       	4         	0         	4              	DEL       
chr3        	90785207    	90900680    	90845656       	91075959       	6         	0         	6              	DEL       
chr3        	90785207    	90900680    	90840263       	91159539       	4         	0         	4              	DUP       
chr3        	90785207    	90900680    	90870921       	91221939       	8         	0         	8              	DEL       
chr3        	90784905    	91066719    	90867452       	90964372       	6         	0         	6              	DEL       
chr3        	90784905    	91066719    	90996432       	91030454       	4         	0         	4              	DEL       
chr3        	90784905    	91066719    	90863008       	91078900       	12        	0         	12             	DEL       
chr3        	90784905    	91066719    	90986361       	91111418       	6         	0         	6              	DEL       
chr3        	90784905    	91066719    	90845332       	91144059       	4         	0         	4              	DUP       
chr3        	90784905    	91066719    	90784517       	90862986       	4         	0         	4              	DEL       
chr3        	90784905    	91066719    	90861626       	90863195       	6         	0         	6              	DUP       
chr3        	90784905    	91066719    	90810147       	90885534       	4         	0         	4              	DUP       
chr3        	90784905    	91066719    	90866608       	90886631       	4         	0         	4              	DUP       
chr3        	90784905    	91066719    	90870539       	90896165       	6         	0         	6              	DEL       
chr3        	90784905    	91066719    	90785208       	90900680       	4         	0         	4              	DEL       
chr3        	90784905    	91066719    	90824054       	90965956       	4         	0         	4              	DEL       
chr3        	90784905    	91066719    	90966616       	90982026       	5         	0         	5              	DEL       
chr3        	90784905    	91066719    	90963720       	90986129       	4         	0         	4              	DEL       
chr3        	90784905    	91066719    	90913556       	90989827       	4         	0         	4              	DUP       
chr3        	90784905    	91066719    	90913522       	91000042       	4         	0         	4              	DUP       
chr3        	90784905    	91066719    	90784906       	91066719       	6         	0         	6              	DUP       
chr3        	90784905    	91066719    	90925403       	91069725       	8         	0         	8              	DUP       
chr3        	90784905    	91066719    	90964718       	91070268       	8         	0         	8              	DEL       
chr3        	90784905    	91066719    	90845656       	91075959       	6         	0         	6              	DEL       
chr3        	90784905    	91066719    	90925708       	91087307       	6         	0         	6              	DEL       
chr3        	90784905    	91066719    	91042931       	91113828       	10        	0         	10             	DEL       
chr3        	90784905    	91066719    	91066677       	91114117       	7         	0         	7              	DUP       
chr3        	90784905    	91066719    	91060137       	91116965       	5         	0         	5              	DUP       
chr3        	90784905    	91066719    	91003932       	91123472       	6         	0         	6              	DUP       
chr3        	90784905    	91066719    	90903737       	91133802       	4         	0         	4              	DUP       
chr3        	90784905    	91066719    	90840263       	91159539       	4         	0         	4              	DUP       
chr3        	90784905    	91066719    	91005152       	91193196       	4         	0         	4              	DEL       
chr3        	90784905    	91066719    	91042929       	91220692       	8         	0         	8              	DEL       
chr3        	90784905    	91066719    	90870921       	91221939       	8         	0         	8              	DEL       
chr3        	90810146    	90885534    	90867452       	90964372       	6         	0         	6              	DEL       
chr3        	90810146    	90885534    	90863008       	91078900       	12        	0         	12             	DEL       
chr3        	90810146    	90885534    	90845332       	91144059       	4         	0         	4              	DUP       
chr3        	90810146    	90885534    	90784517       	90862986       	4         	0         	4              	DEL       
chr3        	90810146    	90885534    	90861626       	90863195       	6         	0         	6              	DUP       
chr3        	90810146    	90885534    	90810147       	90885534       	4         	0         	4              	DUP       
chr3        	90810146    	90885534    	90866608       	90886631       	4         	0         	4              	DUP       
chr3        	90810146    	90885534    	90870539       	90896165       	6         	0         	6              	DEL       
chr3        	90810146    	90885534    	90824054       	90965956       	4         	0         	4              	DEL       
chr3        	90810146    	90885534    	90845656       	91075959       	6         	0         	6              	DEL       
chr3        	90810146    	90885534    	90840263       	91159539       	4         	0         	4              	DUP       
chr3        	90810146    	90885534    	90870921       	91221939       	8         	0         	8              	DEL       
chr3        	90824053    	90965956    	90867452       	90964372       	6         	0         	6              	DEL       
chr3        	90824053    	90965956    	90863008       	91078900       	12        	0         	12             	DEL       
chr3        	90824053    	90965956    	90845332       	91144059       	4         	0         	4              	DUP       
chr3        	90824053    	90965956    	90784517       	90862986       	4         	0         	4              	DEL       
chr3        	90824053    	90965956    	90861626       	90863195       	6         	0         	6              	DUP       
chr3        	90824053    	90965956    	90810147       	90885534       	4         	0         	4              	DUP       
chr3        	90824053    	90965956    	90866608       	90886631       	4         	0         	4              	DUP       
chr3        	90824053    	90965956    	90870539       	90896165       	6         	0         	6              	DEL       
chr3        	90824053    	90965956    	90785208       	90900680       	4         	0         	4              	DEL       
chr3        	90824053    	90965956    	90824054       	90965956       	4         	0         	4              	DEL       
chr3        	90824053    	90965956    	90963720       	90986129       	4         	0         	4              	DEL       
chr3        	90824053    	90965956    	90913556       	90989827       	4         	0         	4              	DUP       
chr3        	90824053    	90965956    	90913522       	91000042       	4         	0         	4              	DUP       
chr3        	90824053    	90965956    	90925403       	91069725       	8         	0         	8              	DUP       
chr3        	90824053    	90965956    	90964718       	91070268       	8         	0         	8              	DEL       
chr3        	90824053    	90965956    	90845656       	91075959       	6         	0         	6              	DEL       
chr3        	90824053    	90965956    	90925708       	91087307       	6         	0         	6              	DEL       
chr3        	90824053    	90965956    	90903737       	91133802       	4         	0         	4              	DUP       
chr3        	90824053    	90965956    	90840263       	91159539       	4         	0         	4              	DUP       
chr3        	90824053    	90965956    	90870921       	91221939       	8         	0         	8              	DEL       
chr3        	90840262    	91159539    	90867452       	90964372       	6         	0         	6              	DEL       
chr3        	90840262    	91159539    	90996432       	91030454       	4         	0         	4              	DEL       
chr3        	90840262    	91159539    	90863008       	91078900       	12        	0         	12             	DEL       
chr3        	90840262    	91159539    	90986361       	91111418       	6         	0         	6              	DEL       
chr3        	90840262    	91159539    	90845332       	91144059       	4         	0         	4              	DUP       
chr3        	90840262    	91159539    	90784517       	90862986       	4         	0         	4              	DEL       
chr3        	90840262    	91159539    	90861626       	90863195       	6         	0         	6              	DUP       
chr3        	90840262    	91159539    	90810147       	90885534       	4         	0         	4              	DUP       
chr3        	90840262    	91159539    	90866608       	90886631       	4         	0         	4              	DUP       
chr3        	90840262    	91159539    	90870539       	90896165       	6         	0         	6              	DEL       
chr3        	90840262    	91159539    	90785208       	90900680       	4         	0         	4              	DEL       
chr3        	90840262    	91159539    	90824054       	90965956       	4         	0         	4              	DEL       
chr3        	90840262    	91159539    	90966616       	90982026       	5         	0         	5              	DEL       
chr3        	90840262    	91159539    	90963720       	90986129       	4         	0         	4              	DEL       
chr3        	90840262    	91159539    	90913556       	90989827       	4         	0         	4              	DUP       
chr3        	90840262    	91159539    	90913522       	91000042       	4         	0         	4              	DUP       
chr3        	90840262    	91159539    	90784906       	91066719       	6         	0         	6              	DUP       
chr3        	90840262    	91159539    	90925403       	91069725       	8         	0         	8              	DUP       
chr3        	90840262    	91159539    	90964718       	91070268       	8         	0         	8              	DEL       
chr3        	90840262    	91159539    	90845656       	91075959       	6         	0         	6              	DEL       
chr3        	90840262    	91159539    	90925708       	91087307       	6         	0         	6              	DEL       
chr3        	90840262    	91159539    	91042931       	91113828       	10        	0         	10             	DEL       
chr3        	90840262    	91159539    	91066677       	91114117       	7         	0         	7              	DUP       
chr3        	90840262    	91159539    	91060137       	91116965       	5         	0         	5              	DUP       
chr3        	90840262    	91159539    	91003932       	91123472       	6         	0         	6              	DUP       
chr3        	90840262    	91159539    	90903737       	91133802       	4         	0         	4              	DUP       
chr3        	90840262    	91159539    	91067092       	91159133       	6         	0         	6              	DEL       
chr3        	90840262    	91159539    	90840263       	91159539       	4         	0         	4              	DUP       
chr3        	90840262    	91159539    	91137007       	91166110       	4         	0         	4              	DEL       
chr3        	90840262    	91159539    	91116722       	91171050       	6         	0         	6              	DUP       
chr3        	90840262    	91159539    	91005152       	91193196       	4         	0         	4              	DEL       
chr3        	90840262    	91159539    	91042929       	91220692       	8         	0         	8              	DEL       
chr3        	90840262    	91159539    	90870921       	91221939       	8         	0         	8              	DEL       
chr3        	90845655    	91075959    	90867452       	90964372       	6         	0         	6              	DEL       
chr3        	90845655    	91075959    	90996432       	91030454       	4         	0         	4              	DEL       
chr3        	90845655    	91075959    	90863008       	91078900       	12        	0         	12             	DEL       
chr3        	90845655    	91075959    	90986361       	91111418       	6         	0         	6              	DEL       
chr3        	90845655    	91075959    	90784517       	90862986       	4         	0         	4              	DEL       
chr3        	90845655    	91075959    	90861626       	90863195       	6         	0         	6              	DUP       
chr3        	90845655    	91075959    	90810147       	90885534       	4         	0         	4              	DUP       
chr3        	90845655    	91075959    	90866608       	90886631       	4         	0         	4              	DUP       
chr3        	90845655    	91075959    	90870539       	90896165       	6         	0         	6              	DEL       
chr3        	90845655    	91075959    	90785208       	90900680       	4         	0         	4              	DEL       
chr3        	90845655    	91075959    	90824054       	90965956       	4         	0         	4              	DEL       
chr3        	90845655    	91075959    	90966616       	90982026       	5         	0         	5              	DEL       
chr3        	90845655    	91075959    	90963720       	90986129       	4         	0         	4              	DEL       
chr3        	90845655    	91075959    	90913556       	90989827       	4         	0         	4              	DUP       
chr3        	90845655    	91075959    	90913522       	91000042       	4         	0         	4              	DUP       
chr3        	90845655    	91075959    	90784906       	91066719       	6         	0         	6              	DUP       
chr3        	90845655    	91075959    	90925403       	91069725       	8         	0         	8              	DUP       
chr3        	90845655    	91075959    	90964718       	91070268       	8         	0         	8              	DEL       
chr3        	90845655    	91075959    	90845656       	91075959       	6         	0         	6              	DEL       
chr3        	90845655    	91075959    	90925708       	91087307       	6         	0         	6              	DEL       
chr3        	90845655    	91075959    	91042931       	91113828       	10        	0         	10             	DEL       
chr3        	90845655    	91075959    	91066677       	91114117       	7         	0         	7              	DUP       
chr3        	90845655    	91075959    	91060137       	91116965       	5         	0         	5              	DUP       
chr3        	90845655    	91075959    	91003932       	91123472       	6         	0         	6              	DUP       
chr3        	90845655    	91075959    	90903737       	91133802       	4         	0         	4              	DUP       
chr3        	90845655    	91075959    	91067092       	91159133       	6         	0         	6              	DEL       
chr3        	90845655    	91075959    	91005152       	91193196       	4         	0         	4              	DEL       
chr3        	90845655    	91075959    	91042929       	91220692       	8         	0         	8              	DEL       
chr3        	90845655    	91075959    	90870921       	91221939       	8         	0         	8              	DEL       
chr3        	90845331    	91144059    	90867452       	90964372       	6         	0         	6              	DEL       
chr3        	90845331    	91144059    	90996432       	91030454       	4         	0         	4              	DEL       
chr3        	90845331    	91144059    	90863008       	91078900       	12        	0         	12             	DEL       
chr3        	90845331    	91144059    	90986361       	91111418       	6         	0         	6              	DEL       
chr3        	90845331    	91144059    	90845332       	91144059       	4         	0         	4              	DUP       
chr3        	90845331    	91144059    	90784517       	90862986       	4         	0         	4              	DEL       
chr3        	90845331    	91144059    	90861626       	90863195       	6         	0         	6              	DUP       
chr3        	90845331    	91144059    	90810147       	90885534       	4         	0         	4              	DUP       
chr3        	90845331    	91144059    	90866608       	90886631       	4         	0         	4              	DUP       
chr3        	90845331    	91144059    	90870539       	90896165       	6         	0         	6              	DEL       
chr3        	90845331    	91144059    	90785208       	90900680       	4         	0         	4              	DEL       
chr3        	90845331    	91144059    	90824054       	90965956       	4         	0         	4              	DEL       
chr3        	90845331    	91144059    	90966616       	90982026       	5         	0         	5              	DEL       
chr3        	90845331    	91144059    	90963720       	90986129       	4         	0         	4              	DEL       
chr3        	90845331    	91144059    	90913556       	90989827       	4         	0         	4              	DUP       
chr3        	90845331    	91144059    	90913522       	91000042       	4         	0         	4              	DUP       
chr3        	90845331    	91144059    	90784906       	91066719       	6         	0         	6              	DUP       
chr3        	90845331    	91144059    	90925403       	91069725       	8         	0         	8              	DUP       
chr3        	90845331    	91144059    	90964718       	91070268       	8         	0         	8              	DEL       
chr3        	90845331    	91144059    	90845656       	91075959       	6         	0         	6              	DEL       
chr3        	90845331    	91144059    	90925708       	91087307       	6         	0         	6              	DEL       
chr3        	90845331    	91144059    	91042931       	91113828       	10        	0         	10             	DEL       
chr3        	90845331    	91144059    	91066677       	91114117       	7         	0         	7              	DUP       
chr3        	90845331    	91144059    	91060137       	91116965       	5         	0         	5              	DUP       
chr3        	90845331    	91144059    	91003932       	91123472       	6         	0         	6              	DUP       
chr3        	90845331    	91144059    	90903737       	91133802       	4         	0         	4              	DUP       
chr3        	90845331    	91144059    	91067092       	91159133       	6         	0         	6              	DEL       
chr3        	90845331    	91144059    	91137007       	91166110       	4         	0         	4              	DEL       
chr3        	90845331    	91144059    	91116722       	91171050       	6         	0         	6              	DUP       
chr3        	90845331    	91144059    	91005152       	91193196       	4         	0         	4              	DEL       
chr3        	90845331    	91144059    	91042929       	91220692       	8         	0         	8              	DEL       
chr3        	90845331    	91144059    	90870921       	91221939       	8         	0         	8              	DEL       
chr3        	90861625    	90863195    	90863008       	91078900       	12        	0         	12             	DEL       
chr3        	90861625    	90863195    	90784517       	90862986       	4         	0         	4              	DEL       
chr3        	90861625    	90863195    	90861626       	90863195       	6         	0         	6              	DUP       
chr3        	90863007    	91078900    	90867452       	90964372       	6         	0         	6              	DEL       
chr3        	90863007    	91078900    	90996432       	91030454       	4         	0         	4              	DEL       
chr3        	90863007    	91078900    	90863008       	91078900       	12        	0         	12             	DEL       
chr3        	90863007    	91078900    	90986361       	91111418       	6         	0         	6              	DEL       
chr3        	90863007    	91078900    	90784517       	90862986       	4         	0         	4              	DEL       
chr3        	90863007    	91078900    	90861626       	90863195       	6         	0         	6              	DUP       
chr3        	90863007    	91078900    	90810147       	90885534       	4         	0         	4              	DUP       
chr3        	90863007    	91078900    	90866608       	90886631       	4         	0         	4              	DUP       
chr3        	90863007    	91078900    	90870539       	90896165       	6         	0         	6              	DEL       
chr3        	90863007    	91078900    	90785208       	90900680       	4         	0         	4              	DEL       
chr3        	90863007    	91078900    	90824054       	90965956       	4         	0         	4              	DEL       
chr3        	90863007    	91078900    	90966616       	90982026       	5         	0         	5              	DEL       
chr3        	90863007    	91078900    	90963720       	90986129       	4         	0         	4              	DEL       
chr3        	90863007    	91078900    	90913556       	90989827       	4         	0         	4              	DUP       
chr3        	90863007    	91078900    	90913522       	91000042       	4         	0         	4              	DUP       
chr3        	90863007    	91078900    	90784906       	91066719       	6         	0         	6              	DUP       
chr3        	90863007    	91078900    	90925403       	91069725       	8         	0         	8              	DUP       
chr3        	90863007    	91078900    	90964718       	91070268       	8         	0         	8              	DEL       
chr3        	90863007    	91078900    	90845656       	91075959       	6         	0         	6              	DEL       
chr3        	90863007    	91078900    	90925708       	91087307       	6         	0         	6              	DEL       
chr3        	90863007    	91078900    	91042931       	91113828       	10        	0         	10             	DEL       
chr3        	90863007    	91078900    	91066677       	91114117       	7         	0         	7              	DUP       
chr3        	90863007    	91078900    	91060137       	91116965       	5         	0         	5              	DUP       
chr3        	90863007    	91078900    	91003932       	91123472       	6         	0         	6              	DUP       
chr3        	90863007    	91078900    	90903737       	91133802       	4         	0         	4              	DUP       
chr3        	90863007    	91078900    	91067092       	91159133       	6         	0         	6              	DEL       
chr3        	90863007    	91078900    	91005152       	91193196       	4         	0         	4              	DEL       
chr3        	90863007    	91078900    	91042929       	91220692       	8         	0         	8              	DEL       
chr3        	90863007    	91078900    	90870921       	91221939       	8         	0         	8              	DEL       
chr3        	90866607    	90886631    	90867452       	90964372       	6         	0         	6              	DEL       
chr3        	90866607    	90886631    	90810147       	90885534       	4         	0         	4              	DUP       
chr3        	90866607    	90886631    	90866608       	90886631       	4         	0         	4              	DUP       
chr3        	90866607    	90886631    	90870539       	90896165       	6         	0         	6              	DEL       
chr3        	90866607    	90886631    	90870921       	91221939       	8         	0         	8              	DEL       
chr3        	90867451    	90964372    	90867452       	90964372       	6         	0         	6              	DEL       
chr3        	90867451    	90964372    	90810147       	90885534       	4         	0         	4              	DUP       
chr3        	90867451    	90964372    	90866608       	90886631       	4         	0         	4              	DUP       
chr3        	90867451    	90964372    	90870539       	90896165       	6         	0         	6              	DEL       
chr3        	90867451    	90964372    	90785208       	90900680       	4         	0         	4              	DEL       
chr3        	90867451    	90964372    	90963720       	90986129       	4         	0         	4              	DEL       
chr3        	90867451    	90964372    	90913556       	90989827       	4         	0         	4              	DUP       
chr3        	90867451    	90964372    	90913522       	91000042       	4         	0         	4              	DUP       
chr3        	90867451    	90964372    	90925403       	91069725       	8         	0         	8              	DUP       
chr3        	90867451    	90964372    	90925708       	91087307       	6         	0         	6              	DEL       
chr3        	90867451    	90964372    	90903737       	91133802       	4         	0         	4              	DUP       
chr3        	90867451    	90964372    	90870921       	91221939       	8         	0         	8              	DEL       
chr3        	90870538    	90896165    	90810147       	90885534       	4         	0         	4              	DUP       
chr3        	90870538    	90896165    	90866608       	90886631       	4         	0         	4              	DUP       
chr3        	90870538    	90896165    	90870539       	90896165       	6         	0         	6              	DEL       
chr3        	90870538    	90896165    	90870921       	91221939       	8         	0         	8              	DEL       
chr3        	90870920    	91221939    	90867452       	90964372       	6         	0         	6              	DEL       
chr3        	90870920    	91221939    	90996432       	91030454       	4         	0         	4              	DEL       
chr3        	90870920    	91221939    	90863008       	91078900       	12        	0         	12             	DEL       
chr3        	90870920    	91221939    	90986361       	91111418       	6         	0         	6              	DEL       
chr3        	90870920    	91221939    	90845332       	91144059       	4         	0         	4              	DUP       
chr3        	90870920    	91221939    	90810147       	90885534       	4         	0         	4              	DUP       
chr3        	90870920    	91221939    	90866608       	90886631       	4         	0         	4              	DUP       
chr3        	90870920    	91221939    	90870539       	90896165       	6         	0         	6              	DEL       
chr3        	90870920    	91221939    	90785208       	90900680       	4         	0         	4              	DEL       
chr3        	90870920    	91221939    	90824054       	90965956       	4         	0         	4              	DEL       
chr3        	90870920    	91221939    	90966616       	90982026       	5         	0         	5              	DEL       
chr3        	90870920    	91221939    	90963720       	90986129       	4         	0         	4              	DEL       
chr3        	90870920    	91221939    	90913556       	90989827       	4         	0         	4              	DUP       
chr3        	90870920    	91221939    	90913522       	91000042       	4         	0         	4              	DUP       
chr3        	90870920    	91221939    	90784906       	91066719       	6         	0         	6              	DUP       
chr3        	90870920    	91221939    	90925403       	91069725       	8         	0         	8              	DUP       
chr3        	90870920    	91221939    	90964718       	91070268       	8         	0         	8              	DEL       
chr3        	90870920    	91221939    	90845656       	91075959       	6         	0         	6              	DEL       
chr3        	90870920    	91221939    	90925708       	91087307       	6         	0         	6              	DEL       
chr3        	90870920    	91221939    	91042931       	91113828       	10        	0         	10             	DEL       
chr3        	90870920    	91221939    	91066677       	91114117       	7         	0         	7              	DUP       
chr3        	90870920    	91221939    	91060137       	91116965       	5         	0         	5              	DUP       
chr3        	90870920    	91221939    	91003932       	91123472       	6         	0         	6              	DUP       
chr3        	90870920    	91221939    	90903737       	91133802       	4         	0         	4              	DUP       
chr3        	90870920    	91221939    	91067092       	91159133       	6         	0         	6              	DEL       
chr3        	90870920    	91221939    	90840263       	91159539       	4         	0         	4              	DUP       
chr3        	90870920    	91221939    	91137007       	91166110       	4         	0         	4              	DEL       
chr3        	90870920    	91221939    	91116722       	91171050       	6         	0         	6              	DUP       
chr3        	90870920    	91221939    	91005152       	91193196       	4         	0         	4              	DEL       
chr3        	90870920    	91221939    	91042929       	91220692       	8         	0         	8              	DEL       
chr3        	90870920    	91221939    	90870921       	91221939       	8         	0         	8              	DEL       
chr3        	90903736    	91133802    	90867452       	90964372       	6         	0         	6              	DEL       
chr3        	90903736    	91133802    	90996432       	91030454       	4         	0         	4              	DEL       
chr3        	90903736    	91133802    	90863008       	91078900       	12        	0         	12             	DEL       
chr3        	90903736    	91133802    	90986361       	91111418       	6         	0         	6              	DEL       
chr3        	90903736    	91133802    	90824054       	90965956       	4         	0         	4              	DEL       
chr3        	90903736    	91133802    	90966616       	90982026       	5         	0         	5              	DEL       
chr3        	90903736    	91133802    	90963720       	90986129       	4         	0         	4              	DEL       
chr3        	90903736    	91133802    	90913556       	90989827       	4         	0         	4              	DUP       
chr3        	90903736    	91133802    	90913522       	91000042       	4         	0         	4              	DUP       
chr3        	90903736    	91133802    	90784906       	91066719       	6         	0         	6              	DUP       
chr3        	90903736    	91133802    	90925403       	91069725       	8         	0         	8              	DUP       
chr3        	90903736    	91133802    	90964718       	91070268       	8         	0         	8              	DEL       
chr3        	90903736    	91133802    	90845656       	91075959       	6         	0         	6              	DEL       
chr3        	90903736    	91133802    	90925708       	91087307       	6         	0         	6              	DEL       
chr3        	90903736    	91133802    	91042931       	91113828       	10        	0         	10             	DEL       
chr3        	90903736    	91133802    	91066677       	91114117       	7         	0         	7              	DUP       
chr3        	90903736    	91133802    	91060137       	91116965       	5         	0         	5              	DUP       
chr3        	90903736    	91133802    	91003932       	91123472       	6         	0         	6              	DUP       
chr3        	90903736    	91133802    	90903737       	91133802       	4         	0         	4              	DUP       
chr3        	90903736    	91133802    	91067092       	91159133       	6         	0         	6              	DEL       
chr3        	90903736    	91133802    	91116722       	91171050       	6         	0         	6              	DUP       
chr3        	90903736    	91133802    	91005152       	91193196       	4         	0         	4              	DEL       
chr3        	90903736    	91133802    	91042929       	91220692       	8         	0         	8              	DEL       
chr3        	90913555    	90989827    	90867452       	90964372       	6         	0         	6              	DEL       
chr3        	90913555    	90989827    	90986361       	91111418       	6         	0         	6              	DEL       
chr3        	90913555    	90989827    	90824054       	90965956       	4         	0         	4              	DEL       
chr3        	90913555    	90989827    	90966616       	90982026       	5         	0         	5              	DEL       
chr3        	90913555    	90989827    	90963720       	90986129       	4         	0         	4              	DEL       
chr3        	90913555    	90989827    	90913556       	90989827       	4         	0         	4              	DUP       
chr3        	90913555    	90989827    	90913522       	91000042       	4         	0         	4              	DUP       
chr3        	90913555    	90989827    	90925403       	91069725       	8         	0         	8              	DUP       
chr3        	90913555    	90989827    	90964718       	91070268       	8         	0         	8              	DEL       
chr3        	90913555    	90989827    	90925708       	91087307       	6         	0         	6              	DEL       
chr3        	90913521    	91000042    	90867452       	90964372       	6         	0         	6              	DEL       
chr3        	90913521    	91000042    	90996432       	91030454       	4         	0         	4              	DEL       
chr3        	90913521    	91000042    	90986361       	91111418       	6         	0         	6              	DEL       
chr3        	90913521    	91000042    	90824054       	90965956       	4         	0         	4              	DEL       
chr3        	90913521    	91000042    	90966616       	90982026       	5         	0         	5              	DEL       
chr3        	90913521    	91000042    	90963720       	90986129       	4         	0         	4              	DEL       
chr3        	90913521    	91000042    	90913556       	90989827       	4         	0         	4              	DUP       
chr3        	90913521    	91000042    	90913522       	91000042       	4         	0         	4              	DUP       
chr3        	90913521    	91000042    	90925403       	91069725       	8         	0         	8              	DUP       
chr3        	90913521    	91000042    	90964718       	91070268       	8         	0         	8              	DEL       
chr3        	90913521    	91000042    	90925708       	91087307       	6         	0         	6              	DEL       
chr3        	90925402    	91069725    	90867452       	90964372       	6         	0         	6              	DEL       
chr3        	90925402    	91069725    	90996432       	91030454       	4         	0         	4              	DEL       
chr3        	90925402    	91069725    	90986361       	91111418       	6         	0         	6              	DEL       
chr3        	90925402    	91069725    	90824054       	90965956       	4         	0         	4              	DEL       
chr3        	90925402    	91069725    	90966616       	90982026       	5         	0         	5              	DEL       
chr3        	90925402    	91069725    	90963720       	90986129       	4         	0         	4              	DEL       
chr3        	90925402    	91069725    	90913556       	90989827       	4         	0         	4              	DUP       
chr3        	90925402    	91069725    	90913522       	91000042       	4         	0         	4              	DUP       
chr3        	90925402    	91069725    	90784906       	91066719       	6         	0         	6              	DUP       
chr3        	90925402    	91069725    	90925403       	91069725       	8         	0         	8              	DUP       
chr3        	90925402    	91069725    	90964718       	91070268       	8         	0         	8              	DEL       
chr3        	90925402    	91069725    	90925708       	91087307       	6         	0         	6              	DEL       
chr3        	90925402    	91069725    	91042931       	91113828       	10        	0         	10             	DEL       
chr3        	90925402    	91069725    	91066677       	91114117       	7         	0         	7              	DUP       
chr3        	90925402    	91069725    	91060137       	91116965       	5         	0         	5              	DUP       
chr3        	90925402    	91069725    	91003932       	91123472       	6         	0         	6              	DUP       
chr3        	90925402    	91069725    	91067092       	91159133       	6         	0         	6              	DEL       
chr3        	90925402    	91069725    	91005152       	91193196       	4         	0         	4              	DEL       
chr3        	90925402    	91069725    	91042929       	91220692       	8         	0         	8              	DEL       
chr3        	90925707    	91087307    	90867452       	90964372       	6         	0         	6              	DEL       
chr3        	90925707    	91087307    	90996432       	91030454       	4         	0         	4              	DEL       
chr3        	90925707    	91087307    	90863008       	91078900       	12        	0         	12             	DEL       
chr3        	90925707    	91087307    	90986361       	91111418       	6         	0         	6              	DEL       
chr3        	90925707    	91087307    	90824054       	90965956       	4         	0         	4              	DEL       
chr3        	90925707    	91087307    	90966616       	90982026       	5         	0         	5              	DEL       
chr3        	90925707    	91087307    	90963720       	90986129       	4         	0         	4              	DEL       
chr3        	90925707    	91087307    	90913556       	90989827       	4         	0         	4              	DUP       
chr3        	90925707    	91087307    	90913522       	91000042       	4         	0         	4              	DUP       
chr3        	90925707    	91087307    	90784906       	91066719       	6         	0         	6              	DUP       
chr3        	90925707    	91087307    	90925403       	91069725       	8         	0         	8              	DUP       
chr3        	90925707    	91087307    	90964718       	91070268       	8         	0         	8              	DEL       
chr3        	90925707    	91087307    	90845656       	91075959       	6         	0         	6              	DEL       
chr3        	90925707    	91087307    	90925708       	91087307       	6         	0         	6              	DEL       
chr3        	90925707    	91087307    	91042931       	91113828       	10        	0         	10             	DEL       
chr3        	90925707    	91087307    	91066677       	91114117       	7         	0         	7              	DUP       
chr3        	90925707    	91087307    	91060137       	91116965       	5         	0         	5              	DUP       
chr3        	90925707    	91087307    	91003932       	91123472       	6         	0         	6              	DUP       
chr3        	90925707    	91087307    	91067092       	91159133       	6         	0         	6              	DEL       
chr3        	90925707    	91087307    	91005152       	91193196       	4         	0         	4              	DEL       
chr3        	90925707    	91087307    	91042929       	91220692       	8         	0         	8              	DEL       
chr3        	90963719    	90986129    	90867452       	90964372       	6         	0         	6              	DEL       
chr3        	90963719    	90986129    	90824054       	90965956       	4         	0         	4              	DEL       
chr3        	90963719    	90986129    	90966616       	90982026       	5         	0         	5              	DEL       
chr3        	90963719    	90986129    	90963720       	90986129       	4         	0         	4              	DEL       
chr3        	90963719    	90986129    	90964718       	91070268       	8         	0         	8              	DEL       
chr3        	90964717    	91070268    	90996432       	91030454       	4         	0         	4              	DEL       
chr3        	90964717    	91070268    	90986361       	91111418       	6         	0         	6              	DEL       
chr3        	90964717    	91070268    	90824054       	90965956       	4         	0         	4              	DEL       
chr3        	90964717    	91070268    	90966616       	90982026       	5         	0         	5              	DEL       
chr3        	90964717    	91070268    	90963720       	90986129       	4         	0         	4              	DEL       
chr3        	90964717    	91070268    	90913556       	90989827       	4         	0         	4              	DUP       
chr3        	90964717    	91070268    	90913522       	91000042       	4         	0         	4              	DUP       
chr3        	90964717    	91070268    	90784906       	91066719       	6         	0         	6              	DUP       
chr3        	90964717    	91070268    	90925403       	91069725       	8         	0         	8              	DUP       
chr3        	90964717    	91070268    	90964718       	91070268       	8         	0         	8              	DEL       
chr3        	90964717    	91070268    	91042931       	91113828       	10        	0         	10             	DEL       
chr3        	90964717    	91070268    	91066677       	91114117       	7         	0         	7              	DUP       
chr3        	90964717    	91070268    	91060137       	91116965       	5         	0         	5              	DUP       
chr3        	90964717    	91070268    	91003932       	91123472       	6         	0         	6              	DUP       
chr3        	90964717    	91070268    	91067092       	91159133       	6         	0         	6              	DEL       
chr3        	90964717    	91070268    	91005152       	91193196       	4         	0         	4              	DEL       
chr3        	90964717    	91070268    	91042929       	91220692       	8         	0         	8              	DEL       
chr3        	90966769    	90981962    	90966616       	90982026       	5         	0         	5              	DEL       
chr3        	90986360    	91111418    	90996432       	91030454       	4         	0         	4              	DEL       
chr3        	90986360    	91111418    	90863008       	91078900       	12        	0         	12             	DEL       
chr3        	90986360    	91111418    	90986361       	91111418       	6         	0         	6              	DEL       
chr3        	90986360    	91111418    	90913556       	90989827       	4         	0         	4              	DUP       
chr3        	90986360    	91111418    	90913522       	91000042       	4         	0         	4              	DUP       
chr3        	90986360    	91111418    	90784906       	91066719       	6         	0         	6              	DUP       
chr3        	90986360    	91111418    	90925403       	91069725       	8         	0         	8              	DUP       
chr3        	90986360    	91111418    	90964718       	91070268       	8         	0         	8              	DEL       
chr3        	90986360    	91111418    	90845656       	91075959       	6         	0         	6              	DEL       
chr3        	90986360    	91111418    	90925708       	91087307       	6         	0         	6              	DEL       
chr3        	90986360    	91111418    	91042931       	91113828       	10        	0         	10             	DEL       
chr3        	90986360    	91111418    	91066677       	91114117       	7         	0         	7              	DUP       
chr3        	90986360    	91111418    	91060137       	91116965       	5         	0         	5              	DUP       
chr3        	90986360    	91111418    	91003932       	91123472       	6         	0         	6              	DUP       
chr3        	90986360    	91111418    	91067092       	91159133       	6         	0         	6              	DEL       
chr3        	90986360    	91111418    	91005152       	91193196       	4         	0         	4              	DEL       
chr3        	90986360    	91111418    	91042929       	91220692       	8         	0         	8              	DEL       
chr3        	90996431    	91030454    	90996432       	91030454       	4         	0         	4              	DEL       
chr3        	90996431    	91030454    	90913522       	91000042       	4         	0         	4              	DUP       
chr3        	90996431    	91030454    	91003932       	91123472       	6         	0         	6              	DUP       
chr3        	90996431    	91030454    	91005152       	91193196       	4         	0         	4              	DEL       
chr3        	91003931    	91123472    	90996432       	91030454       	4         	0         	4              	DEL       
chr3        	91003931    	91123472    	90863008       	91078900       	12        	0         	12             	DEL       
chr3        	91003931    	91123472    	90986361       	91111418       	6         	0         	6              	DEL       
chr3        	91003931    	91123472    	90784906       	91066719       	6         	0         	6              	DUP       
chr3        	91003931    	91123472    	90925403       	91069725       	8         	0         	8              	DUP       
chr3        	91003931    	91123472    	90964718       	91070268       	8         	0         	8              	DEL       
chr3        	91003931    	91123472    	90845656       	91075959       	6         	0         	6              	DEL       
chr3        	91003931    	91123472    	90925708       	91087307       	6         	0         	6              	DEL       
chr3        	91003931    	91123472    	91042931       	91113828       	10        	0         	10             	DEL       
chr3        	91003931    	91123472    	91066677       	91114117       	7         	0         	7              	DUP       
chr3        	91003931    	91123472    	91060137       	91116965       	5         	0         	5              	DUP       
chr3        	91003931    	91123472    	91003932       	91123472       	6         	0         	6              	DUP       
chr3        	91003931    	91123472    	91067092       	91159133       	6         	0         	6              	DEL       
chr3        	91003931    	91123472    	91116722       	91171050       	6         	0         	6              	DUP       
chr3        	91003931    	91123472    	91005152       	91193196       	4         	0         	4              	DEL       
chr3        	91003931    	91123472    	91042929       	91220692       	8         	0         	8              	DEL       
chr3        	91005151    	91193196    	90996432       	91030454       	4         	0         	4              	DEL       
chr3        	91005151    	91193196    	90863008       	91078900       	12        	0         	12             	DEL       
chr3        	91005151    	91193196    	90986361       	91111418       	6         	0         	6              	DEL       
chr3        	91005151    	91193196    	90845332       	91144059       	4         	0         	4              	DUP       
chr3        	91005151    	91193196    	90784906       	91066719       	6         	0         	6              	DUP       
chr3        	91005151    	91193196    	90925403       	91069725       	8         	0         	8              	DUP       
chr3        	91005151    	91193196    	90964718       	91070268       	8         	0         	8              	DEL       
chr3        	91005151    	91193196    	90845656       	91075959       	6         	0         	6              	DEL       
chr3        	91005151    	91193196    	90925708       	91087307       	6         	0         	6              	DEL       
chr3        	91005151    	91193196    	91042931       	91113828       	10        	0         	10             	DEL       
chr3        	91005151    	91193196    	91066677       	91114117       	7         	0         	7              	DUP       
chr3        	91005151    	91193196    	91060137       	91116965       	5         	0         	5              	DUP       
chr3        	91005151    	91193196    	91003932       	91123472       	6         	0         	6              	DUP       
chr3        	91005151    	91193196    	90903737       	91133802       	4         	0         	4              	DUP       
chr3        	91005151    	91193196    	91067092       	91159133       	6         	0         	6              	DEL       
chr3        	91005151    	91193196    	90840263       	91159539       	4         	0         	4              	DUP       
chr3        	91005151    	91193196    	91137007       	91166110       	4         	0         	4              	DEL       
chr3        	91005151    	91193196    	91116722       	91171050       	6         	0         	6              	DUP       
chr3        	91005151    	91193196    	91005152       	91193196       	4         	0         	4              	DEL       
chr3        	91005151    	91193196    	91042929       	91220692       	8         	0         	8              	DEL       
chr3        	91042930    	91113828    	90863008       	91078900       	12        	0         	12             	DEL       
chr3        	91042930    	91113828    	90986361       	91111418       	6         	0         	6              	DEL       
chr3        	91042930    	91113828    	90784906       	91066719       	6         	0         	6              	DUP       
chr3        	91042930    	91113828    	90925403       	91069725       	8         	0         	8              	DUP       
chr3        	91042930    	91113828    	90964718       	91070268       	8         	0         	8              	DEL       
chr3        	91042930    	91113828    	90845656       	91075959       	6         	0         	6              	DEL       
chr3        	91042930    	91113828    	90925708       	91087307       	6         	0         	6              	DEL       
chr3        	91042930    	91113828    	91042931       	91113828       	10        	0         	10             	DEL       
chr3        	91042930    	91113828    	91066677       	91114117       	7         	0         	7              	DUP       
chr3        	91042930    	91113828    	91060137       	91116965       	5         	0         	5              	DUP       
chr3        	91042930    	91113828    	91067092       	91159133       	6         	0         	6              	DEL       
chr3        	91042930    	91113828    	91042929       	91220692       	8         	0         	8              	DEL       
chr3        	91042928    	91220692    	90863008       	91078900       	12        	0         	12             	DEL       
chr3        	91042928    	91220692    	90986361       	91111418       	6         	0         	6              	DEL       
chr3        	91042928    	91220692    	90845332       	91144059       	4         	0         	4              	DUP       
chr3        	91042928    	91220692    	90784906       	91066719       	6         	0         	6              	DUP       
chr3        	91042928    	91220692    	90925403       	91069725       	8         	0         	8              	DUP       
chr3        	91042928    	91220692    	90964718       	91070268       	8         	0         	8              	DEL       
chr3        	91042928    	91220692    	90845656       	91075959       	6         	0         	6              	DEL       
chr3        	91042928    	91220692    	90925708       	91087307       	6         	0         	6              	DEL       
chr3        	91042928    	91220692    	91042931       	91113828       	10        	0         	10             	DEL       
chr3        	91042928    	91220692    	91066677       	91114117       	7         	0         	7              	DUP       
chr3        	91042928    	91220692    	91060137       	91116965       	5         	0         	5              	DUP       
chr3        	91042928    	91220692    	91003932       	91123472       	6         	0         	6              	DUP       
chr3        	91042928    	91220692    	90903737       	91133802       	4         	0         	4              	DUP       
chr3        	91042928    	91220692    	91067092       	91159133       	6         	0         	6              	DEL       
chr3        	91042928    	91220692    	90840263       	91159539       	4         	0         	4              	DUP       
chr3        	91042928    	91220692    	91137007       	91166110       	4         	0         	4              	DEL       
chr3        	91042928    	91220692    	91116722       	91171050       	6         	0         	6              	DUP       
chr3        	91042928    	91220692    	91005152       	91193196       	4         	0         	4              	DEL       
chr3        	91042928    	91220692    	91042929       	91220692       	8         	0         	8              	DEL       
chr3        	91060136    	91116965    	90863008       	91078900       	12        	0         	12             	DEL       
chr3        	91060136    	91116965    	90986361       	91111418       	6         	0         	6              	DEL       
chr3        	91060136    	91116965    	90784906       	91066719       	6         	0         	6              	DUP       
chr3        	91060136    	91116965    	90925403       	91069725       	8         	0         	8              	DUP       
chr3        	91060136    	91116965    	90964718       	91070268       	8         	0         	8              	DEL       
chr3        	91060136    	91116965    	90845656       	91075959       	6         	0         	6              	DEL       
chr3        	91060136    	91116965    	90925708       	91087307       	6         	0         	6              	DEL       
chr3        	91060136    	91116965    	91042931       	91113828       	10        	0         	10             	DEL       
chr3        	91060136    	91116965    	91066677       	91114117       	7         	0         	7              	DUP       
chr3        	91060136    	91116965    	91060137       	91116965       	5         	0         	5              	DUP       
chr3        	91060136    	91116965    	91067092       	91159133       	6         	0         	6              	DEL       
chr3        	91060136    	91116965    	91116722       	91171050       	6         	0         	6              	DUP       
chr3        	91066676    	91114117    	90863008       	91078900       	12        	0         	12             	DEL       
chr3        	91066676    	91114117    	90986361       	91111418       	6         	0         	6              	DEL       
chr3        	91066676    	91114117    	90784906       	91066719       	6         	0         	6              	DUP       
chr3        	91066676    	91114117    	90925403       	91069725       	8         	0         	8              	DUP       
chr3        	91066676    	91114117    	90964718       	91070268       	8         	0         	8              	DEL       
chr3        	91066676    	91114117    	90845656       	91075959       	6         	0         	6              	DEL       
chr3        	91066676    	91114117    	90925708       	91087307       	6         	0         	6              	DEL       
chr3        	91066676    	91114117    	91042931       	91113828       	10        	0         	10             	DEL       
chr3        	91066676    	91114117    	91066677       	91114117       	7         	0         	7              	DUP       
chr3        	91066676    	91114117    	91067092       	91159133       	6         	0         	6              	DEL       
chr3        	91067091    	91159133    	90863008       	91078900       	12        	0         	12             	DEL       
chr3        	91067091    	91159133    	90986361       	91111418       	6         	0         	6              	DEL       
chr3        	91067091    	91159133    	90845332       	91144059       	4         	0         	4              	DUP       
chr3        	91067091    	91159133    	90925403       	91069725       	8         	0         	8              	DUP       
chr3        	91067091    	91159133    	90964718       	91070268       	8         	0         	8              	DEL       
chr3        	91067091    	91159133    	90845656       	91075959       	6         	0         	6              	DEL       
chr3        	91067091    	91159133    	90925708       	91087307       	6         	0         	6              	DEL       
chr3        	91067091    	91159133    	91042931       	91113828       	10        	0         	10             	DEL       
chr3        	91067091    	91159133    	91066677       	91114117       	7         	0         	7              	DUP       
chr3        	91067091    	91159133    	91060137       	91116965       	5         	0         	5              	DUP       
chr3        	91067091    	91159133    	91003932       	91123472       	6         	0         	6              	DUP       
chr3        	91067091    	91159133    	90903737       	91133802       	4         	0         	4              	DUP       
chr3        	91067091    	91159133    	91067092       	91159133       	6         	0         	6              	DEL       
chr3        	91067091    	91159133    	91137007       	91166110       	4         	0         	4              	DEL       
chr3        	91067091    	91159133    	91116722       	91171050       	6         	0         	6              	DUP       
chr3        	91116721    	91171050    	90845332       	91144059       	4         	0         	4              	DUP       
chr3        	91116721    	91171050    	91060137       	91116965       	5         	0         	5              	DUP       
chr3        	91116721    	91171050    	91003932       	91123472       	6         	0         	6              	DUP       
chr3        	91116721    	91171050    	90903737       	91133802       	4         	0         	4              	DUP       
chr3        	91116721    	91171050    	91067092       	91159133       	6         	0         	6              	DEL       
chr3        	91116721    	91171050    	90840263       	91159539       	4         	0         	4              	DUP       
chr3        	91116721    	91171050    	91137007       	91166110       	4         	0         	4              	DEL       
chr3        	91116721    	91171050    	91116722       	91171050       	6         	0         	6              	DUP       
chr3        	91137006    	91166110    	90845332       	91144059       	4         	0         	4              	DUP       
chr3        	91137006    	91166110    	91067092       	91159133       	6         	0         	6              	DEL       
chr3        	91137006    	91166110    	90840263       	91159539       	4         	0         	4              	DUP       
chr3        	91137006    	91166110    	91137007       	91166110       	4         	0         	4              	DEL       
chr3        	91557670    	91561028    	91557671       	91561028       	9         	0         	9              	DEL       
chr3        	91561284    	92705447    	92133504       	92647322       	4         	0         	4              	DEL       
chr3        	91561284    	92705447    	91561285       	92705447       	5         	0         	5              	DEL       
chr3        	91561284    	92705447    	91579405       	93232972       	9         	0         	9              	DEL       
chr3        	91579404    	93232972    	92133504       	92647322       	4         	0         	4              	DEL       
chr3        	91579404    	93232972    	91561285       	92705447       	5         	0         	5              	DEL       
chr3        	91579404    	93232972    	92705767       	93135173       	4         	0         	4              	DEL       
chr3        	91579404    	93232972    	91579405       	93232972       	9         	0         	9              	DEL       
chr3        	92133503    	92647322    	92133504       	92647322       	4         	0         	4              	DEL       
chr3        	93736530    	93737214    	93736486       	93737230       	11        	0         	11             	DUP       
chr3        	94792979    	94795560    	66274529       	94795077       	6         	0         	6              	DUP       
chr3        	94792979    	94795560    	94792985       	94795652       	13        	0         	13             	DUP       
chr3        	98163122    	98202532    	98163122       	98202530       	19        	0         	19             	DUP       
chr3        	98163122    	98202532    	98163375       	98202693       	9         	0         	9              	DEL       
chr3        	98163376    	98202694    	98163122       	98202530       	19        	0         	19             	DUP       
chr3        	98163376    	98202694    	98163375       	98202693       	9         	0         	9              	DEL       
chr3        	98691623    	98695874    	98691808       	98695939       	8         	0         	8              	DEL       
chr3        	99180215    	99183545    	99180219       	99183545       	52        	31        	83             	DEL       
chr3        	99318600    	99318913    	99318610       	99318913       	3         	13        	16             	DEL       
chr3        	99909937    	99910787    	99909938       	99910787       	30        	4         	34             	DEL       
chr3        	100066505   	100066812   	100066519      	100066812      	0         	7         	7              	DEL       
chr3        	100587902   	100588223   	100587918      	100588223      	1         	13        	14             	DEL       
chr3        	101638720   	101640903   	101638721      	101640903      	25        	8         	33             	DEL       
chr3        	103091504   	103091819   	103091520      	103091819      	1         	13        	14             	DEL       
chr3        	104559354   	104560202   	104559356      	104560202      	17        	12        	29             	DEL       
chr3        	104697471   	104697601   	104697464      	104697601      	0         	8         	8              	DEL       
chr3        	105280762   	105280892   	105280779      	105280886      	1         	26        	27             	DEL       
chr3        	107094777   	107094942   	107094784      	107094942      	0         	13        	13             	DEL       
chr3        	109770226   	109770483   	109770230      	109770483      	0         	7         	7              	DEL       
chr3        	110538124   	110538409   	110538125      	110538409      	1         	12        	13             	DEL       
chr3        	112748534   	112748865   	112748554      	112748865      	0         	8         	8              	DEL       
chr3        	114135173   	114135500   	114135186      	114135500      	1         	22        	23             	DEL       
chr3        	114747626   	114747951   	114747637      	114747945      	0         	31        	31             	DEL       
chr3        	115305387   	115305729   	115305404      	115305729      	5         	19        	24             	DEL       
chr3        	116485986   	116486331   	116485987      	116486331      	1         	5         	6              	DEL       
chr3        	116556423   	116556748   	116556437      	116556748      	2         	15        	17             	DEL       
chr3        	118333352   	118333580   	118333377      	118333580      	0         	4         	4              	DEL       
chr3        	118562756   	118562981   	118562757      	118562981      	2         	12        	14             	DEL       
chr3        	120175135   	120175596   	120175138      	120175596      	6         	24        	30             	DEL       
chr3        	122419594   	122419921   	122419604      	122419921      	1         	7         	8              	DEL       
chr3        	123517898   	123518214   	123517910      	123518214      	2         	17        	19             	DEL       
chr3        	125171204   	125171975   	125171209      	125171975      	34        	16        	50             	DEL       
chr3        	125217450   	125218319   	125217458      	125218340      	18        	0         	18             	DEL       
chr3        	125720383   	125743196   	125720382      	125743195      	6         	0         	6              	DEL       
chr3        	125720383   	125743196   	125720719      	125743434      	6         	0         	6              	DUP       
chr3        	125720719   	125743436   	125720382      	125743195      	6         	0         	6              	DEL       
chr3        	125720719   	125743436   	125720719      	125743434      	6         	0         	6              	DUP       
chr3        	126640078   	126640406   	126640095      	126640406      	1         	12        	13             	DEL       
chr3        	128454217   	128454316   	128454222      	128454316      	1         	6         	7              	DEL       
chr3        	129029752   	129030067   	129029753      	129030067      	0         	5         	5              	DEL       
chr3        	129109678   	129109916   	129109686      	129109916      	0         	4         	4              	DEL       
chr3        	129465623   	129465934   	129465643      	129465934      	0         	5         	5              	DEL       
chr3        	130044536   	130087902   	130044539      	130087902      	15        	7         	22             	DEL       
chr3        	130628721   	130634264   	130628733      	130634264      	22        	8         	30             	DEL       
chr3        	131776233   	131776290   	131776234      	131776290      	0         	4         	4              	DEL       
chr3        	133129883   	133129956   	133129884      	133129956      	7         	0         	7              	INV       
chr3        	134955059   	134955714   	134955074      	134955713      	14        	7         	21             	DEL       
chr3        	136302170   	136307357   	136302171      	136307357      	26        	6         	32             	DEL       
chr3        	140902264   	140903516   	140902265      	140903516      	15        	5         	20             	DUP       
chr3        	140902264   	140903516   	140902540      	140903522      	13        	11        	24             	DEL       
chr3        	140902539   	140903517   	140902265      	140903516      	15        	5         	20             	DUP       
chr3        	140902539   	140903517   	140902540      	140903522      	13        	11        	24             	DEL       
chr3        	143448906   	143449672   	143448907      	143449666      	8         	1         	9              	DEL       
chr3        	144799027   	144799605   	144799052      	144799604      	17        	17        	34             	DEL       
chr3        	145071936   	145073031   	145071938      	145073031      	21        	7         	28             	DEL       
chr3        	145170661   	145171123   	145170662      	145171123      	5         	9         	14             	DEL       
chr3        	145518233   	145518295   	145518226      	145518295      	0         	6         	6              	DEL       
chr3        	145927180   	145931403   	145927181      	145931403      	11        	3         	14             	DEL       
chr3        	146015407   	146015557   	146015385      	146015560      	0         	5         	5              	DUP       
chr3        	146214110   	146214423   	146214126      	146214423      	2         	31        	33             	DEL       
chr3        	146667403   	146672618   	146667402      	146672617      	8         	0         	8              	DEL       
chr3        	146667403   	146672618   	146667403      	146677074      	19        	16        	35             	DEL       
chr3        	146667403   	146672618   	146672617      	146677378      	18        	12        	30             	DUP       
chr3        	146667400   	146677075   	146667402      	146672617      	8         	0         	8              	DEL       
chr3        	146667400   	146677075   	146667403      	146677074      	19        	16        	35             	DEL       
chr3        	146667400   	146677075   	146672617      	146677378      	18        	12        	30             	DUP       
chr3        	146672616   	146677378   	146667402      	146672617      	8         	0         	8              	DEL       
chr3        	146672616   	146677378   	146667403      	146677074      	19        	16        	35             	DEL       
chr3        	146672616   	146677378   	146672617      	146677378      	18        	12        	30             	DUP       
chr3        	147888875   	147889453   	147888876      	147889453      	11        	16        	27             	DEL       
chr3        	148563652   	148567639   	148563653      	148567632      	25        	13        	38             	DEL       
chr3        	148849004   	148849323   	148849015      	148849323      	2         	26        	28             	DEL       
chr3        	149126584   	149126913   	149126599      	149126913      	0         	5         	5              	DEL       
chr3        	150160277   	150160588   	150160288      	150160588      	0         	5         	5              	DEL       
chr3        	152593933   	152595366   	152593949      	152595366      	42        	23        	65             	DEL       
chr3        	152899402   	152899592   	152899403      	152899592      	0         	6         	6              	DEL       
chr3        	152982378   	152982590   	152982381      	152982590      	0         	5         	5              	DEL       
chr3        	154378943   	154379264   	154378958      	154379264      	3         	19        	22             	DEL       
chr3        	156374380   	156375902   	156374381      	156375902      	18        	3         	21             	DEL       
chr3        	157762850   	157762915   	157762863      	157762915      	0         	8         	8              	DEL       
chr3        	158399111   	158399456   	158399128      	158399455      	0         	10        	10             	DEL       
chr3        	159078082   	159078136   	159078083      	159078136      	13        	2         	15             	INV       
chr3        	159539231   	159539901   	159539232      	159539901      	33        	22        	55             	DEL       
chr3        	159711195   	159711396   	159711211      	159711395      	0         	9         	9              	DEL       
chr3        	161528937   	161529274   	161528938      	161529259      	2         	12        	14             	DEL       
chr3        	161887240   	161887483   	161887255      	161887465      	1         	3         	4              	DEL       
chr3        	162100277   	162100455   	162100278      	162100455      	0         	9         	9              	DEL       
chr3        	162690507   	162690824   	162690522      	162690824      	3         	19        	22             	DEL       
chr3        	162794344   	162908546   	162794346      	162908546      	31        	8         	39             	DEL       
chr3        	162999517   	163005766   	162999517      	163005992      	9         	0         	9              	DEL       
chr3        	163047112   	163051296   	163047113      	163051296      	53        	18        	71             	DEL       
chr3        	163746378   	163746685   	163746387      	163746685      	1         	10        	11             	DEL       
chr3        	170401775   	170402089   	170401792      	170402089      	2         	3         	5              	DEL       
chr3        	176361734   	176361818   	176361765      	176361818      	0         	11        	11             	DEL       
chr3        	176769642   	176769836   	176769643      	176769836      	0         	4         	4              	DUP       
chr3        	177663526   	177667625   	177663530      	177667629      	17        	0         	17             	DEL       
chr3        	178832341   	178833083   	178832345      	178833083      	19        	6         	25             	DEL       
chr3        	178975386   	178975586   	178975399      	178975586      	0         	5         	5              	DEL       
chr3        	180455800   	180456051   	180455803      	180456051      	1         	21        	22             	DEL       
chr3        	183842602   	183843116   	183842608      	183843115      	0         	4         	4              	DEL       
chr3        	184407583   	184407780   	184407587      	184407780      	0         	20        	20             	DEL       
chr3        	184753017   	184754610   	184753063      	184754639      	8         	0         	8              	DEL       
chr3        	185299539   	185299865   	185299552      	185299865      	1         	9         	10             	DEL       
chr3        	185910856   	185991393   	185910856      	185991391      	8         	0         	8              	DUP       
chr3        	185910856   	185991393   	185911093      	185991515      	5         	0         	5              	DEL       
chr3        	186863225   	186867495   	186863244      	186867495      	44        	21        	65             	DEL       
chr3        	187108876   	187109193   	187108877      	187109181      	1         	29        	30             	DEL       
chr3        	188587042   	188587376   	188587061      	188587376      	0         	23        	23             	DEL       
chr3        	189506717   	189507582   	189506718      	189507582      	33        	10        	43             	DEL       
chr3        	189858104   	189858427   	189858123      	189858427      	0         	22        	22             	DEL       
chr3        	190019554   	190022735   	190019559      	190022735      	12        	9         	21             	DEL       
chr3        	190401241   	190401310   	190401242      	190401310      	0         	9         	9              	DEL       
chr3        	190572849   	190573147   	190572861      	190573147      	1         	9         	10             	DEL       
chr3        	190760668   	190760845   	190760669      	190760845      	0         	21        	21             	DEL       
chr3        	191069287   	191070152   	191069288      	191070152      	28        	7         	35             	DEL       
chr3        	191115780   	191116229   	191115783      	191116229      	19        	6         	25             	INV       
chr3        	191546426   	191548556   	191546501      	191548371      	25        	0         	25             	DEL       
chr3        	192138295   	192138634   	192138309      	192138634      	2         	19        	21             	DEL       
chr3        	192345391   	192345702   	192345405      	192345702      	3         	13        	16             	DEL       
chr3        	192955529   	192955598   	192955531      	192955598      	0         	9         	9              	DEL       
chr3        	193026563   	193027104   	193026566      	193027104      	8         	6         	14             	DEL       
chr3        	193157539   	193167616   	193157543      	193167616      	19        	10        	29             	DEL       
chr3        	194400434   	194401192   	194400443      	194401192      	21        	6         	27             	DEL       
chr3        	194677979   	194679563   	194678040      	194679569      	10        	0         	10             	DEL       
chr3        	194822560   	194825527   	194822565      	194825527      	10        	5         	15             	DEL       
chr3        	194822560   	194825527   	194822580      	194825702      	4         	5         	9              	DUP       
chr3        	194822579   	194825700   	194822565      	194825527      	10        	5         	15             	DEL       
chr3        	194822579   	194825700   	194822580      	194825702      	4         	5         	9              	DUP       
chr3        	194845459   	194846372   	194845460      	194846372      	4         	0         	4              	DEL       
chr3        	195686953   	195687284   	195686954      	195687284      	5         	0         	5              	DEL       
chr3        	195712827   	195714398   	195713416      	195714322      	7         	0         	7              	DEL       
chr3        	195778964   	195780121   	195778965      	195780121      	19        	0         	19             	DEL       
chr3        	195778964   	195780121   	195778895      	195785094      	4         	0         	4              	DUP       
chr3        	195786370   	195788113   	195786327      	195788202      	11        	0         	11             	DEL       
chr3        	195842344   	195843061   	195842346      	195843061      	14        	7         	21             	DEL       
chr3        	195940849   	196000816   	195940981      	196000830      	10        	0         	10             	DUP       
chr3        	195940849   	196000816   	195941596      	196000973      	6         	0         	6              	DEL       
chr3        	195941597   	196000974   	195940981      	196000830      	10        	0         	10             	DUP       
chr3        	195941597   	196000974   	195941596      	196000973      	6         	0         	6              	DEL       
chr3        	196098921   	196099620   	196098922      	196099620      	9         	0         	9              	DEL       
chr3        	197032459   	197034594   	197032458      	197034593      	4         	0         	4              	DEL       
chr3        	197207701   	197212384   	197207702      	197212384      	31        	8         	39             	DEL       
chr3        	197384389   	197386789   	197384402      	197386518      	5         	0         	5              	DUP       
chr3        	197384389   	197386789   	197384626      	197390951      	5         	0         	5              	DUP       
chr3        	197384614   	197391024   	197384402      	197386518      	5         	0         	5              	DUP       
chr3        	197384614   	197391024   	197384626      	197390951      	5         	0         	5              	DUP       
chr3        	197384614   	197391024   	197389438      	197391023      	17        	1         	18             	DUP       
chr3        	197384614   	197391024   	197390840      	197391316      	4         	0         	4              	DEL       
chr3        	197390161   	197391024   	197384626      	197390951      	5         	0         	5              	DUP       
chr3        	197390161   	197391024   	197389438      	197391023      	17        	1         	18             	DUP       
chr3        	197390161   	197391024   	197390840      	197391316      	4         	0         	4              	DEL       
chr3        	197390839   	197391316   	197384626      	197390951      	5         	0         	5              	DUP       
chr3        	197390839   	197391316   	197389438      	197391023      	17        	1         	18             	DUP       
chr3        	197390839   	197391316   	197390840      	197391316      	4         	0         	4              	DEL       
chr4        	127123      	133266      	127126         	133266         	43        	8         	51             	DEL       
chr4        	1026081     	1026287     	1026082        	1026310        	0         	16        	16             	DUP       
chr4        	1095096     	1096415     	1095097        	1096415        	5         	0         	5              	DEL       
chr4        	1545406     	1547109     	1545405        	1547153        	6         	0         	6              	DEL       
chr4        	1601228     	1601942     	1601232        	1601942        	14        	4         	18             	DEL       
chr4        	2396073     	2396690     	2396074        	2396690        	12        	0         	12             	DEL       
chr4        	3610203     	3610820     	3610204        	3610820        	9         	0         	9              	DEL       
chr4        	3901386     	4174097     	3901386        	4174095        	15        	0         	15             	DUP       
chr4        	3901386     	4174097     	3901626        	4174282        	9         	0         	9              	DEL       
chr4        	3901609     	4174562     	3901386        	4174095        	15        	0         	15             	DUP       
chr4        	3901609     	4174562     	3901626        	4174282        	9         	0         	9              	DEL       
chr4        	6649861     	6651183     	6649866        	6651183        	51        	16        	67             	DEL       
chr4        	7130766     	7131691     	7130859        	7131395        	2         	2         	4              	DUP       
chr4        	7565833     	7566190     	7565861        	7566190        	0         	10        	10             	DEL       
chr4        	7633783     	7634125     	7633785        	7634125        	0         	6         	6              	DEL       
chr4        	7994066     	7995166     	7994082        	7995166        	31        	15        	46             	DEL       
chr4        	9455396     	9479864     	9455452        	9479929        	15        	0         	15             	DEL       
chr4        	9571437     	9571546     	9571442        	9571546        	0         	7         	7              	DEL       
chr4        	9950665     	9950916     	9950685        	9950916        	1         	4         	5              	DEL       
chr4        	9955196     	9955515     	9955210        	9955515        	0         	6         	6              	DEL       
chr4        	10144612    	10144678    	10144614       	10144678       	0         	8         	8              	DEL       
chr4        	10209635    	10232943    	10209643       	10232943       	44        	21        	65             	DEL       
chr4        	17201132    	17201443    	17201142       	17201443       	2         	22        	24             	DEL       
chr4        	17264649    	17264711    	17264660       	17264711       	0         	7         	7              	DEL       
chr4        	19077826    	19083928    	19077795       	19083927       	10        	0         	10             	DEL       
chr4        	19641488    	19641830    	19641502       	19641830       	1         	13        	14             	DEL       
chr4        	20079832    	20079928    	20079864       	20079927       	0         	8         	8              	DEL       
chr4        	21159362    	21165474    	21159379       	21165474       	27        	10        	37             	DEL       
chr4        	21693106    	21693227    	21693107       	21693227       	0         	14        	14             	DEL       
chr4        	22431267    	22431329    	22431274       	22431329       	0         	8         	8              	DEL       
chr4        	23720040    	23720362    	23720060       	23720362       	3         	18        	21             	DEL       
chr4        	25239426    	25239568    	25239430       	25239568       	0         	9         	9              	DEL       
chr4        	25495527    	25495841    	25495543       	25495841       	0         	21        	21             	DEL       
chr4        	26526696    	26526934    	26526707       	26526907       	0         	5         	5              	DEL       
chr4        	26954328    	26955829    	26954335       	26955829       	19        	11        	30             	DEL       
chr4        	27206380    	27206565    	27206381       	27206565       	0         	18        	18             	DUP       
chr4        	28419967    	28420318    	28419969       	28420318       	1         	11        	12             	DEL       
chr4        	28562663    	28562988    	28562678       	28562988       	3         	10        	13             	DEL       
chr4        	29659486    	29659815    	29659500       	29659815       	3         	20        	23             	DEL       
chr4        	31204192    	31204512    	31204205       	31204512       	0         	19        	19             	DEL       
chr4        	31336864    	31337064    	31336870       	31337064       	1         	23        	24             	DEL       
chr4        	31491240    	31491677    	31491245       	31491677       	13        	23        	36             	DEL       
chr4        	31819254    	31832732    	31819198       	31832939       	5         	0         	5              	DEL       
chr4        	32064146    	32069425    	32064147       	32069429       	6         	10        	16             	DUP       
chr4        	32064146    	32069425    	32064254       	32069454       	9         	0         	9              	DEL       
chr4        	32064146    	32069425    	32064255       	32072888       	0         	8         	8              	DEL       
chr4        	32064146    	32069425    	32069426       	32072888       	7         	0         	7              	DEL       
chr4        	32064146    	32069425    	32069419       	32072988       	5         	8         	13             	DUP       
chr4        	32064255    	32069455    	32064147       	32069429       	6         	10        	16             	DUP       
chr4        	32064255    	32069455    	32064254       	32069454       	9         	0         	9              	DEL       
chr4        	32064255    	32069455    	32064255       	32072888       	0         	8         	8              	DEL       
chr4        	32064255    	32069455    	32069426       	32072888       	7         	0         	7              	DEL       
chr4        	32064255    	32069455    	32069419       	32072988       	5         	8         	13             	DUP       
chr4        	32064249    	32072889    	32064147       	32069429       	6         	10        	16             	DUP       
chr4        	32064249    	32072889    	32064254       	32069454       	9         	0         	9              	DEL       
chr4        	32064249    	32072889    	32064255       	32072888       	0         	8         	8              	DEL       
chr4        	32064249    	32072889    	32069426       	32072888       	7         	0         	7              	DEL       
chr4        	32064249    	32072889    	32069419       	32072988       	5         	8         	13             	DUP       
chr4        	32069427    	32072889    	32064147       	32069429       	6         	10        	16             	DUP       
chr4        	32069427    	32072889    	32064254       	32069454       	9         	0         	9              	DEL       
chr4        	32069427    	32072889    	32064255       	32072888       	0         	8         	8              	DEL       
chr4        	32069427    	32072889    	32069426       	32072888       	7         	0         	7              	DEL       
chr4        	32069427    	32072889    	32069419       	32072988       	5         	8         	13             	DUP       
chr4        	32069418    	32072986    	32064147       	32069429       	6         	10        	16             	DUP       
chr4        	32069418    	32072986    	32064254       	32069454       	9         	0         	9              	DEL       
chr4        	32069418    	32072986    	32064255       	32072888       	0         	8         	8              	DEL       
chr4        	32069418    	32072986    	32069426       	32072888       	7         	0         	7              	DEL       
chr4        	32069418    	32072986    	32069419       	32072988       	5         	8         	13             	DUP       
chr4        	32538977    	32539293    	32538993       	32539293       	2         	7         	9              	DEL       
chr4        	34778262    	34827321    	34778310       	34827319       	23        	0         	23             	DEL       
chr4        	35238632    	35242814    	35238633       	35242814       	22        	10        	32             	DEL       
chr4        	35906102    	35906190    	35906103       	35906190       	0         	5         	5              	DEL       
chr4        	36468281    	36468615    	36468301       	36468615       	3         	13        	16             	DEL       
chr4        	36778991    	36779315    	36779006       	36779315       	1         	11        	12             	DEL       
chr4        	36841123    	36841467    	36841138       	36841467       	1         	19        	20             	DEL       
chr4        	37330875    	37331603    	37330876       	37331603       	6         	0         	6              	DEL       
chr4        	39029455    	39029738    	39029470       	39029738       	3         	22        	25             	DEL       
chr4        	39812925    	39813535    	39812926       	39813535       	5         	0         	5              	DEL       
chr4        	40023294    	40024661    	40023335       	40024661       	41        	9         	50             	DEL       
chr4        	40294805    	40295622    	40295084       	40295591       	5         	0         	5              	DUP       
chr4        	43929477    	43929819    	43929479       	43929819       	2         	18        	20             	DEL       
chr4        	44505257    	44505713    	44505262       	44505712       	7         	22        	29             	DEL       
chr4        	44507359    	44507678    	44507377       	44507678       	1         	17        	18             	DEL       
chr4        	44969978    	44970151    	44969980       	44970151       	0         	10        	10             	DEL       
chr4        	46200777    	46203009    	46200780       	46203009       	30        	26        	56             	DEL       
chr4        	48092552    	48092620    	48092556       	48092620       	0         	8         	8              	DEL       
chr4        	49717606    	51459200    	49721918       	49788214       	4         	0         	4              	DUP       
chr4        	49717606    	51459200    	50278395       	50468053       	5         	0         	5              	DEL       
chr4        	49717606    	51459200    	49920471       	50807219       	4         	0         	4              	DUP       
chr4        	49717606    	51459200    	50468251       	51293428       	6         	0         	6              	DEL       
chr4        	49717606    	51459200    	51241689       	51312650       	4         	0         	4              	DUP       
chr4        	49717606    	51459200    	51263231       	51561360       	5         	0         	5              	DUP       
chr4        	49717606    	51459200    	50453548       	51571640       	4         	0         	4              	DEL       
chr4        	49717606    	51459200    	51407928       	51640946       	8         	0         	8              	DUP       
chr4        	49717606    	51459200    	49932120       	51702582       	9         	0         	9              	DEL       
chr4        	49721917    	49788214    	49721918       	49788214       	4         	0         	4              	DUP       
chr4        	49920470    	50807219    	50278395       	50468053       	5         	0         	5              	DEL       
chr4        	49920470    	50807219    	49920471       	50807219       	4         	0         	4              	DUP       
chr4        	49920470    	50807219    	50468251       	51293428       	6         	0         	6              	DEL       
chr4        	49920470    	50807219    	50453548       	51571640       	4         	0         	4              	DEL       
chr4        	49920470    	50807219    	49932120       	51702582       	9         	0         	9              	DEL       
chr4        	49932227    	51702412    	50278395       	50468053       	5         	0         	5              	DEL       
chr4        	49932227    	51702412    	49920471       	50807219       	4         	0         	4              	DUP       
chr4        	49932227    	51702412    	50468251       	51293428       	6         	0         	6              	DEL       
chr4        	49932227    	51702412    	51241689       	51312650       	4         	0         	4              	DUP       
chr4        	49932227    	51702412    	49717440       	51459375       	4         	0         	4              	DEL       
chr4        	49932227    	51702412    	51263231       	51561360       	5         	0         	5              	DUP       
chr4        	49932227    	51702412    	50453548       	51571640       	4         	0         	4              	DEL       
chr4        	49932227    	51702412    	51407928       	51640946       	8         	0         	8              	DUP       
chr4        	50278394    	50468053    	50278395       	50468053       	5         	0         	5              	DEL       
chr4        	50278394    	50468053    	50453548       	51571640       	4         	0         	4              	DEL       
chr4        	50453547    	51571640    	50278395       	50468053       	5         	0         	5              	DEL       
chr4        	50453547    	51571640    	49920471       	50807219       	4         	0         	4              	DUP       
chr4        	50453547    	51571640    	50468251       	51293428       	6         	0         	6              	DEL       
chr4        	50453547    	51571640    	51241689       	51312650       	4         	0         	4              	DUP       
chr4        	50453547    	51571640    	49717440       	51459375       	4         	0         	4              	DEL       
chr4        	50453547    	51571640    	51263231       	51561360       	5         	0         	5              	DUP       
chr4        	50453547    	51571640    	50453548       	51571640       	4         	0         	4              	DEL       
chr4        	50453547    	51571640    	51407928       	51640946       	8         	0         	8              	DUP       
chr4        	50468250    	51293428    	49920471       	50807219       	4         	0         	4              	DUP       
chr4        	50468250    	51293428    	50468251       	51293428       	6         	0         	6              	DEL       
chr4        	50468250    	51293428    	51241689       	51312650       	4         	0         	4              	DUP       
chr4        	50468250    	51293428    	51263231       	51561360       	5         	0         	5              	DUP       
chr4        	51241688    	51312650    	50468251       	51293428       	6         	0         	6              	DEL       
chr4        	51241688    	51312650    	51241689       	51312650       	4         	0         	4              	DUP       
chr4        	51241688    	51312650    	51263231       	51561360       	5         	0         	5              	DUP       
chr4        	51263230    	51561360    	50468251       	51293428       	6         	0         	6              	DEL       
chr4        	51263230    	51561360    	51241689       	51312650       	4         	0         	4              	DUP       
chr4        	51263230    	51561360    	49717440       	51459375       	4         	0         	4              	DEL       
chr4        	51263230    	51561360    	51263231       	51561360       	5         	0         	5              	DUP       
chr4        	51263230    	51561360    	51407928       	51640946       	8         	0         	8              	DUP       
chr4        	51407865    	51641135    	49717440       	51459375       	4         	0         	4              	DEL       
chr4        	51407865    	51641135    	51263231       	51561360       	5         	0         	5              	DUP       
chr4        	51407865    	51641135    	50453548       	51571640       	4         	0         	4              	DEL       
chr4        	51407865    	51641135    	51407928       	51640946       	8         	0         	8              	DUP       
chr4        	54616251    	54616573    	54616269       	54616573       	2         	9         	11             	DEL       
chr4        	54711648    	54711726    	54711649       	54711726       	0         	4         	4              	DEL       
chr4        	54942507    	54942752    	54942519       	54942752       	1         	9         	10             	DEL       
chr4        	57221178    	57221578    	57221179       	57221568       	3         	15        	18             	DEL       
chr4        	57633823    	57634079    	57633840       	57634079       	0         	10        	10             	DEL       
chr4        	58562829    	58569373    	58562834       	58569373       	12        	13        	25             	DEL       
chr4        	58562829    	58569373    	58562832       	58569632       	12        	9         	21             	DUP       
chr4        	58562831    	58569632    	58562834       	58569373       	12        	13        	25             	DEL       
chr4        	58562831    	58569632    	58562832       	58569632       	12        	9         	21             	DUP       
chr4        	59078840    	59084883    	59078847       	59084883       	22        	12        	34             	DEL       
chr4        	59119668    	59119776    	59119669       	59119776       	1         	14        	15             	DEL       
chr4        	60464387    	60467468    	60464387       	60467468       	19        	0         	19             	DEL       
chr4        	60703509    	60703840    	60703526       	60703840       	0         	18        	18             	DEL       
chr4        	60756208    	60756332    	60756210       	60756332       	0         	11        	11             	DEL       
chr4        	61133656    	61136235    	61133657       	61136235       	24        	4         	28             	DEL       
chr4        	61519071    	61519534    	61519072       	61519534       	4         	0         	4              	DEL       
chr4        	61633223    	61633941    	61633224       	61633941       	17        	0         	17             	DEL       
chr4        	62435465    	62435962    	62435466       	62435962       	5         	7         	12             	DEL       
chr4        	63268589    	63288818    	63268590       	63288818       	34        	12        	46             	DEL       
chr4        	63828609    	63848664    	63828610       	63848664       	36        	12        	48             	DEL       
chr4        	63917865    	63918837    	63917880       	63918836       	55        	18        	73             	DEL       
chr4        	65775390    	65775702    	65775400       	65775702       	5         	24        	29             	DEL       
chr4        	66251975    	66252097    	66251976       	66252090       	0         	8         	8              	DEL       
chr4        	66256349    	66257773    	66256297       	66257773       	15        	0         	15             	DEL       
chr4        	68007458    	68007528    	68007461       	68007528       	0         	12        	12             	DEL       
chr4        	68171173    	68171495    	68171189       	68171495       	4         	25        	29             	DEL       
chr4        	68508093    	68625479    	68508072       	68625437       	20        	0         	20             	DEL       
chr4        	68925136    	68925457    	68925156       	68925457       	0         	19        	19             	DEL       
chr4        	69094122    	69094447    	69094130       	69094447       	0         	14        	14             	DEL       
chr4        	69394661    	69414291    	69393244       	69412472       	4         	0         	4              	DUP       
chr4        	69394661    	69414291    	69393451       	69413159       	6         	0         	6              	DEL       
chr4        	69394661    	69414291    	69395292       	69414469       	4         	0         	4              	DUP       
chr4        	69394661    	69414291    	69394660       	69414290       	6         	0         	6              	DEL       
chr4        	69395291    	69414469    	69393244       	69412472       	4         	0         	4              	DUP       
chr4        	69395291    	69414469    	69393451       	69413159       	6         	0         	6              	DEL       
chr4        	69395291    	69414469    	69395292       	69414469       	4         	0         	4              	DUP       
chr4        	69395291    	69414469    	69394660       	69414290       	6         	0         	6              	DEL       
chr4        	69601739    	69607084    	69601709       	69607188       	4         	0         	4              	DEL       
chr4        	70242279    	70242478    	70242276       	70242478       	0         	8         	8              	DEL       
chr4        	70336686    	70336907    	70336687       	70336913       	0         	19        	19             	DUP       
chr4        	70516298    	70516404    	70516332       	70516404       	0         	4         	4              	DEL       
chr4        	71060694    	71060855    	71060700       	71060844       	2         	25        	27             	DEL       
chr4        	71963908    	71964238    	71963926       	71964238       	4         	32        	36             	DEL       
chr4        	74271549    	119005810   	114586665      	114589884      	1         	3         	4              	DEL       
chr4        	74271549    	119005810   	117658613      	117669895      	4         	0         	4              	DEL       
chr4        	74271549    	119005810   	74570975       	74571065       	0         	25        	25             	DEL       
chr4        	74271549    	119005810   	74717526       	74723632       	16        	0         	16             	DEL       
chr4        	74271549    	119005810   	78347980       	78354041       	20        	16        	36             	DEL       
chr4        	74271549    	119005810   	79284589       	79284902       	0         	19        	19             	DEL       
chr4        	74271549    	119005810   	80381385       	80381711       	1         	21        	22             	DEL       
chr4        	74271549    	119005810   	81070376       	81070682       	0         	24        	24             	DEL       
chr4        	74271549    	119005810   	82008160       	82010238       	27        	14        	41             	DEL       
chr4        	74271549    	119005810   	82258638       	82258937       	1         	12        	13             	DEL       
chr4        	74271549    	119005810   	82474368       	82474676       	1         	4         	5              	DEL       
chr4        	74271549    	119005810   	83300566       	83300840       	2         	27        	29             	DEL       
chr4        	74271549    	119005810   	85317826       	85317905       	0         	5         	5              	DEL       
chr4        	74271549    	119005810   	85389370       	85389677       	0         	12        	12             	DEL       
chr4        	74271549    	119005810   	85643235       	85643557       	5         	16        	21             	DEL       
chr4        	74271549    	119005810   	85739616       	85739924       	3         	8         	11             	DEL       
chr4        	74271549    	119005810   	86145215       	86145382       	0         	14        	14             	DEL       
chr4        	74271549    	119005810   	86173945       	86173999       	0         	9         	9              	DEL       
chr4        	74271549    	119005810   	86725165       	86730790       	8         	0         	8              	DEL       
chr4        	74271549    	119005810   	87111003       	87111317       	1         	13        	14             	DEL       
chr4        	74271549    	119005810   	87347108       	87353146       	20        	1         	21             	DEL       
chr4        	74271549    	119005810   	87562748       	87565160       	18        	9         	27             	DEL       
chr4        	74271549    	119005810   	87854497       	87854800       	0         	14        	14             	DEL       
chr4        	74271549    	119005810   	88116534       	88116852       	2         	17        	19             	DEL       
chr4        	74271549    	119005810   	88760322       	88760631       	3         	23        	26             	DEL       
chr4        	74271549    	119005810   	90648514       	90648576       	0         	9         	9              	DEL       
chr4        	74271549    	119005810   	90675647       	90681757       	45        	21        	66             	DEL       
chr4        	74271549    	119005810   	91010406       	91014685       	18        	22        	40             	DEL       
chr4        	74271549    	119005810   	91012490       	91014948       	1         	6         	7              	DUP       
chr4        	74271549    	119005810   	91012686       	91014950       	12        	0         	12             	DEL       
chr4        	74271549    	119005810   	91782591       	91782655       	0         	4         	4              	DEL       
chr4        	74271549    	119005810   	92646206       	92649010       	7         	0         	7              	DUP       
chr4        	74271549    	119005810   	92647306       	92649137       	23        	0         	23             	INV       
chr4        	74271549    	119005810   	92832453       	92832724       	0         	4         	4              	DEL       
chr4        	74271549    	119005810   	92934422       	92940410       	16        	0         	16             	DEL       
chr4        	74271549    	119005810   	93517943       	93518026       	0         	15        	15             	DEL       
chr4        	74271549    	119005810   	93638303       	93644339       	20        	9         	29             	DEL       
chr4        	74271549    	119005810   	94577823       	94578129       	2         	14        	16             	DEL       
chr4        	74271549    	119005810   	94949314       	94949615       	2         	2         	4              	DEL       
chr4        	74271549    	119005810   	95461303       	95461509       	0         	9         	9              	DEL       
chr4        	74271549    	119005810   	96650963       	96651270       	1         	15        	16             	DEL       
chr4        	74271549    	119005810   	96976059       	96976379       	1         	11        	12             	DEL       
chr4        	74271549    	119005810   	97189506       	97189819       	1         	9         	10             	DEL       
chr4        	74271549    	119005810   	97212239       	97212538       	0         	5         	5              	DEL       
chr4        	74271549    	119005810   	97260126       	97260431       	1         	16        	17             	DEL       
chr4        	74271549    	119005810   	97433140       	97438062       	25        	6         	31             	DEL       
chr4        	74271549    	119005810   	97669514       	97669819       	3         	29        	32             	DEL       
chr4        	74271549    	119005810   	98892636       	98895949       	18        	2         	20             	DUP       
chr4        	74271549    	119005810   	99149147       	99149447       	1         	21        	22             	DEL       
chr4        	74271549    	119005810   	100323694      	100323953      	0         	16        	16             	DEL       
chr4        	74271549    	119005810   	100371909      	100371984      	0         	18        	18             	DEL       
chr4        	74271549    	119005810   	100769108      	100769219      	0         	12        	12             	DEL       
chr4        	74271549    	119005810   	101749373      	101750029      	6         	0         	6              	DEL       
chr4        	74271549    	119005810   	101791202      	101791252      	0         	6         	6              	DEL       
chr4        	74271549    	119005810   	101866630      	101867194      	15        	16        	31             	DEL       
chr4        	74271549    	119005810   	102410182      	102410704      	0         	7         	7              	DEL       
chr4        	74271549    	119005810   	102408376      	102411004      	23        	0         	23             	DEL       
chr4        	74271549    	119005810   	102951930      	102954478      	13        	0         	13             	DEL       
chr4        	74271549    	119005810   	103139051      	103139161      	0         	11        	11             	DEL       
chr4        	74271549    	119005810   	103650634      	103650701      	0         	6         	6              	DEL       
chr4        	74271549    	119005810   	103972889      	103973523      	10        	12        	22             	DEL       
chr4        	74271549    	119005810   	105914246      	105914591      	0         	5         	5              	DEL       
chr4        	74271549    	119005810   	106135421      	106142205      	25        	6         	31             	DEL       
chr4        	74271549    	119005810   	107053172      	107053330      	2         	14        	16             	DEL       
chr4        	74271549    	119005810   	107142038      	107154888      	19        	10        	29             	DEL       
chr4        	74271549    	119005810   	107206671      	107210557      	50        	19        	69             	DEL       
chr4        	74271549    	119005810   	107355544      	107358347      	23        	12        	35             	DEL       
chr4        	74271549    	119005810   	108799934      	108801069      	20        	0         	20             	DEL       
chr4        	74271549    	119005810   	109577601      	109577909      	0         	14        	14             	DEL       
chr4        	74271549    	119005810   	109827304      	109827368      	0         	14        	14             	DEL       
chr4        	74271549    	119005810   	110462065      	110462376      	3         	14        	17             	DEL       
chr4        	74271549    	119005810   	110595165      	110595353      	0         	13        	13             	DEL       
chr4        	74271549    	119005810   	110887613      	110887903      	2         	19        	21             	DEL       
chr4        	74271549    	119005810   	111337148      	111894883      	7         	0         	7              	DUP       
chr4        	74271549    	119005810   	112427350      	112427413      	0         	5         	5              	DEL       
chr4        	74271549    	119005810   	112548833      	112549125      	3         	16        	19             	DEL       
chr4        	74271549    	119005810   	112749804      	112750298      	0         	8         	8              	DEL       
chr4        	74271549    	119005810   	113064790      	113065179      	6         	0         	6              	DEL       
chr4        	74271549    	119005810   	114586664      	114592708      	20        	0         	20             	DEL       
chr4        	74271549    	119005810   	114703452      	114703714      	0         	18        	18             	DEL       
chr4        	74271549    	119005810   	116174106      	116174238      	0         	16        	16             	DEL       
chr4        	74271549    	119005810   	116330333      	116330639      	1         	10        	11             	DEL       
chr4        	74271549    	119005810   	116499489      	116499752      	0         	4         	4              	DEL       
chr4        	74271549    	119005810   	116779039      	116779941      	7         	0         	7              	DEL       
chr4        	74271549    	119005810   	117248303      	117248367      	0         	4         	4              	DEL       
chr4        	74271549    	119005810   	117668136      	117681644      	5         	0         	5              	DUP       
chr4        	74271549    	119005810   	117668370      	117682018      	8         	0         	8              	DEL       
chr4        	74271549    	119005810   	117739916      	117739985      	1         	3         	4              	DEL       
chr4        	74271549    	119005810   	74271550       	119005810      	4         	0         	4              	DEL       
chr4        	74570972    	74571065    	74570975       	74571065       	0         	25        	25             	DEL       
chr4        	74717529    	74723589    	74717526       	74723632       	16        	0         	16             	DEL       
chr4        	78347965    	78354042    	78347980       	78354041       	20        	16        	36             	DEL       
chr4        	79284573    	79284902    	79284589       	79284902       	0         	19        	19             	DEL       
chr4        	80381371    	80381711    	80381385       	80381711       	1         	21        	22             	DEL       
chr4        	81070360    	81070682    	81070376       	81070682       	0         	24        	24             	DEL       
chr4        	82008146    	82010238    	82008160       	82010238       	27        	14        	41             	DEL       
chr4        	82258624    	82258937    	82258638       	82258937       	1         	12        	13             	DEL       
chr4        	82474354    	82474676    	82474368       	82474676       	1         	4         	5              	DEL       
chr4        	83300554    	83300840    	83300566       	83300840       	2         	27        	29             	DEL       
chr4        	85317822    	85317905    	85317826       	85317905       	0         	5         	5              	DEL       
chr4        	85389365    	85389677    	85389370       	85389677       	0         	12        	12             	DEL       
chr4        	85643231    	85643564    	85643235       	85643557       	5         	16        	21             	DEL       
chr4        	85739601    	85739924    	85739616       	85739924       	3         	8         	11             	DEL       
chr4        	86145199    	86145382    	86145215       	86145382       	0         	14        	14             	DEL       
chr4        	86173938    	86173999    	86173945       	86173999       	0         	9         	9              	DEL       
chr4        	86725237    	86730790    	86725165       	86730790       	8         	0         	8              	DEL       
chr4        	87110984    	87111317    	87111003       	87111317       	1         	13        	14             	DEL       
chr4        	87347090    	87353146    	87347108       	87353146       	20        	1         	21             	DEL       
chr4        	87562730    	87565160    	87562748       	87565160       	18        	9         	27             	DEL       
chr4        	87854482    	87854800    	87854497       	87854800       	0         	14        	14             	DEL       
chr4        	88116515    	88116852    	88116534       	88116852       	2         	17        	19             	DEL       
chr4        	88760308    	88760631    	88760322       	88760631       	3         	23        	26             	DEL       
chr4        	90648513    	90648576    	90648514       	90648576       	0         	9         	9              	DEL       
chr4        	90675633    	90681757    	90675647       	90681757       	45        	21        	66             	DEL       
chr4        	91010404    	91014686    	91010406       	91014685       	18        	22        	40             	DEL       
chr4        	91010404    	91014686    	91012490       	91014948       	1         	6         	7              	DUP       
chr4        	91010404    	91014686    	91012686       	91014950       	12        	0         	12             	DEL       
chr4        	91012489    	91014948    	91010406       	91014685       	18        	22        	40             	DEL       
chr4        	91012489    	91014948    	91012490       	91014948       	1         	6         	7              	DUP       
chr4        	91012489    	91014948    	91012686       	91014950       	12        	0         	12             	DEL       
chr4        	91012687    	91014951    	91010406       	91014685       	18        	22        	40             	DEL       
chr4        	91012687    	91014951    	91012490       	91014948       	1         	6         	7              	DUP       
chr4        	91012687    	91014951    	91012686       	91014950       	12        	0         	12             	DEL       
chr4        	91782570    	91782655    	91782591       	91782655       	0         	4         	4              	DEL       
chr4        	92646206    	92649012    	92646206       	92649010       	7         	0         	7              	DUP       
chr4        	92646206    	92649012    	92647306       	92649137       	23        	0         	23             	INV       
chr4        	92647307    	92649139    	92646206       	92649010       	7         	0         	7              	DUP       
chr4        	92647307    	92649139    	92647306       	92649137       	23        	0         	23             	INV       
chr4        	92832444    	92832724    	92832453       	92832724       	0         	4         	4              	DEL       
chr4        	92934327    	92940464    	92934422       	92940410       	16        	0         	16             	DEL       
chr4        	93517929    	93518026    	93517943       	93518026       	0         	15        	15             	DEL       
chr4        	93638287    	93644339    	93638303       	93644339       	20        	9         	29             	DEL       
chr4        	94577812    	94578129    	94577823       	94578129       	2         	14        	16             	DEL       
chr4        	94949296    	94949615    	94949314       	94949615       	2         	2         	4              	DEL       
chr4        	95461302    	95461509    	95461303       	95461509       	0         	9         	9              	DEL       
chr4        	96650950    	96651270    	96650963       	96651270       	1         	15        	16             	DEL       
chr4        	96976042    	96976379    	96976059       	96976379       	1         	11        	12             	DEL       
chr4        	97189492    	97189819    	97189506       	97189819       	1         	9         	10             	DEL       
chr4        	97212223    	97212538    	97212239       	97212538       	0         	5         	5              	DEL       
chr4        	97260109    	97260431    	97260126       	97260431       	1         	16        	17             	DEL       
chr4        	97433138    	97438062    	97433140       	97438062       	25        	6         	31             	DEL       
chr4        	97669500    	97669819    	97669514       	97669819       	3         	29        	32             	DEL       
chr4        	98892635    	98895948    	98892636       	98895949       	18        	2         	20             	DUP       
chr4        	99149130    	99149447    	99149147       	99149447       	1         	21        	22             	DEL       
chr4        	100323688   	100323953   	100323694      	100323953      	0         	16        	16             	DEL       
chr4        	100371908   	100371979   	100371909      	100371984      	0         	18        	18             	DEL       
chr4        	100769095   	100769219   	100769108      	100769219      	0         	12        	12             	DEL       
chr4        	101749372   	101750029   	101749373      	101750029      	6         	0         	6              	DEL       
chr4        	101791198   	101791252   	101791202      	101791252      	0         	6         	6              	DEL       
chr4        	101866628   	101867195   	101866630      	101867194      	15        	16        	31             	DEL       
chr4        	102408580   	102410890   	102410182      	102410704      	0         	7         	7              	DEL       
chr4        	102410178   	102410711   	102410182      	102410704      	0         	7         	7              	DEL       
chr4        	102951943   	102954450   	102951930      	102954478      	13        	0         	13             	DEL       
chr4        	103139050   	103139161   	103139051      	103139161      	0         	11        	11             	DEL       
chr4        	103650617   	103650701   	103650634      	103650701      	0         	6         	6              	DEL       
chr4        	103972888   	103973523   	103972889      	103973523      	10        	12        	22             	DEL       
chr4        	106135420   	106142205   	106135421      	106142205      	25        	6         	31             	DEL       
chr4        	107053171   	107053330   	107053172      	107053330      	2         	14        	16             	DEL       
chr4        	107142035   	107154888   	107142038      	107154888      	19        	10        	29             	DEL       
chr4        	107206650   	107210557   	107206671      	107210557      	50        	19        	69             	DEL       
chr4        	107355538   	107358347   	107355544      	107358347      	23        	12        	35             	DEL       
chr4        	108799895   	108801059   	108799934      	108801069      	20        	0         	20             	DEL       
chr4        	109577583   	109577909   	109577601      	109577909      	0         	14        	14             	DEL       
chr4        	109827301   	109827368   	109827304      	109827368      	0         	14        	14             	DEL       
chr4        	110462043   	110462376   	110462065      	110462376      	3         	14        	17             	DEL       
chr4        	110595162   	110595353   	110595165      	110595353      	0         	13        	13             	DEL       
chr4        	110887593   	110887903   	110887613      	110887903      	2         	19        	21             	DEL       
chr4        	111337148   	111894885   	111337148      	111894883      	7         	0         	7              	DUP       
chr4        	112427349   	112427413   	112427350      	112427413      	0         	5         	5              	DEL       
chr4        	112548817   	112549125   	112548833      	112549125      	3         	16        	19             	DEL       
chr4        	113064717   	113065180   	113064790      	113065179      	6         	0         	6              	DEL       
chr4        	114586655   	114592709   	114586665      	114589884      	1         	3         	4              	DEL       
chr4        	114586655   	114592709   	114586664      	114592708      	20        	0         	20             	DEL       
chr4        	114703440   	114703714   	114703452      	114703714      	0         	18        	18             	DEL       
chr4        	116174105   	116174238   	116174106      	116174238      	0         	16        	16             	DEL       
chr4        	116330321   	116330640   	116330333      	116330639      	1         	10        	11             	DEL       
chr4        	116499488   	116499752   	116499489      	116499752      	0         	4         	4              	DEL       
chr4        	116779036   	116779942   	116779039      	116779941      	7         	0         	7              	DEL       
chr4        	117668135   	117681644   	117658613      	117669895      	4         	0         	4              	DEL       
chr4        	117668135   	117681644   	117668136      	117681644      	5         	0         	5              	DUP       
chr4        	117668135   	117681644   	117668370      	117682018      	8         	0         	8              	DEL       
chr4        	117668371   	117682019   	117658613      	117669895      	4         	0         	4              	DEL       
chr4        	117668371   	117682019   	117668136      	117681644      	5         	0         	5              	DUP       
chr4        	117668371   	117682019   	117668370      	117682018      	8         	0         	8              	DEL       
chr4        	117740076   	117740170   	117739916      	117739985      	1         	3         	4              	DEL       
chr4        	119096079   	119096400   	119096097      	119096400      	2         	14        	16             	DEL       
chr4        	119342322   	119343515   	119342323      	119343515      	5         	0         	5              	DEL       
chr4        	120165931   	120166137   	120165938      	120166143      	2         	24        	26             	DEL       
chr4        	120887773   	120888091   	120887787      	120888091      	0         	24        	24             	DEL       
chr4        	121311493   	121311611   	121311498      	121311611      	0         	7         	7              	DEL       
chr4        	122321414   	122321540   	122321429      	122321540      	0         	11        	11             	DEL       
chr4        	123908841   	123909102   	123908849      	123909098      	1         	26        	27             	DUP       
chr4        	124022396   	124024031   	124022412      	124024031      	18        	8         	26             	DEL       
chr4        	124750582   	124750902   	124750597      	124750902      	0         	9         	9              	DEL       
chr4        	124946205   	124946535   	124946218      	124946535      	1         	33        	34             	DEL       
chr4        	126101127   	126101562   	126101128      	126101562      	5         	0         	5              	INV       
chr4        	127457934   	127458053   	127457935      	127458053      	0         	15        	15             	DEL       
chr4        	129144970   	129147287   	129144969      	129147286      	5         	0         	5              	DEL       
chr4        	129486397   	129486516   	129486398      	129486516      	0         	19        	19             	DEL       
chr4        	129705218   	129705493   	129705219      	129705493      	0         	9         	9              	DEL       
chr4        	130524354   	130524432   	130524356      	130524432      	0         	9         	9              	DEL       
chr4        	130690036   	130690205   	130690052      	130690205      	0         	21        	21             	DEL       
chr4        	130773682   	130773934   	130773683      	130773919      	0         	12        	12             	DEL       
chr4        	132444314   	132444409   	132444315      	132444409      	0         	7         	7              	DEL       
chr4        	132698720   	132699027   	132698735      	132699027      	1         	15        	16             	DEL       
chr4        	132898441   	132898765   	132898458      	132898765      	3         	21        	24             	DEL       
chr4        	133211359   	133211980   	133211360      	133211980      	9         	0         	9              	DEL       
chr4        	133220446   	133220756   	133220462      	133220756      	0         	24        	24             	DEL       
chr4        	133425619   	133425743   	133425622      	133425743      	0         	6         	6              	DEL       
chr4        	134511846   	134514546   	134511847      	134514546      	35        	21        	56             	DEL       
chr4        	136390481   	136390539   	136390484      	136390539      	0         	8         	8              	DEL       
chr4        	138045056   	138046064   	138045057      	138046064      	21        	7         	28             	DEL       
chr4        	138547724   	138552070   	138547723      	138552069      	42        	0         	42             	DEL       
chr4        	139026859   	139027180   	139026873      	139027179      	6         	6         	12             	DEL       
chr4        	141309623   	141311908   	141309629      	141311908      	48        	25        	73             	DEL       
chr4        	141932285   	141932375   	141932286      	141932375      	0         	13        	13             	DEL       
chr4        	142053968   	142054066   	142053971      	142054066      	0         	8         	8              	DEL       
chr4        	143826747   	144057738   	143826746      	144057737      	7         	0         	7              	DEL       
chr4        	143826747   	144057738   	143858988      	144082864      	6         	0         	6              	DUP       
chr4        	143826747   	144057738   	143981246      	144084468      	4         	0         	4              	DUP       
chr4        	143826747   	144057738   	143884100      	144124636      	6         	0         	6              	DEL       
chr4        	143858988   	144082866   	143826746      	144057737      	7         	0         	7              	DEL       
chr4        	143858988   	144082866   	143858988      	144082864      	6         	0         	6              	DUP       
chr4        	143858988   	144082866   	143981246      	144084468      	4         	0         	4              	DUP       
chr4        	143858988   	144082866   	143884100      	144124636      	6         	0         	6              	DEL       
chr4        	144395292   	144398753   	144395262      	144398753      	6         	0         	6              	DEL       
chr4        	145517653   	145519298   	145517661      	145519298      	45        	11        	56             	DEL       
chr4        	145693779   	145694473   	145693809      	145694616      	17        	0         	17             	INV       
chr4        	146286075   	146287001   	146286075      	146286961      	4         	0         	4              	DUP       
chr4        	146809024   	146809938   	146808998      	146809938      	17        	0         	17             	DEL       
chr4        	149239886   	149240229   	149239904      	149240229      	5         	18        	23             	DEL       
chr4        	150029874   	150030197   	150029888      	150030197      	5         	16        	21             	DEL       
chr4        	151419552   	151420400   	151419570      	151420400      	21        	9         	30             	DEL       
chr4        	151857371   	151857840   	151857372      	151857840      	1         	10        	11             	DEL       
chr4        	152069158   	152072794   	152069162      	152072794      	17        	5         	22             	DEL       
chr4        	154156836   	154212718   	154156835      	154212717      	8         	0         	8              	DEL       
chr4        	154881858   	154881938   	154881859      	154881938      	0         	18        	18             	DEL       
chr4        	155328121   	155328523   	155328122      	155328523      	5         	19        	24             	DEL       
chr4        	156080879   	156081191   	156080894      	156081191      	3         	23        	26             	DEL       
chr4        	160957876   	160963791   	160957882      	160963791      	50        	20        	70             	DEL       
chr4        	161854981   	161855060   	161854982      	161855060      	0         	15        	15             	DEL       
chr4        	162141092   	162141412   	162141110      	162141412      	0         	9         	9              	DEL       
chr4        	163580787   	163581101   	163580802      	163581101      	0         	9         	9              	DEL       
chr4        	163737145   	163737980   	163737160      	163737980      	22        	7         	29             	DEL       
chr4        	164754799   	164755096   	164754820      	164755096      	0         	7         	7              	DEL       
chr4        	165081464   	165083903   	165081506      	165083868      	28        	0         	28             	DEL       
chr4        	166083163   	166083767   	166083164      	166083767      	10        	11        	21             	DEL       
chr4        	166186934   	166187277   	166186951      	166187277      	3         	23        	26             	DEL       
chr4        	166755884   	166761920   	166755897      	166761920      	45        	21        	66             	DEL       
chr4        	167885326   	167885439   	167885328      	167885439      	0         	4         	4              	DEL       
chr4        	169357308   	169357730   	169357313      	169357730      	7         	16        	23             	DEL       
chr4        	169787156   	169787306   	169787134      	169787312      	0         	7         	7              	DUP       
chr4        	169887285   	169887566   	169887295      	169887559      	0         	7         	7              	DEL       
chr4        	171048531   	171048596   	171048532      	171048596      	0         	22        	22             	DEL       
chr4        	171453259   	171458274   	171453261      	171458274      	15        	7         	22             	DEL       
chr4        	172067487   	172071780   	172067488      	172071780      	36        	18        	54             	DEL       
chr4        	172255281   	172255336   	172255284      	172255336      	0         	8         	8              	DEL       
chr4        	173611907   	173614760   	173611958      	173614735      	13        	0         	13             	DEL       
chr4        	176055683   	176055798   	176055692      	176055798      	0         	4         	4              	DEL       
chr4        	176218227   	176219085   	176218228      	176219085      	13        	0         	13             	DEL       
chr4        	176948163   	176948480   	176948178      	176948480      	3         	12        	15             	DEL       
chr4        	177235672   	177236002   	177235683      	177236002      	3         	26        	29             	DEL       
chr4        	177982494   	177982722   	177982498      	177982722      	0         	13        	13             	DEL       
chr4        	179142662   	179143006   	179142665      	179143006      	1         	5         	6              	DEL       
chr4        	179176721   	179177353   	179176723      	179177353      	15        	8         	23             	DEL       
chr4        	180396117   	180396301   	180396136      	180396301      	1         	23        	24             	DEL       
chr4        	180628274   	180628589   	180628287      	180628589      	0         	22        	22             	DEL       
chr4        	180955632   	180957135   	180955649      	180957135      	54        	22        	76             	DEL       
chr4        	181135405   	181135976   	181135408      	181135976      	9         	15        	24             	DEL       
chr4        	183753114   	183754575   	183753083      	183754558      	13        	0         	13             	DEL       
chr4        	184744616   	184744935   	184744628      	184744935      	1         	14        	15             	DEL       
chr4        	185063738   	185063898   	185063739      	185063898      	0         	5         	5              	DUP       
chr4        	185234385   	185234697   	185234400      	185234697      	2         	12        	14             	DEL       
chr4        	185277714   	185278035   	185277724      	185278035      	0         	11        	11             	DEL       
chr4        	185520480   	185522919   	185520483      	185522919      	61        	28        	89             	DEL       
chr4        	186172333   	186177088   	186172332      	186177087      	7         	0         	7              	DEL       
chr4        	186292799   	186293583   	186292823      	186293555      	28        	0         	28             	DEL       
chr4        	186432376   	186436011   	186432325      	186436010      	7         	0         	7              	DEL       
chr4        	186457552   	186457626   	186457555      	186457626      	0         	9         	9              	DEL       
chr4        	186693361   	186693690   	186693366      	186693690      	0         	4         	4              	DEL       
chr4        	186874542   	186874863   	186874559      	186874863      	2         	16        	18             	DEL       
chr4        	188038211   	188038334   	188038216      	188038334      	0         	14        	14             	DEL       
chr4        	188506343   	188509137   	188506343      	188509135      	16        	0         	16             	DUP       
chr4        	188506343   	188509137   	188508141      	188508609      	4         	0         	4              	DEL       
chr4        	188872084   	188872404   	188872100      	188872404      	1         	23        	24             	DEL       
chr4        	188874245   	188874831   	188874246      	188874831      	6         	0         	6              	DEL       
chr4        	189048521   	189048877   	189048541      	189048876      	2         	17        	19             	DEL       
chr4        	189050985   	189051581   	189051261      	189052145      	9         	0         	9              	DEL       
chr4        	189136843   	189143118   	189136860      	189143118      	16        	4         	20             	DEL       
chr4        	189184285   	189185043   	189184286      	189185043      	24        	0         	24             	DEL       
chr4        	189270445   	189279308   	189270449      	189279308      	6         	3         	9              	DEL       
chr4        	189332683   	189333006   	189332699      	189333006      	4         	25        	29             	DEL       
chr4        	189370263   	189370583   	189370277      	189370583      	1         	8         	9              	DEL       
chr4        	189508174   	189508328   	189508175      	189508329      	0         	14        	14             	DUP       
chr5        	53217       	53451       	53218          	53451          	0         	6         	6              	DEL       
chr5        	693238      	784642      	692855         	784399         	4         	0         	4              	DEL       
chr5        	693238      	784642      	693238         	784640         	8         	0         	8              	DUP       
chr5        	693238      	784642      	697073         	788737         	4         	0         	4              	DUP       
chr5        	693238      	784642      	710220         	795288         	4         	0         	4              	DUP       
chr5        	693238      	784642      	746100         	838547         	4         	0         	4              	DEL       
chr5        	693238      	784642      	747722         	840039         	6         	0         	6              	DEL       
chr5        	697073      	788739      	692855         	784399         	4         	0         	4              	DEL       
chr5        	697073      	788739      	693238         	784640         	8         	0         	8              	DUP       
chr5        	697073      	788739      	697073         	788737         	4         	0         	4              	DUP       
chr5        	697073      	788739      	710220         	795288         	4         	0         	4              	DUP       
chr5        	697073      	788739      	746100         	838547         	4         	0         	4              	DEL       
chr5        	697073      	788739      	747722         	840039         	6         	0         	6              	DEL       
chr5        	710219      	795288      	692855         	784399         	4         	0         	4              	DEL       
chr5        	710219      	795288      	693238         	784640         	8         	0         	8              	DUP       
chr5        	710219      	795288      	697073         	788737         	4         	0         	4              	DUP       
chr5        	710219      	795288      	710220         	795288         	4         	0         	4              	DUP       
chr5        	710219      	795288      	746100         	838547         	4         	0         	4              	DEL       
chr5        	710219      	795288      	747722         	840039         	6         	0         	6              	DEL       
chr5        	1044586     	1045336     	1044615        	1045303        	7         	0         	7              	DUP       
chr5        	1061035     	1061577     	1061036        	1061577        	4         	0         	4              	DEL       
chr5        	1178177     	1180617     	1178179        	1180617        	15        	8         	23             	DEL       
chr5        	1682347     	1682660     	1682360        	1682660        	5         	25        	30             	DEL       
chr5        	1845405     	1845955     	1845511        	1846012        	7         	0         	7              	DUP       
chr5        	1924475     	1925088     	1924477        	1925088        	6         	6         	12             	DEL       
chr5        	1941029     	1941340     	1941042        	1941340        	0         	27        	27             	DEL       
chr5        	1950897     	1951341     	1950911        	1951334        	3         	3         	6              	DEL       
chr5        	2226268     	2226864     	2226269        	2226864        	6         	4         	10             	DEL       
chr5        	2769308     	2769526     	2769314        	2769526        	0         	14        	14             	DEL       
chr5        	3323559     	3324342     	3323580        	3324337        	17        	0         	17             	DUP       
chr5        	3499146     	3499468     	3499159        	3499468        	0         	10        	10             	DEL       
chr5        	3502198     	3502528     	3502213        	3502527        	1         	7         	8              	DEL       
chr5        	3637891     	3639154     	3637981        	3639201        	9         	0         	9              	DEL       
chr5        	6524261     	6524581     	6524277        	6524581        	0         	9         	9              	DEL       
chr5        	7221818     	7222140     	7221829        	7222140        	0         	12        	12             	DEL       
chr5        	7371587     	7372622     	7371553        	7372513        	6         	0         	6              	DEL       
chr5        	8937734     	8938708     	8937741        	8938708        	23        	11        	34             	DEL       
chr5        	9400497     	9400768     	9400507        	9400768        	0         	6         	6              	DEL       
chr5        	9411647     	9411962     	9411662        	9411962        	1         	14        	15             	DEL       
chr5        	9989985     	9990199     	9989987        	9990199        	1         	20        	21             	DEL       
chr5        	10638907    	10640141    	10638956       	10640137       	13        	0         	13             	DEL       
chr5        	11338912    	11339237    	11338930       	11339237       	1         	16        	17             	DEL       
chr5        	12037376    	12037457    	12037378       	12037457       	0         	7         	7              	DEL       
chr5        	12769543    	12769598    	12769547       	12769598       	0         	8         	8              	DEL       
chr5        	12967728    	12967789    	12967734       	12967789       	0         	5         	5              	DEL       
chr5        	13855190    	13855506    	13855208       	13855506       	0         	9         	9              	DEL       
chr5        	13894972    	13895270    	13894983       	13895270       	2         	22        	24             	DEL       
chr5        	16982813    	16982907    	16982834       	16982908       	0         	10        	10             	DEL       
chr5        	17508120    	17621766    	17508120       	17621764       	6         	0         	6              	DUP       
chr5        	17508120    	17621766    	17508335       	17622092       	6         	0         	6              	DEL       
chr5        	17508336    	17622093    	17508120       	17621764       	6         	0         	6              	DUP       
chr5        	17508336    	17622093    	17508335       	17622092       	6         	0         	6              	DEL       
chr5        	18873202    	18874738    	18873203       	18874738       	0         	8         	8              	DEL       
chr5        	19078407    	19078927    	19078408       	19078927       	5         	0         	5              	DEL       
chr5        	21651473    	21651782    	21651474       	21651782       	0         	4         	4              	DEL       
chr5        	22154481    	22154543    	22154482       	22154543       	0         	4         	4              	DEL       
chr5        	22796500    	22796819    	22796516       	22796819       	1         	9         	10             	DEL       
chr5        	24091497    	24091823    	24091513       	24091823       	2         	13        	15             	DEL       
chr5        	24370417    	24373328    	24370433       	24373327       	44        	22        	66             	DEL       
chr5        	24452729    	24453052    	24452743       	24453052       	0         	18        	18             	DEL       
chr5        	24758215    	24758286    	24758236       	24758286       	0         	15        	15             	DEL       
chr5        	25777196    	25777521    	25777212       	25777521       	4         	28        	32             	DEL       
chr5        	26111076    	26111403    	26111094       	26111403       	1         	26        	27             	DEL       
chr5        	26154125    	26154186    	26154126       	26154186       	0         	8         	8              	DEL       
chr5        	26186145    	26186206    	26186147       	26186206       	0         	7         	7              	DEL       
chr5        	26600607    	26600726    	26600618       	26600726       	0         	13        	13             	DEL       
chr5        	26653792    	26653857    	26653796       	26653857       	0         	9         	9              	DEL       
chr5        	26793191    	26793524    	26793134       	26793522       	10        	0         	10             	INV       
chr5        	26796588    	26801787    	26796592       	26801787       	25        	7         	32             	DEL       
chr5        	26864191    	26864256    	26864205       	26864256       	0         	8         	8              	DEL       
chr5        	28309209    	28309386    	28309211       	28309386       	0         	11        	11             	DEL       
chr5        	28813468    	28813722    	28813472       	28813722       	0         	11        	11             	DEL       
chr5        	29858562    	29858622    	29858563       	29858622       	0         	4         	4              	DEL       
chr5        	30915411    	30915948    	30915411       	30915948       	2         	4         	6              	DEL       
chr5        	31677316    	31677638    	31677334       	31677638       	1         	15        	16             	DEL       
chr5        	31849884    	31849996    	31849888       	31849967       	0         	12        	12             	DEL       
chr5        	33200752    	33201065    	33200764       	33201065       	2         	17        	19             	DEL       
chr5        	33355456    	33355788    	33355469       	33355788       	2         	17        	19             	DEL       
chr5        	34304683    	34307799    	34304693       	34307799       	60        	4         	64             	DEL       
chr5        	35191031    	35191370    	35191048       	35191369       	1         	6         	7              	DEL       
chr5        	35614070    	35614384    	35614083       	35614384       	1         	11        	12             	DEL       
chr5        	37293696    	37294028    	37293717       	37294028       	1         	13        	14             	DEL       
chr5        	40697050    	40697151    	40697077       	40697151       	0         	5         	5              	DEL       
chr5        	42165825    	42167667    	42165839       	42167667       	47        	24        	71             	DEL       
chr5        	43516377    	43516447    	43516380       	43516447       	0         	12        	12             	DEL       
chr5        	43523534    	43523590    	43523538       	43523590       	0         	5         	5              	DEL       
chr5        	43665830    	43824485    	43665557       	43824276       	5         	0         	5              	DEL       
chr5        	43665830    	43824485    	43666231       	43824515       	5         	0         	5              	DUP       
chr5        	44514122    	44517788    	44514128       	44517787       	1         	7         	8              	DEL       
chr5        	44514122    	44517788    	44514118       	44517852       	5         	5         	10             	DUP       
chr5        	44514116    	44517852    	44514128       	44517787       	1         	7         	8              	DEL       
chr5        	44514116    	44517852    	44514118       	44517852       	5         	5         	10             	DUP       
chr5        	46270549    	46275734    	46270554       	46275734       	71        	29        	100            	DEL       
chr5        	46405924    	46406949    	46405957       	46406949       	29        	5         	34             	DEL       
chr5        	46405185    	46410472    	46405957       	46406949       	29        	5         	34             	DEL       
chr5        	46405185    	46410472    	46407689       	46409803       	20        	0         	20             	DEL       
chr5        	46405185    	46410472    	46405230       	46410472       	4         	0         	4              	DEL       
chr5        	46407629    	46409843    	46407689       	46409803       	20        	0         	20             	DEL       
chr5        	46490991    	46508585    	46500620       	46508280       	5         	0         	5              	DEL       
chr5        	46490991    	46508585    	46491193       	46508451       	17        	0         	17             	DUP       
chr5        	46490991    	46508585    	46493618       	46692142       	5         	0         	5              	DEL       
chr5        	46493807    	46691989    	46500620       	46508280       	5         	0         	5              	DEL       
chr5        	46493807    	46691989    	46491193       	46508451       	17        	0         	17             	DUP       
chr5        	46493807    	46691989    	46571587       	46689522       	15        	0         	15             	DEL       
chr5        	46493807    	46691989    	46621894       	46696048       	5         	0         	5              	DEL       
chr5        	46493807    	46691989    	46659121       	46708986       	10        	0         	10             	DEL       
chr5        	46571586    	46689522    	46571587       	46689522       	15        	0         	15             	DEL       
chr5        	46571586    	46689522    	46621894       	46696048       	5         	0         	5              	DEL       
chr5        	46571586    	46689522    	46659121       	46708986       	10        	0         	10             	DEL       
chr5        	46621893    	46696048    	46571587       	46689522       	15        	0         	15             	DEL       
chr5        	46621893    	46696048    	46493618       	46692142       	5         	0         	5              	DEL       
chr5        	46621893    	46696048    	46621894       	46696048       	5         	0         	5              	DEL       
chr5        	46621893    	46696048    	46659121       	46708986       	10        	0         	10             	DEL       
chr5        	46621893    	46696048    	46693477       	46783972       	4         	0         	4              	DUP       
chr5        	46659120    	46708986    	46571587       	46689522       	15        	0         	15             	DEL       
chr5        	46659120    	46708986    	46493618       	46692142       	5         	0         	5              	DEL       
chr5        	46659120    	46708986    	46621894       	46696048       	5         	0         	5              	DEL       
chr5        	46659120    	46708986    	46659121       	46708986       	10        	0         	10             	DEL       
chr5        	46659120    	46708986    	46693477       	46783972       	4         	0         	4              	DUP       
chr5        	46659120    	46708986    	46708883       	46784018       	20        	0         	20             	DUP       
chr5        	46693476    	46783972    	46621894       	46696048       	5         	0         	5              	DEL       
chr5        	46693476    	46783972    	46659121       	46708986       	10        	0         	10             	DEL       
chr5        	46693476    	46783972    	46693477       	46783972       	4         	0         	4              	DUP       
chr5        	46693476    	46783972    	46708883       	46784018       	20        	0         	20             	DUP       
chr5        	46708882    	46784018    	46659121       	46708986       	10        	0         	10             	DEL       
chr5        	46708882    	46784018    	46693477       	46783972       	4         	0         	4              	DUP       
chr5        	46708882    	46784018    	46708883       	46784018       	20        	0         	20             	DUP       
chr5        	49621621    	49622443    	49621622       	49622443       	6         	0         	6              	DUP       
chr5        	49676052    	49680994    	49676029       	49680823       	10        	0         	10             	DUP       
chr5        	49676052    	49680994    	49677630       	49680624       	4         	0         	4              	DEL       
chr5        	49676052    	49680994    	49677409       	49711035       	4         	0         	4              	DUP       
chr5        	49677629    	49680624    	49677630       	49680624       	4         	0         	4              	DEL       
chr5        	49677408    	49711035    	49676029       	49680823       	10        	0         	10             	DUP       
chr5        	49677408    	49711035    	49677630       	49680624       	4         	0         	4              	DEL       
chr5        	49677408    	49711035    	49684569       	49687159       	5         	0         	5              	DUP       
chr5        	49677408    	49711035    	49706052       	49710972       	4         	0         	4              	DUP       
chr5        	49677408    	49711035    	49677409       	49711035       	4         	0         	4              	DUP       
chr5        	49677408    	49711035    	49687133       	49748972       	6         	0         	6              	DEL       
chr5        	49684568    	49687159    	49684569       	49687159       	5         	0         	5              	DUP       
chr5        	49684568    	49687159    	49687133       	49748972       	6         	0         	6              	DEL       
chr5        	49687132    	49748972    	49739586       	49856545       	4         	0         	4              	DEL       
chr5        	49687132    	49748972    	49684569       	49687159       	5         	0         	5              	DUP       
chr5        	49687132    	49748972    	49706052       	49710972       	4         	0         	4              	DUP       
chr5        	49687132    	49748972    	49677409       	49711035       	4         	0         	4              	DUP       
chr5        	49687132    	49748972    	49739327       	49747884       	5         	0         	5              	DUP       
chr5        	49687132    	49748972    	49687133       	49748972       	6         	0         	6              	DEL       
chr5        	49687132    	49748972    	49723332       	49895141       	6         	0         	6              	DUP       
chr5        	49687132    	49748972    	49747882       	49930646       	4         	0         	4              	DEL       
chr5        	49687132    	49748972    	49723596       	49937285       	11        	0         	11             	DEL       
chr5        	49706051    	49710972    	49706052       	49710972       	4         	0         	4              	DUP       
chr5        	49706051    	49710972    	49677409       	49711035       	4         	0         	4              	DUP       
chr5        	49723331    	49895141    	49739586       	49856545       	4         	0         	4              	DEL       
chr5        	49723331    	49895141    	49739327       	49747884       	5         	0         	5              	DUP       
chr5        	49723331    	49895141    	49687133       	49748972       	6         	0         	6              	DEL       
chr5        	49723331    	49895141    	49770589       	49832518       	4         	0         	4              	DEL       
chr5        	49723331    	49895141    	49667530       	49832881       	24        	0         	24             	DUP       
chr5        	49723331    	49895141    	49832508       	49886199       	8         	0         	8              	DUP       
chr5        	49723331    	49895141    	49723332       	49895141       	6         	0         	6              	DUP       
chr5        	49723331    	49895141    	49853710       	49913527       	4         	0         	4              	DEL       
chr5        	49723331    	49895141    	49747882       	49930646       	4         	0         	4              	DEL       
chr5        	49723331    	49895141    	49723596       	49937285       	11        	0         	11             	DEL       
chr5        	49723331    	49895141    	49853691       	49990662       	6         	0         	6              	DEL       
chr5        	49723768    	49937155    	49739586       	49856545       	4         	0         	4              	DEL       
chr5        	49723768    	49937155    	49739327       	49747884       	5         	0         	5              	DUP       
chr5        	49723768    	49937155    	49687133       	49748972       	6         	0         	6              	DEL       
chr5        	49723768    	49937155    	49770589       	49832518       	4         	0         	4              	DEL       
chr5        	49723768    	49937155    	49667530       	49832881       	24        	0         	24             	DUP       
chr5        	49723768    	49937155    	49832508       	49886199       	8         	0         	8              	DUP       
chr5        	49723768    	49937155    	49723332       	49895141       	6         	0         	6              	DUP       
chr5        	49723768    	49937155    	49853710       	49913527       	4         	0         	4              	DEL       
chr5        	49723768    	49937155    	49895796       	49913538       	8         	0         	8              	DEL       
chr5        	49723768    	49937155    	49747882       	49930646       	4         	0         	4              	DEL       
chr5        	49723768    	49937155    	49853691       	49990662       	6         	0         	6              	DEL       
chr5        	49723768    	49937155    	49914029       	50026942       	5         	0         	5              	DEL       
chr5        	49739139    	49748106    	49739586       	49856545       	4         	0         	4              	DEL       
chr5        	49739139    	49748106    	49739327       	49747884       	5         	0         	5              	DUP       
chr5        	49739139    	49748106    	49747882       	49930646       	4         	0         	4              	DEL       
chr5        	49739585    	49856545    	49739586       	49856545       	4         	0         	4              	DEL       
chr5        	49739585    	49856545    	49739327       	49747884       	5         	0         	5              	DUP       
chr5        	49739585    	49856545    	49687133       	49748972       	6         	0         	6              	DEL       
chr5        	49739585    	49856545    	49770589       	49832518       	4         	0         	4              	DEL       
chr5        	49739585    	49856545    	49667530       	49832881       	24        	0         	24             	DUP       
chr5        	49739585    	49856545    	49832508       	49886199       	8         	0         	8              	DUP       
chr5        	49739585    	49856545    	49853710       	49913527       	4         	0         	4              	DEL       
chr5        	49739585    	49856545    	49747882       	49930646       	4         	0         	4              	DEL       
chr5        	49739585    	49856545    	49853691       	49990662       	6         	0         	6              	DEL       
chr5        	49747881    	49930646    	49739586       	49856545       	4         	0         	4              	DEL       
chr5        	49747881    	49930646    	49739327       	49747884       	5         	0         	5              	DUP       
chr5        	49747881    	49930646    	49687133       	49748972       	6         	0         	6              	DEL       
chr5        	49747881    	49930646    	49770589       	49832518       	4         	0         	4              	DEL       
chr5        	49747881    	49930646    	49667530       	49832881       	24        	0         	24             	DUP       
chr5        	49747881    	49930646    	49832508       	49886199       	8         	0         	8              	DUP       
chr5        	49747881    	49930646    	49723332       	49895141       	6         	0         	6              	DUP       
chr5        	49747881    	49930646    	49853710       	49913527       	4         	0         	4              	DEL       
chr5        	49747881    	49930646    	49895796       	49913538       	8         	0         	8              	DEL       
chr5        	49747881    	49930646    	49747882       	49930646       	4         	0         	4              	DEL       
chr5        	49747881    	49930646    	49853691       	49990662       	6         	0         	6              	DEL       
chr5        	49747881    	49930646    	49914029       	50026942       	5         	0         	5              	DEL       
chr5        	49770588    	49832518    	49770589       	49832518       	4         	0         	4              	DEL       
chr5        	49770588    	49832518    	49832508       	49886199       	8         	0         	8              	DUP       
chr5        	49832507    	49886199    	49739586       	49856545       	4         	0         	4              	DEL       
chr5        	49832507    	49886199    	49770589       	49832518       	4         	0         	4              	DEL       
chr5        	49832507    	49886199    	49667530       	49832881       	24        	0         	24             	DUP       
chr5        	49832507    	49886199    	49832508       	49886199       	8         	0         	8              	DUP       
chr5        	49832507    	49886199    	49853710       	49913527       	4         	0         	4              	DEL       
chr5        	49832507    	49886199    	49853691       	49990662       	6         	0         	6              	DEL       
chr5        	49853709    	49913527    	49739586       	49856545       	4         	0         	4              	DEL       
chr5        	49853709    	49913527    	49832508       	49886199       	8         	0         	8              	DUP       
chr5        	49853709    	49913527    	49723332       	49895141       	6         	0         	6              	DUP       
chr5        	49853709    	49913527    	49853710       	49913527       	4         	0         	4              	DEL       
chr5        	49853709    	49913527    	49895796       	49913538       	8         	0         	8              	DEL       
chr5        	49853709    	49913527    	49853691       	49990662       	6         	0         	6              	DEL       
chr5        	49853690    	49990662    	49739586       	49856545       	4         	0         	4              	DEL       
chr5        	49853690    	49990662    	49832508       	49886199       	8         	0         	8              	DUP       
chr5        	49853690    	49990662    	49723332       	49895141       	6         	0         	6              	DUP       
chr5        	49853690    	49990662    	49853710       	49913527       	4         	0         	4              	DEL       
chr5        	49853690    	49990662    	49895796       	49913538       	8         	0         	8              	DEL       
chr5        	49853690    	49990662    	49747882       	49930646       	4         	0         	4              	DEL       
chr5        	49853690    	49990662    	49723596       	49937285       	11        	0         	11             	DEL       
chr5        	49853690    	49990662    	49937617       	49958077       	5         	0         	5              	DEL       
chr5        	49853690    	49990662    	49853691       	49990662       	6         	0         	6              	DEL       
chr5        	49853690    	49990662    	49914029       	50026942       	5         	0         	5              	DEL       
chr5        	49895795    	49913538    	49853710       	49913527       	4         	0         	4              	DEL       
chr5        	49895795    	49913538    	49895796       	49913538       	8         	0         	8              	DEL       
chr5        	49937647    	49958089    	49937617       	49958077       	5         	0         	5              	DEL       
chr5        	50938545    	50943630    	50938549       	50943630       	24        	6         	30             	DEL       
chr5        	51984587    	51984660    	51984589       	51984660       	0         	13        	13             	DEL       
chr5        	52935940    	52936274    	52935958       	52936274       	2         	24        	26             	DEL       
chr5        	53102569    	53102634    	53102570       	53102634       	0         	10        	10             	DEL       
chr5        	53881097    	53881403    	53881111       	53881403       	2         	20        	22             	DEL       
chr5        	54459700    	54459789    	54459702       	54459789       	0         	8         	8              	DEL       
chr5        	54785929    	54786079    	54785930       	54786079       	0         	7         	7              	DEL       
chr5        	55433270    	55433551    	55433271       	55433551       	0         	4         	4              	DEL       
chr5        	56133378    	56134519    	56133423       	56134510       	40        	0         	40             	DEL       
chr5        	58027648    	58037951    	58027651       	58037951       	18        	9         	27             	DEL       
chr5        	58384164    	58390274    	58384174       	58390268       	34        	10        	44             	DEL       
chr5        	58481776    	58482299    	58481777       	58482299       	13        	1         	14             	DEL       
chr5        	60705876    	60707838    	60705882       	60707838       	39        	21        	60             	DEL       
chr5        	60898965    	60899129    	60898978       	60899128       	0         	5         	5              	DEL       
chr5        	61907876    	61908031    	61907877       	61908031       	0         	11        	11             	DEL       
chr5        	61997798    	61998125    	61997813       	61998125       	0         	8         	8              	DEL       
chr5        	62279034    	62280777    	62278954       	62280697       	15        	0         	15             	DEL       
chr5        	63008875    	63008995    	63008876       	63008995       	0         	6         	6              	DEL       
chr5        	63277511    	63614765    	63324877       	63325180       	0         	4         	4              	DEL       
chr5        	63277511    	63614765    	63408624       	63408934       	4         	7         	11             	DEL       
chr5        	63277511    	63614765    	63277533       	63614944       	10        	0         	10             	DEL       
chr5        	63324857    	63325180    	63324877       	63325180       	0         	4         	4              	DEL       
chr5        	63408610    	63408934    	63408624       	63408934       	4         	7         	11             	DEL       
chr5        	64990226    	64990564    	64990243       	64990564       	4         	13        	17             	DEL       
chr5        	66050212    	66050543    	66050228       	66050543       	2         	7         	9              	DEL       
chr5        	71557653    	71557721    	71557654       	71557721       	0         	6         	6              	DEL       
chr5        	73741376    	73741430    	73741378       	73741429       	0         	5         	5              	DEL       
chr5        	73775880    	73775932    	73775881       	73775932       	0         	6         	6              	DEL       
chr5        	74353159    	74353478    	74353171       	74353478       	1         	26        	27             	DEL       
chr5        	75786467    	75786777    	75786477       	75786777       	0         	15        	15             	DEL       
chr5        	76139837    	76139956    	76139855       	76139956       	0         	16        	16             	DEL       
chr5        	77766483    	77766794    	77766501       	77766794       	1         	12        	13             	DEL       
chr5        	77809393    	77809724    	77809408       	77809724       	0         	20        	20             	DEL       
chr5        	78278341    	78278633    	78278353       	78278632       	0         	15        	15             	DEL       
chr5        	78981902    	78982222    	78981916       	78982222       	2         	14        	16             	DEL       
chr5        	80261368    	80261683    	80261380       	80261683       	1         	8         	9              	DEL       
chr5        	81455322    	81455652    	81455337       	81455652       	0         	11        	11             	DEL       
chr5        	81712344    	81712618    	81712362       	81712618       	0         	20        	20             	DEL       
chr5        	81886659    	81887002    	81886671       	81887002       	1         	16        	17             	DEL       
chr5        	82860896    	82861212    	82860913       	82861212       	2         	17        	19             	DEL       
chr5        	83610238    	83610558    	83610256       	83610558       	0         	10        	10             	DEL       
chr5        	84652272    	84659346    	84652216       	84659393       	11        	0         	11             	DEL       
chr5        	86109522    	86109692    	86109523       	86109692       	0         	9         	9              	DEL       
chr5        	88032842    	88032990    	88032843       	88032990       	0         	30        	30             	DEL       
chr5        	88736194    	88736525    	88736212       	88736525       	0         	10        	10             	DEL       
chr5        	88747320    	88747649    	88747337       	88747649       	1         	8         	9              	DEL       
chr5        	89310538    	89311201    	89310539       	89311201       	24        	0         	24             	DEL       
chr5        	90564603    	90564925    	90564618       	90564925       	0         	7         	7              	DEL       
chr5        	90808622    	90809230    	90808623       	90809230       	0         	4         	4              	DEL       
chr5        	91203954    	91206278    	91203958       	91206278       	31        	21        	52             	DEL       
chr5        	91278875    	91279169    	91278885       	91279169       	0         	15        	15             	DEL       
chr5        	92184956    	92185312    	92184970       	92185311       	1         	16        	17             	DEL       
chr5        	94580577    	94580915    	94580594       	94580915       	3         	11        	14             	DEL       
chr5        	94773919    	94774249    	94773928       	94774249       	0         	4         	4              	DEL       
chr5        	96007606    	96007962    	96007622       	96007961       	4         	19        	23             	DEL       
chr5        	96574010    	96574357    	96574027       	96574357       	2         	11        	13             	DEL       
chr5        	96989312    	96989413    	96989319       	96989390       	0         	9         	9              	DEL       
chr5        	97282260    	97282353    	97282300       	97282353       	0         	10        	10             	DEL       
chr5        	98065856    	98067056    	98065859       	98067050       	19        	11        	30             	DEL       
chr5        	99009412    	99011778    	99009413       	99011778       	34        	2         	36             	DEL       
chr5        	99522869    	99523930    	99522870       	99523930       	8         	0         	8              	DEL       
chr5        	99838609    	99838924    	99838625       	99838924       	3         	21        	24             	DEL       
chr5        	100272442   	100272755   	100272460      	100272755      	0         	12        	12             	DEL       
chr5        	100423755   	100424074   	100423772      	100424074      	3         	25        	28             	DEL       
chr5        	100587828   	100588134   	100587843      	100588134      	1         	5         	6              	DEL       
chr5        	102827649   	102827903   	102827669      	102827903      	0         	28        	28             	DEL       
chr5        	103694852   	103695178   	103694866      	103695178      	2         	13        	15             	DEL       
chr5        	103726608   	103726925   	103726615      	103726925      	0         	8         	8              	DEL       
chr5        	104518572   	104524625   	104518587      	104524625      	32        	8         	40             	DEL       
chr5        	106989049   	106990726   	106989050      	106990742      	18        	4         	22             	DEL       
chr5        	107862782   	107863620   	107862784      	107863620      	23        	9         	32             	DEL       
chr5        	111359243   	111359566   	111359244      	111359566      	2         	15        	17             	DEL       
chr5        	114123339   	114123663   	114123358      	114123663      	1         	10        	11             	DEL       
chr5        	114989670   	114999300   	114989662      	114999235      	22        	0         	22             	DEL       
chr5        	115395614   	115395933   	115395629      	115395933      	2         	12        	14             	DEL       
chr5        	115420800   	115422192   	115420818      	115422192      	17        	6         	23             	DEL       
chr5        	115633703   	115634147   	115633704      	115634147      	12        	0         	12             	DEL       
chr5        	115794759   	115795109   	115794770      	115795109      	2         	12        	14             	DEL       
chr5        	116558439   	116558761   	116558452      	116558761      	4         	20        	24             	DEL       
chr5        	116937600   	116937692   	116937590      	116937692      	0         	10        	10             	DEL       
chr5        	117092485   	117092804   	117092499      	117092804      	1         	8         	9              	DEL       
chr5        	117973457   	117973635   	117973458      	117973635      	0         	9         	9              	DUP       
chr5        	118532526   	118532839   	118532527      	118532839      	0         	9         	9              	DEL       
chr5        	119679448   	119679769   	119679462      	119679769      	2         	13        	15             	DEL       
chr5        	120044450   	120046985   	120044451      	120046985      	61        	22        	83             	DEL       
chr5        	120977322   	120977638   	120977338      	120977638      	1         	6         	7              	DEL       
chr5        	120994751   	120995025   	120994752      	120995025      	0         	11        	11             	DEL       
chr5        	121391740   	121391864   	121391741      	121391864      	0         	11        	11             	DEL       
chr5        	121723535   	121724315   	121723537      	121724315      	19        	4         	23             	DEL       
chr5        	122240419   	122245113   	122240436      	122245113      	31        	9         	40             	DEL       
chr5        	122938658   	122938982   	122938659      	122938968      	2         	5         	7              	DEL       
chr5        	124339408   	124339495   	124339411      	124339495      	0         	8         	8              	DEL       
chr5        	125381651   	125381974   	125381665      	125381974      	1         	6         	7              	DEL       
chr5        	126160712   	126162729   	126160712      	126162727      	13        	0         	13             	DUP       
chr5        	126160712   	126162729   	126161001      	126162993      	13        	0         	13             	DEL       
chr5        	126161002   	126162994   	126160712      	126162727      	13        	0         	13             	DUP       
chr5        	126161002   	126162994   	126161001      	126162993      	13        	0         	13             	DEL       
chr5        	127606639   	127606967   	127606654      	127606967      	2         	15        	17             	DEL       
chr5        	127836637   	127837588   	127836640      	127837588      	33        	21        	54             	DEL       
chr5        	128071746   	128075224   	128071751      	128075224      	26        	7         	33             	DEL       
chr5        	131418840   	131418914   	131418859      	131418913      	1         	6         	7              	DEL       
chr5        	131468494   	131468581   	131468503      	131468581      	0         	10        	10             	DEL       
chr5        	133798991   	133800797   	133798987      	133800797      	13        	3         	16             	DEL       
chr5        	135779484   	135785023   	135779507      	135785023      	26        	14        	40             	DEL       
chr5        	136709026   	136709303   	136709027      	136709303      	8         	0         	8              	INV       
chr5        	137518985   	137520702   	137519035      	137520694      	48        	0         	48             	DEL       
chr5        	137686872   	137688197   	137686889      	137688197      	18        	9         	27             	DEL       
chr5        	139452657   	139453659   	139452658      	139453659      	48        	0         	48             	DEL       
chr5        	139452274   	139453769   	139452275      	139453769      	0         	5         	5              	DUP       
chr5        	139452274   	139453769   	139452658      	139453659      	48        	0         	48             	DEL       
chr5        	140834661   	140848633   	140834662      	140848633      	4         	0         	4              	DUP       
chr5        	140834661   	140848633   	140842552      	140859346      	12        	5         	17             	DEL       
chr5        	140842551   	140859346   	140834662      	140848633      	4         	0         	4              	DUP       
chr5        	140842551   	140859346   	140842552      	140859346      	12        	5         	17             	DEL       
chr5        	141174602   	141179747   	141174602      	141179745      	8         	0         	8              	DUP       
chr5        	141632063   	142199690   	142079635      	142079940      	2         	8         	10             	DEL       
chr5        	141632063   	142199690   	141632095      	142199688      	4         	0         	4              	DUP       
chr5        	141632063   	142199690   	141632292      	142199959      	6         	0         	6              	DEL       
chr5        	141632293   	142199960   	142079635      	142079940      	2         	8         	10             	DEL       
chr5        	141632293   	142199960   	141632095      	142199688      	4         	0         	4              	DUP       
chr5        	141632293   	142199960   	141632292      	142199959      	6         	0         	6              	DEL       
chr5        	142079634   	142079940   	142079635      	142079940      	2         	8         	10             	DEL       
chr5        	143555800   	143556113   	143555815      	143556113      	0         	14        	14             	DEL       
chr5        	143801477   	143806582   	143801481      	143806582      	11        	7         	18             	DEL       
chr5        	143974068   	143974245   	143974085      	143974244      	0         	14        	14             	DEL       
chr5        	144133301   	144135482   	144132923      	144135488      	37        	16        	53             	DUP       
chr5        	144133301   	144135482   	144133302      	144135482      	61        	19        	80             	DEL       
chr5        	144132922   	144135486   	144132923      	144135488      	37        	16        	53             	DUP       
chr5        	144132922   	144135486   	144133302      	144135482      	61        	19        	80             	DEL       
chr5        	144679904   	144680098   	144679905      	144680098      	13        	8         	21             	INV       
chr5        	145492340   	145493242   	145492343      	145493242      	18        	3         	21             	DEL       
chr5        	147243087   	147243521   	147243089      	147243521      	10        	6         	16             	DEL       
chr5        	148705318   	148705667   	148705319      	148705667      	11        	0         	11             	INV       
chr5        	149021869   	149022028   	149021884      	149022028      	0         	14        	14             	DEL       
chr5        	149327059   	149327300   	149327063      	149327300      	1         	17        	18             	DEL       
chr5        	150062174   	150062600   	150062178      	150062600      	3         	11        	14             	DEL       
chr5        	150084359   	150084467   	150084363      	150084455      	0         	4         	4              	DEL       
chr5        	150366627   	150366954   	150366641      	150366954      	0         	4         	4              	DEL       
chr5        	150823597   	150843701   	150823598      	150843701      	24        	5         	29             	DEL       
chr5        	151410241   	151413100   	151410240      	151413099      	10        	0         	10             	DEL       
chr5        	152076851   	152082886   	152076869      	152082886      	59        	15        	74             	DEL       
chr5        	153606867   	153606960   	153606870      	153606960      	0         	23        	23             	DEL       
chr5        	154425867   	154427707   	154425866      	154427657      	16        	0         	16             	DEL       
chr5        	154936356   	154936442   	154936357      	154936442      	0         	9         	9              	DEL       
chr5        	155760323   	155761329   	155760324      	155761329      	23        	0         	23             	DEL       
chr5        	155884772   	155885564   	155884779      	155885564      	17        	10        	27             	DEL       
chr5        	159165388   	159165735   	159165400      	159165734      	0         	10        	10             	DEL       
chr5        	160315548   	160315655   	160315550      	160315655      	1         	9         	10             	DEL       
chr5        	160987108   	160987207   	160987111      	160987207      	0         	12        	12             	DEL       
chr5        	161004297   	161004629   	161004311      	161004629      	1         	20        	21             	DEL       
chr5        	161244886   	161253583   	161244886      	161253581      	7         	0         	7              	DUP       
chr5        	161244886   	161253583   	161245109      	161254053      	4         	0         	4              	DEL       
chr5        	161245110   	161254054   	161244886      	161253581      	7         	0         	7              	DUP       
chr5        	161245110   	161254054   	161245109      	161254053      	4         	0         	4              	DEL       
chr5        	164939290   	164939601   	164939306      	164939601      	1         	7         	8              	DEL       
chr5        	169315518   	169315753   	169315535      	169315753      	0         	31        	31             	DEL       
chr5        	170702791   	170704389   	170702790      	170704388      	7         	0         	7              	DEL       
chr5        	170731812   	170731902   	170731823      	170731902      	0         	21        	21             	DEL       
chr5        	172458535   	172458635   	172458546      	172458635      	1         	16        	17             	DEL       
chr5        	173462709   	173463043   	173462725      	173463043      	2         	21        	23             	DEL       
chr5        	176960577   	176963180   	176960586      	176963179      	44        	24        	68             	DEL       
chr5        	178395046   	178396807   	178394963      	178396762      	12        	0         	12             	DEL       
chr5        	179411896   	179412974   	179411897      	179412974      	5         	0         	5              	DEL       
chr5        	179627723   	179628021   	179627735      	179628021      	0         	5         	5              	DEL       
chr5        	180615426   	180615565   	180615575      	180616405      	5         	0         	5              	DEL       
chr5        	180617197   	180618420   	180617198      	180618420      	5         	0         	5              	DEL       
chr6        	380339      	380419      	380340         	380419         	0         	12        	12             	DEL       
chr6        	666375      	667821      	666376         	667821         	25        	11        	36             	DEL       
chr6        	1051552     	1051737     	1051543        	1051737        	0         	10        	10             	DUP       
chr6        	1053741     	1053909     	1053742        	1053909        	0         	6         	6              	DUP       
chr6        	1303872     	1304002     	1303889        	1304002        	0         	13        	13             	DEL       
chr6        	1682556     	1682868     	1682567        	1682868        	0         	17        	17             	DEL       
chr6        	3145536     	3146274     	3145537        	3146274        	6         	0         	6              	DEL       
chr6        	3156325     	3179602     	3156325        	3179600        	5         	0         	5              	DUP       
chr6        	3156325     	3179602     	3156541        	3180187        	12        	0         	12             	DEL       
chr6        	3156542     	3180188     	3156325        	3179600        	5         	0         	5              	DUP       
chr6        	3156542     	3180188     	3156541        	3180187        	12        	0         	12             	DEL       
chr6        	4050006     	4050326     	4050023        	4050326        	3         	16        	19             	DEL       
chr6        	5037014     	5038952     	5037015        	5038952        	29        	8         	37             	DEL       
chr6        	6068615     	6068945     	6068616        	6068945        	0         	4         	4              	DEL       
chr6        	6277106     	6277369     	6277122        	6277369        	0         	12        	12             	DEL       
chr6        	7273053     	7273644     	7273054        	7273644        	5         	0         	5              	DEL       
chr6        	7717133     	7717469     	7717151        	7717469        	3         	27        	30             	DEL       
chr6        	8227689     	8228008     	8227706        	8228008        	1         	12        	13             	DEL       
chr6        	9014582     	9014691     	9014599        	9014691        	0         	9         	9              	DEL       
chr6        	9146265     	9146624     	9146266        	9146624        	7         	0         	7              	DEL       
chr6        	10070558    	10070872    	10070572       	10070872       	3         	18        	21             	DEL       
chr6        	10293761    	10293907    	10293764       	10293907       	0         	14        	14             	DEL       
chr6        	11555857    	11556178    	11555873       	11556178       	1         	20        	21             	DEL       
chr6        	11616039    	11616171    	11616055       	11616171       	2         	18        	20             	DEL       
chr6        	11903202    	11903515    	11903219       	11903515       	3         	20        	23             	DEL       
chr6        	13882317    	13883621    	13882321       	13883621       	12        	4         	16             	DEL       
chr6        	14745053    	14745466    	14745050       	14745466       	6         	19        	25             	DEL       
chr6        	17472037    	17472351    	17472054       	17472351       	0         	8         	8              	DEL       
chr6        	19423370    	19423605    	19423383       	19423605       	0         	12        	12             	DEL       
chr6        	19676084    	19677127    	19676176       	19677127       	14        	0         	14             	DEL       
chr6        	19764880    	19770954    	19764879       	19771090       	8         	0         	8              	DEL       
chr6        	20259624    	20259678    	20259627       	20259678       	0         	8         	8              	DEL       
chr6        	20765134    	20765455    	20765147       	20765455       	0         	11        	11             	DEL       
chr6        	22227242    	22227525    	22227255       	22227525       	3         	18        	21             	DEL       
chr6        	23300133    	23300457    	23300148       	23300456       	1         	25        	26             	DEL       
chr6        	23685766    	23686096    	23685767       	23686087       	1         	9         	10             	DEL       
chr6        	23743030    	23745717    	23743031       	23745717       	20        	15        	35             	DEL       
chr6        	24811646    	24817722    	24811659       	24817722       	34        	18        	52             	DEL       
chr6        	25181045    	25181121    	25181046       	25181121       	0         	9         	9              	DEL       
chr6        	25275200    	25275323    	25275201       	25275323       	0         	4         	4              	DEL       
chr6        	26611009    	26617791    	26611087       	26617811       	16        	0         	16             	DEL       
chr6        	27216694    	27217174    	27216708       	27217173       	0         	4         	4              	DEL       
chr6        	28117395    	28117661    	28117406       	28117660       	0         	5         	5              	DEL       
chr6        	28222416    	28222754    	28222429       	28222754       	1         	9         	10             	DEL       
chr6        	28929691    	28930238    	28929692       	28930238       	7         	4         	11             	DEL       
chr6        	29717691    	29720304    	29717710       	29720303       	39        	0         	39             	DEL       
chr6        	29798589    	29954973    	29932004       	29933749       	33        	0         	33             	DEL       
chr6        	29798589    	29954973    	29875741       	29881333       	19        	0         	19             	DEL       
chr6        	29798589    	29954973    	29798127       	29955043       	11        	0         	11             	DUP       
chr6        	29798589    	29954973    	29798959       	29954881       	19        	0         	19             	DEL       
chr6        	29798127    	29954590    	29932004       	29933749       	33        	0         	33             	DEL       
chr6        	29798127    	29954590    	29875741       	29881333       	19        	0         	19             	DEL       
chr6        	29798127    	29954590    	29798127       	29955043       	11        	0         	11             	DUP       
chr6        	29798127    	29954590    	29798959       	29954881       	19        	0         	19             	DEL       
chr6        	29875652    	29881432    	29875741       	29881333       	19        	0         	19             	DEL       
chr6        	29931990    	29933749    	29932004       	29933749       	33        	0         	33             	DEL       
chr6        	31026228    	31027303    	31026260       	31027292       	17        	0         	17             	DEL       
chr6        	31132406    	31132460    	31132409       	31132465       	0         	4         	4              	DEL       
chr6        	31225532    	31226644    	31225566       	31226613       	21        	0         	21             	DEL       
chr6        	31243838    	31245339    	31243852       	31245338       	61        	0         	61             	DEL       
chr6        	31268696    	31353838    	31324242       	31326272       	9         	0         	9              	DEL       
chr6        	31268696    	31353838    	31311215       	31320934       	5         	0         	5              	DEL       
chr6        	31268696    	31353838    	31328437       	31337127       	12        	0         	12             	DEL       
chr6        	31268696    	31353838    	31268695       	31353837       	7         	0         	7              	DEL       
chr6        	31311216    	31320935    	31311215       	31320934       	5         	0         	5              	DEL       
chr6        	31324278    	31326225    	31324242       	31326272       	9         	0         	9              	DEL       
chr6        	31388451    	31485227    	31453726       	31456609       	33        	0         	33             	DEL       
chr6        	31388451    	31485227    	31388405       	31485344       	25        	0         	25             	DEL       
chr6        	31388451    	31485227    	31388621       	31485712       	17        	0         	17             	DUP       
chr6        	31388552    	31485826    	31453726       	31456609       	33        	0         	33             	DEL       
chr6        	31388552    	31485826    	31388405       	31485344       	25        	0         	25             	DEL       
chr6        	31388552    	31485826    	31388621       	31485712       	17        	0         	17             	DUP       
chr6        	31453719    	31456609    	31453726       	31456609       	33        	0         	33             	DEL       
chr6        	32410068    	32410876    	32410068       	32410876       	47        	0         	47             	DEL       
chr6        	32485247    	32571353    	32486038       	32572025       	4         	0         	4              	DEL       
chr6        	32485247    	32571353    	32546967       	32548539       	5         	0         	5              	DEL       
chr6        	32546966    	32548539    	32546967       	32548539       	5         	0         	5              	DEL       
chr6        	32594133    	32596839    	32594187       	32596831       	32        	0         	32             	DEL       
chr6        	32626820    	32628835    	32626688       	32628695       	5         	0         	5              	DEL       
chr6        	32626820    	32628835    	32626968       	32628830       	4         	0         	4              	DUP       
chr6        	32637560    	32741590    	32657113       	32658152       	7         	0         	7              	DEL       
chr6        	32637560    	32741590    	32708770       	32709253       	7         	0         	7              	DEL       
chr6        	32637560    	32741590    	32637756       	32741571       	5         	0         	5              	DUP       
chr6        	32657220    	32658057    	32657113       	32658152       	7         	0         	7              	DEL       
chr6        	32708795    	32709253    	32708770       	32709253       	7         	0         	7              	DEL       
chr6        	32810976    	32812043    	32810930       	32812043       	19        	0         	19             	DEL       
chr6        	33615419    	33618067    	33615421       	33618067       	25        	25        	50             	DEL       
chr6        	34071568    	34072200    	34071861       	34072134       	5         	0         	5              	DEL       
chr6        	34071568    	34072200    	34071568       	34072194       	29        	0         	29             	DUP       
chr6        	34732144    	34733341    	34732144       	34733341       	16        	0         	16             	DEL       
chr6        	35658654    	35661967    	35658657       	35661967       	21        	13        	34             	DEL       
chr6        	35786782    	35799008    	35786783       	35799011       	17        	7         	24             	DUP       
chr6        	36102341    	36102416    	36102343       	36102416       	0         	9         	9              	DEL       
chr6        	38954410    	38954727    	38954423       	38954726       	1         	26        	27             	DEL       
chr6        	41436321    	41436645    	41436338       	41436645       	0         	5         	5              	DEL       
chr6        	43418233    	43418352    	43418234       	43418336       	0         	9         	9              	DEL       
chr6        	44044483    	44045277    	44044808       	44045014       	11        	8         	19             	DUP       
chr6        	45914770    	45915135    	45914771       	45915135       	0         	5         	5              	DEL       
chr6        	45999720    	46000048    	45999738       	46000048       	2         	5         	7              	DEL       
chr6        	47312404    	47312498    	47312419       	47312498       	0         	17        	17             	DEL       
chr6        	50484752    	50485082    	50484765       	50485082       	2         	17        	19             	DEL       
chr6        	50798242    	50798554    	50798258       	50798554       	1         	5         	6              	DEL       
chr6        	51334673    	51335324    	51334678       	51335324       	6         	6         	12             	DEL       
chr6        	51391487    	51391804    	51391502       	51391804       	1         	19        	20             	DEL       
chr6        	51652550    	51652877    	51652566       	51652877       	2         	19        	21             	DEL       
chr6        	51871310    	51872006    	51871313       	51872006       	35        	22        	57             	DEL       
chr6        	52785953    	52826587    	52786106       	52826609       	7         	0         	7              	DUP       
chr6        	53173079    	53173151    	53173080       	53173151       	0         	12        	12             	DEL       
chr6        	54059858    	54063911    	54059859       	54063911       	8         	18        	26             	DUP       
chr6        	54059858    	54063911    	54060007       	54070030       	7         	15        	22             	DEL       
chr6        	54059858    	54063911    	54063910       	54070030       	27        	0         	27             	DEL       
chr6        	54060004    	54070030    	54059859       	54063911       	8         	18        	26             	DUP       
chr6        	54060004    	54070030    	54060007       	54070030       	7         	15        	22             	DEL       
chr6        	54060004    	54070030    	54063910       	54070030       	27        	0         	27             	DEL       
chr6        	54063879    	54070178    	54059859       	54063911       	8         	18        	26             	DUP       
chr6        	54063879    	54070178    	54060007       	54070030       	7         	15        	22             	DEL       
chr6        	54063879    	54070178    	54063910       	54070030       	27        	0         	27             	DEL       
chr6        	54691636    	54691972    	54691651       	54691972       	4         	24        	28             	DEL       
chr6        	54915507    	54915836    	54915524       	54915836       	1         	17        	18             	DEL       
chr6        	54981582    	54986640    	54981590       	54986640       	22        	7         	29             	DEL       
chr6        	54999564    	54999892    	54999580       	54999892       	2         	28        	30             	DEL       
chr6        	55476939    	55477535    	55476941       	55477535       	13        	14        	27             	DEL       
chr6        	55597022    	55597116    	55597027       	55597116       	0         	11        	11             	DEL       
chr6        	56325277    	56325674    	56325278       	56325665       	0         	6         	6              	DEL       
chr6        	57033688    	57033749    	57033689       	57033749       	0         	16        	16             	DEL       
chr6        	57489508    	60382475    	57489560       	60382473       	4         	0         	4              	DUP       
chr6        	57489508    	60382475    	57489750       	60382632       	5         	0         	5              	DEL       
chr6        	57489508    	60382475    	58202220       	60956616       	7         	0         	7              	DEL       
chr6        	57489508    	60382475    	58432455       	61307785       	43        	0         	43             	DUP       
chr6        	57489508    	60382475    	58433265       	61307771       	34        	0         	34             	DEL       
chr6        	57489751    	60382633    	57489560       	60382473       	4         	0         	4              	DUP       
chr6        	57489751    	60382633    	57489750       	60382632       	5         	0         	5              	DEL       
chr6        	57489751    	60382633    	58202220       	60956616       	7         	0         	7              	DEL       
chr6        	57489751    	60382633    	58432455       	61307785       	43        	0         	43             	DUP       
chr6        	57489751    	60382633    	58433265       	61307771       	34        	0         	34             	DEL       
chr6        	58202221    	60956617    	60420036       	60424419       	9         	0         	9              	DEL       
chr6        	58202221    	60956617    	57489560       	60382473       	4         	0         	4              	DUP       
chr6        	58202221    	60956617    	57489750       	60382632       	5         	0         	5              	DEL       
chr6        	58202221    	60956617    	60650936       	60651132       	0         	5         	5              	DEL       
chr6        	58202221    	60956617    	60655411       	60660200       	17        	0         	17             	DEL       
chr6        	58202221    	60956617    	58202220       	60956616       	7         	0         	7              	DEL       
chr6        	58202221    	60956617    	58432455       	61307785       	43        	0         	43             	DUP       
chr6        	58202221    	60956617    	58433265       	61307771       	34        	0         	34             	DEL       
chr6        	58433238    	61307790    	60420036       	60424419       	9         	0         	9              	DEL       
chr6        	58433238    	61307790    	57489560       	60382473       	4         	0         	4              	DUP       
chr6        	58433238    	61307790    	57489750       	60382632       	5         	0         	5              	DEL       
chr6        	58433238    	61307790    	60650936       	60651132       	0         	5         	5              	DEL       
chr6        	58433238    	61307790    	60655411       	60660200       	17        	0         	17             	DEL       
chr6        	58433238    	61307790    	58202220       	60956616       	7         	0         	7              	DEL       
chr6        	58433238    	61307790    	61183415       	61183719       	0         	6         	6              	DEL       
chr6        	58433238    	61307790    	58432455       	61307785       	43        	0         	43             	DUP       
chr6        	58433238    	61307790    	58433265       	61307771       	34        	0         	34             	DEL       
chr6        	58432543    	61307655    	60420036       	60424419       	9         	0         	9              	DEL       
chr6        	58432543    	61307655    	57489560       	60382473       	4         	0         	4              	DUP       
chr6        	58432543    	61307655    	57489750       	60382632       	5         	0         	5              	DEL       
chr6        	58432543    	61307655    	60650936       	60651132       	0         	5         	5              	DEL       
chr6        	58432543    	61307655    	60655411       	60660200       	17        	0         	17             	DEL       
chr6        	58432543    	61307655    	58202220       	60956616       	7         	0         	7              	DEL       
chr6        	58432543    	61307655    	61183415       	61183719       	0         	6         	6              	DEL       
chr6        	58432543    	61307655    	58432455       	61307785       	43        	0         	43             	DUP       
chr6        	58432543    	61307655    	58433265       	61307771       	34        	0         	34             	DEL       
chr6        	60420110    	60424419    	60420036       	60424419       	9         	0         	9              	DEL       
chr6        	60650932    	60651132    	60650936       	60651132       	0         	5         	5              	DEL       
chr6        	60655330    	60660244    	60655411       	60660200       	17        	0         	17             	DEL       
chr6        	61183397    	61183719    	61183415       	61183719       	0         	6         	6              	DEL       
chr6        	61369113    	61373011    	61369114       	61373074       	18        	0         	18             	DUP       
chr6        	61377985    	61379002    	61378038       	61378888       	18        	0         	18             	DEL       
chr6        	61568976    	61569053    	61568979       	61569053       	0         	8         	8              	DEL       
chr6        	62887728    	62889080    	62887729       	62889080       	16        	8         	24             	DEL       
chr6        	63957113    	63958453    	63957118       	63958453       	22        	12        	34             	DEL       
chr6        	64296527    	64296622    	64296531       	64296622       	0         	5         	5              	DEL       
chr6        	64475258    	64475573    	64475269       	64475573       	1         	12        	13             	DEL       
chr6        	65550133    	65552128    	65550146       	65552128       	36        	20        	56             	DEL       
chr6        	66782690    	66782832    	66782591       	66782832       	4         	7         	11             	INV       
chr6        	66843965    	71274559    	68015017       	68015258       	1         	13        	14             	DEL       
chr6        	66843965    	71274559    	69480785       	69482482       	9         	0         	9              	DEL       
chr6        	66843965    	71274559    	66843966       	71274559       	4         	0         	4              	DUP       
chr6        	68015006    	68015258    	68015017       	68015258       	1         	13        	14             	DEL       
chr6        	69480792    	69482368    	69480785       	69482482       	9         	0         	9              	DEL       
chr6        	71861724    	71862046    	71861739       	71862046       	1         	15        	16             	DEL       
chr6        	72512236    	72513076    	72512237       	72513076       	10        	0         	10             	DEL       
chr6        	73711529    	73711836    	73711539       	73711836       	0         	13        	13             	DEL       
chr6        	73882343    	73892723    	73882346       	73892723       	25        	5         	30             	DEL       
chr6        	74155716    	74156868    	74155732       	74156868       	57        	19        	76             	DEL       
chr6        	74158699    	74159832    	74158703       	74159832       	25        	11        	36             	DEL       
chr6        	74223005    	74223357    	74223006       	74223357       	0         	22        	22             	DEL       
chr6        	75248066    	75248386    	75248083       	75248386       	1         	19        	20             	DEL       
chr6        	76036786    	76036866    	76036788       	76036866       	1         	21        	22             	DEL       
chr6        	76387774    	76392924    	76387779       	76392924       	36        	15        	51             	DEL       
chr6        	76727539    	76749351    	76727538       	76749350       	8         	0         	8              	DEL       
chr6        	77210381    	77210693    	77210403       	77210693       	1         	13        	14             	DEL       
chr6        	79361553    	79363529    	79361959       	79363967       	18        	0         	18             	DUP       
chr6        	79361553    	79363529    	79361544       	79363626       	11        	0         	11             	DEL       
chr6        	79361969    	79364090    	79361959       	79363967       	18        	0         	18             	DUP       
chr6        	79361969    	79364090    	79361544       	79363626       	11        	0         	11             	DEL       
chr6        	82966354    	82966668    	82966367       	82966668       	2         	8         	10             	DEL       
chr6        	84608424    	84614502    	84608440       	84614502       	47        	25        	72             	DEL       
chr6        	85062031    	85062089    	85062033       	85062089       	0         	8         	8              	DEL       
chr6        	85316633    	85316949    	85316647       	85316949       	0         	19        	19             	DEL       
chr6        	85434579    	85434914    	85434593       	85434914       	1         	14        	15             	DEL       
chr6        	85999020    	86005073    	85999036       	86005085       	26        	0         	26             	DEL       
chr6        	86696472    	86708123    	86696480       	86708123       	28        	8         	36             	DEL       
chr6        	87408454    	87408588    	87408477       	87408588       	0         	5         	5              	DEL       
chr6        	87575991    	87576519    	87575992       	87576519       	6         	0         	6              	DEL       
chr6        	87941589    	87941662    	87941592       	87941662       	0         	12        	12             	DEL       
chr6        	88714432    	88714741    	88714447       	88714741       	0         	13        	13             	DEL       
chr6        	89212033    	89212457    	89212034       	89212457       	2         	18        	20             	DEL       
chr6        	89213907    	89214230    	89213912       	89214230       	44        	20        	64             	INV       
chr6        	90251481    	90251587    	90251482       	90251587       	0         	18        	18             	DEL       
chr6        	90527855    	90528177    	90527871       	90528177       	2         	18        	20             	DEL       
chr6        	92098275    	92098602    	92098292       	92098602       	2         	3         	5              	DEL       
chr6        	92200933    	92201257    	92200949       	92201257       	0         	11        	11             	DEL       
chr6        	93125230    	93125295    	93125231       	93125295       	0         	8         	8              	DEL       
chr6        	93687786    	93687848    	93687790       	93687848       	0         	13        	13             	DEL       
chr6        	93947644    	93947812    	93947648       	93947812       	0         	22        	22             	DEL       
chr6        	94483603    	94484618    	94483606       	94484618       	68        	26        	94             	DEL       
chr6        	94625903    	94626209    	94625912       	94626203       	4         	32        	36             	DEL       
chr6        	94691108    	94691204    	94691110       	94691204       	0         	18        	18             	DEL       
chr6        	95018959    	95020767    	95018919       	95020692       	19        	0         	19             	DUP       
chr6        	99586624    	99587445    	99586625       	99587445       	17        	6         	23             	DEL       
chr6        	99812252    	99812403    	99812253       	99812403       	1         	17        	18             	DEL       
chr6        	101046746   	101048826   	101046802      	101048747      	23        	0         	23             	DEL       
chr6        	102367246   	102367938   	102367247      	102367938      	15        	7         	22             	DEL       
chr6        	103289588   	103315014   	103289589      	103315014      	22        	8         	30             	DEL       
chr6        	103679673   	103679804   	103679698      	103679784      	0         	7         	7              	DEL       
chr6        	103735308   	103735634   	103735321      	103735634      	2         	13        	15             	DEL       
chr6        	103740453   	103740518   	103740457      	103740518      	0         	8         	8              	DEL       
chr6        	104812950   	104815882   	104812953      	104815882      	17        	4         	21             	DEL       
chr6        	105119961   	105120297   	105119978      	105120297      	3         	20        	23             	DEL       
chr6        	105909606   	105909665   	105909607      	105909665      	0         	8         	8              	DEL       
chr6        	106480956   	106481273   	106480970      	106481273      	0         	8         	8              	DEL       
chr6        	106535746   	106536066   	106535761      	106536066      	2         	13        	15             	DEL       
chr6        	106859930   	106860119   	106859950      	106860119      	0         	15        	15             	DEL       
chr6        	106986183   	106987326   	106986212      	106987344      	18        	0         	18             	DEL       
chr6        	107710137   	107711198   	107710138      	107711198      	26        	23        	49             	DEL       
chr6        	107944907   	107945211   	107944917      	107945211      	1         	25        	26             	DEL       
chr6        	110974006   	110974314   	110974023      	110974314      	1         	5         	6              	DEL       
chr6        	112148904   	112149114   	112148918      	112149113      	0         	17        	17             	DEL       
chr6        	113379802   	113379880   	113379803      	113379880      	5         	2         	7              	INV       
chr6        	116429649   	116429969   	116429667      	116429969      	2         	15        	17             	DEL       
chr6        	117459391   	117459494   	117459392      	117459494      	0         	11        	11             	DEL       
chr6        	118070870   	118071120   	118070871      	118071120      	5         	0         	5              	INV       
chr6        	118940824   	118941153   	118940825      	118941155      	2         	9         	11             	DUP       
chr6        	119096337   	119096666   	119096354      	119096666      	0         	20        	20             	DEL       
chr6        	120504094   	120504275   	120504095      	120504276      	0         	7         	7              	DUP       
chr6        	120857952   	120858097   	120857961      	120858097      	1         	8         	9              	DEL       
chr6        	120998145   	120998470   	120998160      	120998470      	0         	21        	21             	DEL       
chr6        	121476199   	121476955   	121476200      	121476955      	6         	0         	6              	DEL       
chr6        	121980496   	121980816   	121980513      	121980816      	1         	12        	13             	DEL       
chr6        	123193912   	123194228   	123193925      	123194228      	0         	14        	14             	DEL       
chr6        	124177760   	124178084   	124177777      	124178084      	2         	11        	13             	DEL       
chr6        	124515709   	124515835   	124515710      	124515835      	0         	12        	12             	DEL       
chr6        	125861763   	125866163   	125861939      	125866136      	18        	0         	18             	DEL       
chr6        	126146860   	126147098   	126146862      	126147098      	1         	17        	18             	DEL       
chr6        	128655201   	128655419   	128655202      	128655419      	0         	19        	19             	DEL       
chr6        	128668670   	128669005   	128668686      	128669005      	3         	12        	15             	DEL       
chr6        	128998369   	129004429   	128998385      	129004429      	39        	21        	60             	DEL       
chr6        	129415924   	129416239   	129415944      	129416239      	0         	14        	14             	DEL       
chr6        	130527041   	130531151   	130527040      	130531149      	53        	8         	61             	INV       
chr6        	130638248   	130638569   	130638263      	130638569      	1         	8         	9              	DEL       
chr6        	131563617   	131563946   	131563618      	131563946      	17        	0         	17             	INV       
chr6        	131760849   	131761080   	131760850      	131761080      	0         	7         	7              	DEL       
chr6        	133020694   	133026764   	133020695      	133026746      	56        	32        	88             	DEL       
chr6        	133947837   	133948586   	133947842      	133948586      	25        	12        	37             	DEL       
chr6        	134032404   	134032471   	134032421      	134032471      	0         	7         	7              	DEL       
chr6        	134496206   	134496524   	134496223      	134496524      	4         	21        	25             	DEL       
chr6        	135914476   	135914787   	135914489      	135914787      	0         	7         	7              	DEL       
chr6        	136559357   	136559413   	136559362      	136559413      	0         	7         	7              	DEL       
chr6        	136992555   	136993049   	136992557      	136993049      	8         	22        	30             	DEL       
chr6        	137952216   	137952370   	137952217      	137952370      	0         	4         	4              	DEL       
chr6        	140536868   	140536954   	140536869      	140536954      	0         	9         	9              	DEL       
chr6        	140631752   	140632041   	140631766      	140632041      	2         	23        	25             	DEL       
chr6        	140734083   	140734583   	140734087      	140734583      	9         	7         	16             	DEL       
chr6        	141004569   	141004896   	141004584      	141004896      	4         	14        	18             	DEL       
chr6        	142743559   	142743653   	142743570      	142743653      	0         	5         	5              	DEL       
chr6        	142840296   	142840383   	142840297      	142840383      	0         	23        	23             	DEL       
chr6        	144806554   	144806885   	144806555      	144806885      	0         	8         	8              	DEL       
chr6        	148185177   	148185312   	148185188      	148185288      	0         	9         	9              	DEL       
chr6        	149311641   	149311808   	149311646      	149311808      	0         	16        	16             	DEL       
chr6        	149762614   	149763234   	149762542      	149763244      	12        	0         	12             	DEL       
chr6        	149981521   	149981668   	149981529      	149981668      	0         	6         	6              	DEL       
chr6        	151164728   	151165802   	151164780      	151165776      	29        	0         	29             	DEL       
chr6        	152708835   	152712654   	152708855      	152712654      	30        	9         	39             	DEL       
chr6        	153087112   	153087172   	153087116      	153087172      	1         	6         	7              	DEL       
chr6        	154125779   	154126102   	154125795      	154126102      	2         	22        	24             	DEL       
chr6        	154142103   	154142195   	154142112      	154142195      	0         	7         	7              	DEL       
chr6        	154298854   	154300370   	154298872      	154300370      	18        	5         	23             	DEL       
chr6        	154496314   	154496513   	154496315      	154496513      	0         	5         	5              	DEL       
chr6        	155066166   	155066241   	155066167      	155066241      	0         	8         	8              	DEL       
chr6        	158088004   	158088066   	158088009      	158088065      	0         	15        	15             	DEL       
chr6        	158127233   	158128034   	158127250      	158128034      	24        	17        	41             	DEL       
chr6        	158455043   	158455372   	158455059      	158455372      	0         	10        	10             	DEL       
chr6        	158927694   	158928998   	158927733      	158928961      	22        	0         	22             	DEL       
chr6        	159231076   	159231390   	159231093      	159231390      	3         	20        	23             	DEL       
chr6        	159245728   	159246052   	159245746      	159246052      	1         	14        	15             	DEL       
chr6        	159665224   	159667657   	159665252      	159667646      	10        	0         	10             	DEL       
chr6        	160456703   	160535880   	160456624      	160535480      	4         	0         	4              	DEL       
chr6        	160456703   	160535880   	160456770      	160535585      	14        	0         	14             	DUP       
chr6        	161263103   	161263206   	161263105      	161263206      	0         	15        	15             	DEL       
chr6        	162011321   	162011506   	162011331      	162011494      	0         	5         	5              	DEL       
chr6        	162162786   	162165967   	162162815      	162165778      	19        	0         	19             	DEL       
chr6        	163829774   	163829883   	163829776      	163829883      	0         	18        	18             	DEL       
chr6        	164354504   	164354811   	164354513      	164354811      	0         	7         	7              	DEL       
chr6        	165311176   	165318643   	165311180      	165318643      	19        	9         	28             	DEL       
chr6        	167004612   	167004682   	167004622      	167004682      	0         	13        	13             	DEL       
chr6        	167074581   	167076088   	167074582      	167076088      	12        	3         	15             	DEL       
chr6        	167591370   	167641392   	167591371      	167641392      	4         	0         	4              	DEL       
chr6        	168270043   	168270260   	168270044      	168270260      	1         	5         	6              	DUP       
chr6        	168316456   	168317990   	168316593      	168317933      	22        	0         	22             	DEL       
chr6        	168679093   	168679448   	168679095      	168679448      	2         	5         	7              	DEL       
chr6        	168931796   	168932607   	168931818      	168932605      	4         	0         	4              	DUP       
chr6        	169505461   	169505555   	169505462      	169505555      	0         	6         	6              	DEL       
chr6        	170266815   	170267626   	170266816      	170267626      	7         	0         	7              	DEL       
chr6        	170398378   	170400316   	170398523      	170400314      	14        	0         	14             	DUP       
chr6        	170458660   	170459572   	170458661      	170459572      	6         	0         	6              	DEL       
chr7        	220976      	222067      	220977         	222067         	5         	0         	5              	DEL       
chr7        	224405      	225909      	224406         	225909         	5         	0         	5              	DEL       
chr7        	419382      	420109      	419383         	420109         	4         	0         	4              	DEL       
chr7        	467301      	468313      	467289         	467708         	3         	1         	4              	DUP       
chr7        	839514      	839818      	839531         	839818         	1         	7         	8              	DEL       
chr7        	864692      	864749      	864698         	864749         	0         	11        	11             	DEL       
chr7        	1036676     	1040196     	1036688        	1040196        	12        	8         	20             	DEL       
chr7        	1115402     	1116121     	1115403        	1116121        	6         	0         	6              	DEL       
chr7        	1127661     	1129455     	1127716        	1129435        	16        	0         	16             	DEL       
chr7        	1145441     	1148054     	1145442        	1148018        	15        	3         	18             	DEL       
chr7        	1273160     	1274138     	1273161        	1274138        	5         	0         	5              	DEL       
chr7        	1280537     	1281135     	1280538        	1281135        	5         	0         	5              	DEL       
chr7        	1295289     	1295563     	1295305        	1295557        	0         	7         	7              	DEL       
chr7        	1517710     	1523954     	1517711        	1523954        	24        	10        	34             	DEL       
chr7        	2201191     	2201257     	2201194        	2201257        	0         	5         	5              	DEL       
chr7        	2561057     	2561166     	2561061        	2561166        	0         	7         	7              	DEL       
chr7        	3963107     	3963864     	3963108        	3963864        	6         	0         	6              	DEL       
chr7        	4041631     	4042664     	4041633        	4042664        	23        	6         	29             	DEL       
chr7        	5167734     	5169588     	5167703        	5169614        	17        	0         	17             	DUP       
chr7        	7502677     	7502978     	7502696        	7502978        	0         	18        	18             	DEL       
chr7        	8658997     	8659216     	8659000        	8659216        	0         	20        	20             	DEL       
chr7        	9595003     	9596347     	9595020        	9596347        	22        	11        	33             	DEL       
chr7        	10464689    	10466505    	10464689       	10466506       	15        	4         	19             	DEL       
chr7        	12242076    	12242399    	12242085       	12242399       	1         	5         	6              	DEL       
chr7        	13575833    	13575905    	13575833       	13575904       	0         	5         	5              	DEL       
chr7        	13623563    	13623830    	13623568       	13623830       	1         	21        	22             	DEL       
chr7        	14188362    	14188681    	14188378       	14188681       	0         	11        	11             	DEL       
chr7        	14211585    	14212338    	14211586       	14212338       	14        	0         	14             	DEL       
chr7        	14409414    	14409736    	14409425       	14409736       	0         	7         	7              	DEL       
chr7        	14411638    	14411805    	14411642       	14411805       	0         	6         	6              	DEL       
chr7        	14870793    	14871112    	14870809       	14871112       	0         	14        	14             	DEL       
chr7        	15190072    	15190232    	15190092       	15190231       	1         	13        	14             	DEL       
chr7        	15845823    	15846241    	15845828       	15846241       	5         	11        	16             	DEL       
chr7        	16132147    	16134447    	16132148       	16134447       	25        	10        	35             	DEL       
chr7        	16896662    	16897002    	16896677       	16897002       	5         	16        	21             	DEL       
chr7        	21548087    	21548209    	21548092       	21548209       	1         	6         	7              	DEL       
chr7        	22395180    	22397141    	22395184       	22397141       	25        	12        	37             	DEL       
chr7        	23056346    	23056399    	23056349       	23056399       	0         	6         	6              	DEL       
chr7        	23998541    	24000451    	23998546       	24000451       	56        	30        	86             	DEL       
chr7        	24028694    	24028901    	24028695       	24028902       	0         	6         	6              	DUP       
chr7        	24638305    	24638629    	24638323       	24638629       	2         	12        	14             	DEL       
chr7        	25004981    	25005311    	25004994       	25005311       	2         	34        	36             	DEL       
chr7        	25017824    	25020234    	25017842       	25020234       	30        	14        	44             	DEL       
chr7        	26097447    	26105933    	26097406       	26105875       	21        	0         	21             	DEL       
chr7        	27474715    	27474991    	27474730       	27474991       	0         	19        	19             	DEL       
chr7        	27743470    	27744113    	27743471       	27744113       	4         	0         	4              	DEL       
chr7        	28174680    	28175045    	28174685       	28175045       	3         	11        	14             	DEL       
chr7        	29437300    	29437611    	29437316       	29437611       	0         	5         	5              	DEL       
chr7        	29633077    	29745831    	29631963       	29744897       	4         	0         	4              	DEL       
chr7        	29633077    	29745831    	29633076       	29745830       	9         	0         	9              	DEL       
chr7        	31484150    	31485639    	31484165       	31485639       	15        	2         	17             	DEL       
chr7        	31550692    	31552382    	31551421       	31552381       	7         	0         	7              	DEL       
chr7        	32350538    	32353500    	32350553       	32353500       	46        	22        	68             	DEL       
chr7        	32510312    	32511242    	32510313       	32511242       	5         	0         	5              	DEL       
chr7        	33363918    	33364247    	33363934       	33364247       	0         	6         	6              	DEL       
chr7        	33668660    	33668795    	33668682       	33668795       	0         	6         	6              	DEL       
chr7        	33859228    	33859560    	33859244       	33859560       	1         	13        	14             	DEL       
chr7        	36313062    	36313148    	36313063       	36313148       	1         	10        	11             	DEL       
chr7        	36401553    	36402305    	36401554       	36402305       	14        	0         	14             	DEL       
chr7        	36486826    	36486999    	36486850       	36486999       	0         	18        	18             	DEL       
chr7        	36839273    	36839363    	36839275       	36839363       	0         	7         	7              	DEL       
chr7        	37437673    	37438001    	37437687       	37438001       	2         	15        	17             	DEL       
chr7        	37958904    	37959220    	37958914       	37959220       	1         	28        	29             	DEL       
chr7        	38243273    	38246115    	38243273       	38246069       	5         	0         	5              	DUP       
chr7        	38254192    	38270271    	38254192       	38270269       	5         	0         	5              	DUP       
chr7        	39164369    	39164506    	39164370       	39164506       	2         	2         	4              	DEL       
chr7        	39340742    	39340808    	39340744       	39340808       	0         	8         	8              	DEL       
chr7        	40839775    	40840872    	40839776       	40840871       	63        	12        	75             	INV       
chr7        	42510100    	42510423    	42510115       	42510423       	1         	14        	15             	DEL       
chr7        	42565022    	42565365    	42565038       	42565365       	2         	14        	16             	DEL       
chr7        	44560572    	44560721    	44560579       	44560721       	0         	9         	9              	DEL       
chr7        	46074084    	46075926    	46074087       	46075926       	19        	9         	28             	DEL       
chr7        	47179479    	47179576    	47179484       	47179576       	0         	4         	4              	DEL       
chr7        	47855582    	47855911    	47855593       	47855899       	1         	9         	10             	DEL       
chr7        	49512468    	49512787    	49512479       	49512787       	1         	6         	7              	DEL       
chr7        	49549696    	49549887    	49549697       	49549887       	4         	0         	4              	INV       
chr7        	49680241    	49686301    	49680251       	49686301       	12        	0         	12             	DEL       
chr7        	51624198    	51624522    	51624213       	51624522       	1         	9         	10             	DEL       
chr7        	52027265    	52027579    	52027278       	52027579       	0         	36        	36             	DEL       
chr7        	52039410    	52039728    	52039424       	52039728       	1         	10        	11             	DEL       
chr7        	52452474    	52452677    	52452477       	52452677       	0         	8         	8              	DEL       
chr7        	53141799    	53141889    	53141800       	53141889       	12        	3         	15             	INV       
chr7        	53244059    	53244119    	53244063       	53244119       	0         	8         	8              	DEL       
chr7        	54772148    	54772229    	54772149       	54772229       	0         	8         	8              	DEL       
chr7        	55219049    	55221368    	55219065       	55221368       	23        	10        	33             	DEL       
chr7        	56237785    	56238156    	56237795       	56238156       	1         	7         	8              	DEL       
chr7        	56584785    	56590822    	56584797       	56590822       	18        	6         	24             	DEL       
chr7        	56823767    	56827347    	56823766       	56827346       	10        	0         	10             	DEL       
chr7        	57297185    	57297510    	57297199       	57297510       	2         	3         	5              	DEL       
chr7        	57509115    	57509455    	57509132       	57509455       	0         	7         	7              	DEL       
chr7        	57898008    	57899701    	57898024       	57899652       	61        	0         	61             	DEL       
chr7        	57995734    	58007333    	57995766       	58007333       	28        	0         	28             	DEL       
chr7        	58175421    	58189404    	58175616       	61964082       	4         	0         	4              	DUP       
chr7        	58175421    	58189404    	58188901       	61964134       	29        	0         	29             	DUP       
chr7        	58175421    	58189404    	58175621       	58189286       	6         	0         	6              	DUP       
chr7        	58175421    	58189404    	58184990       	60573026       	14        	0         	14             	DEL       
chr7        	58175421    	58189404    	58189259       	61967065       	21        	0         	21             	DEL       
chr7        	58175421    	58189404    	58175823       	61967065       	7         	0         	7              	DEL       
chr7        	58175615    	61964082    	59168950       	60735206       	10        	0         	10             	DEL       
chr7        	58175615    	61964082    	60996059       	60996920       	11        	0         	11             	DUP       
chr7        	58175615    	61964082    	58175616       	61964082       	4         	0         	4              	DUP       
chr7        	58175615    	61964082    	58188901       	61964134       	29        	0         	29             	DUP       
chr7        	58175615    	61964082    	58175621       	58189286       	6         	0         	6              	DUP       
chr7        	58175615    	61964082    	59086431       	59496054       	4         	0         	4              	DUP       
chr7        	58175615    	61964082    	59245618       	60296386       	5         	0         	5              	DEL       
chr7        	58175615    	61964082    	59510894       	60362664       	4         	0         	4              	DUP       
chr7        	58175615    	61964082    	59307384       	60480826       	5         	0         	5              	DEL       
chr7        	58175615    	61964082    	60039068       	60535236       	4         	0         	4              	DEL       
chr7        	58175615    	61964082    	60527470       	60535449       	12        	0         	12             	DEL       
chr7        	58175615    	61964082    	60121428       	60536024       	8         	0         	8              	DUP       
chr7        	58175615    	61964082    	58184990       	60573026       	14        	0         	14             	DEL       
chr7        	58175615    	61964082    	60421698       	60573807       	17        	0         	17             	DUP       
chr7        	58175615    	61964082    	61444214       	61515525       	6         	0         	6              	DEL       
chr7        	58175615    	61964082    	60535551       	61967290       	4         	0         	4              	DUP       
chr7        	58175615    	61964082    	61964141       	61967104       	7         	0         	7              	DEL       
chr7        	58175615    	61964082    	58189259       	61967065       	21        	0         	21             	DEL       
chr7        	58175615    	61964082    	58175823       	61967065       	7         	0         	7              	DEL       
chr7        	58175615    	61964082    	61822332       	62250159       	27        	0         	27             	DUP       
chr7        	58175822    	61967065    	59168950       	60735206       	10        	0         	10             	DEL       
chr7        	58175822    	61967065    	60996059       	60996920       	11        	0         	11             	DUP       
chr7        	58175822    	61967065    	58175616       	61964082       	4         	0         	4              	DUP       
chr7        	58175822    	61967065    	58188901       	61964134       	29        	0         	29             	DUP       
chr7        	58175822    	61967065    	58175621       	58189286       	6         	0         	6              	DUP       
chr7        	58175822    	61967065    	59086431       	59496054       	4         	0         	4              	DUP       
chr7        	58175822    	61967065    	59245618       	60296386       	5         	0         	5              	DEL       
chr7        	58175822    	61967065    	59510894       	60362664       	4         	0         	4              	DUP       
chr7        	58175822    	61967065    	59307384       	60480826       	5         	0         	5              	DEL       
chr7        	58175822    	61967065    	60039068       	60535236       	4         	0         	4              	DEL       
chr7        	58175822    	61967065    	60527470       	60535449       	12        	0         	12             	DEL       
chr7        	58175822    	61967065    	60121428       	60536024       	8         	0         	8              	DUP       
chr7        	58175822    	61967065    	58184990       	60573026       	14        	0         	14             	DEL       
chr7        	58175822    	61967065    	60421698       	60573807       	17        	0         	17             	DUP       
chr7        	58175822    	61967065    	61444214       	61515525       	6         	0         	6              	DEL       
chr7        	58175822    	61967065    	60535551       	61967290       	4         	0         	4              	DUP       
chr7        	58175822    	61967065    	61964141       	61967104       	7         	0         	7              	DEL       
chr7        	58175822    	61967065    	58189259       	61967065       	21        	0         	21             	DEL       
chr7        	58175822    	61967065    	58175823       	61967065       	7         	0         	7              	DEL       
chr7        	58175822    	61967065    	61822332       	62250159       	27        	0         	27             	DUP       
chr7        	58184989    	60573026    	59168950       	60735206       	10        	0         	10             	DEL       
chr7        	58184989    	60573026    	58188901       	61964134       	29        	0         	29             	DUP       
chr7        	58184989    	60573026    	58175621       	58189286       	6         	0         	6              	DUP       
chr7        	58184989    	60573026    	59086431       	59496054       	4         	0         	4              	DUP       
chr7        	58184989    	60573026    	59245618       	60296386       	5         	0         	5              	DEL       
chr7        	58184989    	60573026    	59510894       	60362664       	4         	0         	4              	DUP       
chr7        	58184989    	60573026    	59307384       	60480826       	5         	0         	5              	DEL       
chr7        	58184989    	60573026    	60039068       	60535236       	4         	0         	4              	DEL       
chr7        	58184989    	60573026    	60527470       	60535449       	12        	0         	12             	DEL       
chr7        	58184989    	60573026    	60121428       	60536024       	8         	0         	8              	DUP       
chr7        	58184989    	60573026    	58184990       	60573026       	14        	0         	14             	DEL       
chr7        	58184989    	60573026    	60421698       	60573807       	17        	0         	17             	DUP       
chr7        	58184989    	60573026    	60535551       	61967290       	4         	0         	4              	DUP       
chr7        	58184989    	60573026    	58189259       	61967065       	21        	0         	21             	DEL       
chr7        	58188900    	61964134    	59168950       	60735206       	10        	0         	10             	DEL       
chr7        	58188900    	61964134    	60996059       	60996920       	11        	0         	11             	DUP       
chr7        	58188900    	61964134    	58175616       	61964082       	4         	0         	4              	DUP       
chr7        	58188900    	61964134    	58188901       	61964134       	29        	0         	29             	DUP       
chr7        	58188900    	61964134    	58175621       	58189286       	6         	0         	6              	DUP       
chr7        	58188900    	61964134    	59086431       	59496054       	4         	0         	4              	DUP       
chr7        	58188900    	61964134    	59245618       	60296386       	5         	0         	5              	DEL       
chr7        	58188900    	61964134    	59510894       	60362664       	4         	0         	4              	DUP       
chr7        	58188900    	61964134    	59307384       	60480826       	5         	0         	5              	DEL       
chr7        	58188900    	61964134    	60039068       	60535236       	4         	0         	4              	DEL       
chr7        	58188900    	61964134    	60527470       	60535449       	12        	0         	12             	DEL       
chr7        	58188900    	61964134    	60121428       	60536024       	8         	0         	8              	DUP       
chr7        	58188900    	61964134    	58184990       	60573026       	14        	0         	14             	DEL       
chr7        	58188900    	61964134    	60421698       	60573807       	17        	0         	17             	DUP       
chr7        	58188900    	61964134    	61444214       	61515525       	6         	0         	6              	DEL       
chr7        	58188900    	61964134    	60535551       	61967290       	4         	0         	4              	DUP       
chr7        	58188900    	61964134    	61964141       	61967104       	7         	0         	7              	DEL       
chr7        	58188900    	61964134    	58189259       	61967065       	21        	0         	21             	DEL       
chr7        	58188900    	61964134    	61822332       	62250159       	27        	0         	27             	DUP       
chr7        	58189258    	61967065    	59168950       	60735206       	10        	0         	10             	DEL       
chr7        	58189258    	61967065    	60996059       	60996920       	11        	0         	11             	DUP       
chr7        	58189258    	61967065    	58175616       	61964082       	4         	0         	4              	DUP       
chr7        	58189258    	61967065    	58188901       	61964134       	29        	0         	29             	DUP       
chr7        	58189258    	61967065    	58175621       	58189286       	6         	0         	6              	DUP       
chr7        	58189258    	61967065    	59086431       	59496054       	4         	0         	4              	DUP       
chr7        	58189258    	61967065    	59245618       	60296386       	5         	0         	5              	DEL       
chr7        	58189258    	61967065    	59510894       	60362664       	4         	0         	4              	DUP       
chr7        	58189258    	61967065    	59307384       	60480826       	5         	0         	5              	DEL       
chr7        	58189258    	61967065    	60039068       	60535236       	4         	0         	4              	DEL       
chr7        	58189258    	61967065    	60527470       	60535449       	12        	0         	12             	DEL       
chr7        	58189258    	61967065    	60121428       	60536024       	8         	0         	8              	DUP       
chr7        	58189258    	61967065    	58184990       	60573026       	14        	0         	14             	DEL       
chr7        	58189258    	61967065    	60421698       	60573807       	17        	0         	17             	DUP       
chr7        	58189258    	61967065    	61444214       	61515525       	6         	0         	6              	DEL       
chr7        	58189258    	61967065    	60535551       	61967290       	4         	0         	4              	DUP       
chr7        	58189258    	61967065    	61964141       	61967104       	7         	0         	7              	DEL       
chr7        	58189258    	61967065    	58189259       	61967065       	21        	0         	21             	DEL       
chr7        	58189258    	61967065    	58175823       	61967065       	7         	0         	7              	DEL       
chr7        	58189258    	61967065    	61822332       	62250159       	27        	0         	27             	DUP       
chr7        	59168949    	60735206    	59168950       	60735206       	10        	0         	10             	DEL       
chr7        	59168949    	60735206    	59086431       	59496054       	4         	0         	4              	DUP       
chr7        	59168949    	60735206    	59245618       	60296386       	5         	0         	5              	DEL       
chr7        	59168949    	60735206    	59510894       	60362664       	4         	0         	4              	DUP       
chr7        	59168949    	60735206    	59307384       	60480826       	5         	0         	5              	DEL       
chr7        	59168949    	60735206    	60039068       	60535236       	4         	0         	4              	DEL       
chr7        	59168949    	60735206    	60527470       	60535449       	12        	0         	12             	DEL       
chr7        	59168949    	60735206    	60121428       	60536024       	8         	0         	8              	DUP       
chr7        	59168949    	60735206    	58184990       	60573026       	14        	0         	14             	DEL       
chr7        	59168949    	60735206    	60421698       	60573807       	17        	0         	17             	DUP       
chr7        	59168949    	60735206    	60535551       	61967290       	4         	0         	4              	DUP       
chr7        	59307494    	60480720    	59086431       	59496054       	4         	0         	4              	DUP       
chr7        	59307494    	60480720    	59245618       	60296386       	5         	0         	5              	DEL       
chr7        	59307494    	60480720    	59510894       	60362664       	4         	0         	4              	DUP       
chr7        	59307494    	60480720    	60039068       	60535236       	4         	0         	4              	DEL       
chr7        	59307494    	60480720    	60121428       	60536024       	8         	0         	8              	DUP       
chr7        	59307494    	60480720    	60421698       	60573807       	17        	0         	17             	DUP       
chr7        	59510893    	60362664    	59245618       	60296386       	5         	0         	5              	DEL       
chr7        	59510893    	60362664    	59510894       	60362664       	4         	0         	4              	DUP       
chr7        	59510893    	60362664    	60039068       	60535236       	4         	0         	4              	DEL       
chr7        	59510893    	60362664    	60121428       	60536024       	8         	0         	8              	DUP       
chr7        	60039067    	60535236    	59245618       	60296386       	5         	0         	5              	DEL       
chr7        	60039067    	60535236    	59510894       	60362664       	4         	0         	4              	DUP       
chr7        	60039067    	60535236    	59307384       	60480826       	5         	0         	5              	DEL       
chr7        	60039067    	60535236    	60039068       	60535236       	4         	0         	4              	DEL       
chr7        	60039067    	60535236    	60527470       	60535449       	12        	0         	12             	DEL       
chr7        	60039067    	60535236    	60121428       	60536024       	8         	0         	8              	DUP       
chr7        	60039067    	60535236    	60421698       	60573807       	17        	0         	17             	DUP       
chr7        	60121427    	60536024    	59245618       	60296386       	5         	0         	5              	DEL       
chr7        	60121427    	60536024    	59510894       	60362664       	4         	0         	4              	DUP       
chr7        	60121427    	60536024    	59307384       	60480826       	5         	0         	5              	DEL       
chr7        	60121427    	60536024    	60039068       	60535236       	4         	0         	4              	DEL       
chr7        	60121427    	60536024    	60527470       	60535449       	12        	0         	12             	DEL       
chr7        	60121427    	60536024    	60121428       	60536024       	8         	0         	8              	DUP       
chr7        	60121427    	60536024    	60421698       	60573807       	17        	0         	17             	DUP       
chr7        	60121427    	60536024    	60535551       	61967290       	4         	0         	4              	DUP       
chr7        	60421611    	60573848    	59307384       	60480826       	5         	0         	5              	DEL       
chr7        	60421611    	60573848    	60039068       	60535236       	4         	0         	4              	DEL       
chr7        	60421611    	60573848    	60527470       	60535449       	12        	0         	12             	DEL       
chr7        	60421611    	60573848    	60121428       	60536024       	8         	0         	8              	DUP       
chr7        	60421611    	60573848    	58184990       	60573026       	14        	0         	14             	DEL       
chr7        	60421611    	60573848    	60421698       	60573807       	17        	0         	17             	DUP       
chr7        	60421611    	60573848    	60535551       	61967290       	4         	0         	4              	DUP       
chr7        	60527579    	60535438    	60039068       	60535236       	4         	0         	4              	DEL       
chr7        	60527579    	60535438    	60527470       	60535449       	12        	0         	12             	DEL       
chr7        	60535550    	61967290    	59168950       	60735206       	10        	0         	10             	DEL       
chr7        	60535550    	61967290    	60996059       	60996920       	11        	0         	11             	DUP       
chr7        	60535550    	61967290    	58175616       	61964082       	4         	0         	4              	DUP       
chr7        	60535550    	61967290    	58188901       	61964134       	29        	0         	29             	DUP       
chr7        	60535550    	61967290    	60121428       	60536024       	8         	0         	8              	DUP       
chr7        	60535550    	61967290    	58184990       	60573026       	14        	0         	14             	DEL       
chr7        	60535550    	61967290    	60421698       	60573807       	17        	0         	17             	DUP       
chr7        	60535550    	61967290    	61444214       	61515525       	6         	0         	6              	DEL       
chr7        	60535550    	61967290    	60535551       	61967290       	4         	0         	4              	DUP       
chr7        	60535550    	61967290    	61964141       	61967104       	7         	0         	7              	DEL       
chr7        	60535550    	61967290    	58189259       	61967065       	21        	0         	21             	DEL       
chr7        	60535550    	61967290    	58175823       	61967065       	7         	0         	7              	DEL       
chr7        	60535550    	61967290    	61822332       	62250159       	27        	0         	27             	DUP       
chr7        	60996059    	60996922    	60996059       	60996920       	11        	0         	11             	DUP       
chr7        	61444213    	61515525    	61444214       	61515525       	6         	0         	6              	DEL       
chr7        	61822374    	62249965    	58175616       	61964082       	4         	0         	4              	DUP       
chr7        	61822374    	62249965    	58188901       	61964134       	29        	0         	29             	DUP       
chr7        	61822374    	62249965    	60535551       	61967290       	4         	0         	4              	DUP       
chr7        	61822374    	62249965    	61964141       	61967104       	7         	0         	7              	DEL       
chr7        	61822374    	62249965    	58189259       	61967065       	21        	0         	21             	DEL       
chr7        	61822374    	62249965    	58175823       	61967065       	7         	0         	7              	DEL       
chr7        	61822374    	62249965    	62239893       	62248568       	4         	8         	12             	DEL       
chr7        	61822374    	62249965    	61822332       	62250159       	27        	0         	27             	DUP       
chr7        	61964142    	61967070    	58175616       	61964082       	4         	0         	4              	DUP       
chr7        	61964142    	61967070    	58188901       	61964134       	29        	0         	29             	DUP       
chr7        	61964142    	61967070    	61964141       	61967104       	7         	0         	7              	DEL       
chr7        	61964142    	61967070    	58189259       	61967065       	21        	0         	21             	DEL       
chr7        	61964142    	61967070    	58175823       	61967065       	7         	0         	7              	DEL       
chr7        	62239889    	62248568    	62239893       	62248568       	4         	8         	12             	DEL       
chr7        	62307417    	62408438    	62307413       	62408555       	11        	0         	11             	DUP       
chr7        	62541912    	62544488    	62541957       	62544472       	59        	0         	59             	DEL       
chr7        	62576338    	62576708    	62576339       	62576708       	4         	0         	4              	DEL       
chr7        	64855428    	64857680    	64855446       	64857680       	58        	21        	79             	DEL       
chr7        	64952997    	64953656    	64952998       	64953656       	18        	6         	24             	DEL       
chr7        	65084370    	65773797    	65436182       	65436542       	5         	0         	5              	INV       
chr7        	65084370    	65773797    	65063124       	65752761       	5         	0         	5              	DEL       
chr7        	65084370    	65773797    	65084370       	65773795       	6         	0         	6              	DUP       
chr7        	66392655    	66395117    	66392633       	66395160       	12        	0         	12             	DEL       
chr7        	66728423    	73967870    	67666808       	67667158       	1         	13        	14             	DEL       
chr7        	66728423    	73967870    	68664085       	68664205       	1         	6         	7              	DEL       
chr7        	66728423    	73967870    	68997096       	68997402       	0         	10        	10             	DEL       
chr7        	66728423    	73967870    	71746928       	71747970       	14        	1         	15             	DEL       
chr7        	66728423    	73967870    	66728585       	73967789       	4         	3         	7              	DUP       
chr7        	66728423    	73967870    	66729471       	73967920       	6         	0         	6              	DEL       
chr7        	66728423    	73967870    	73134523       	74943378       	0         	7         	7              	DUP       
chr7        	66729708    	73967880    	67666808       	67667158       	1         	13        	14             	DEL       
chr7        	66729708    	73967880    	68664085       	68664205       	1         	6         	7              	DEL       
chr7        	66729708    	73967880    	68997096       	68997402       	0         	10        	10             	DEL       
chr7        	66729708    	73967880    	71746928       	71747970       	14        	1         	15             	DEL       
chr7        	66729708    	73967880    	66728585       	73967789       	4         	3         	7              	DUP       
chr7        	66729708    	73967880    	66729471       	73967920       	6         	0         	6              	DEL       
chr7        	66729708    	73967880    	73134523       	74943378       	0         	7         	7              	DUP       
chr7        	67666807    	67667158    	67666808       	67667158       	1         	13        	14             	DEL       
chr7        	68664077    	68664211    	68664085       	68664205       	1         	6         	7              	DEL       
chr7        	68997082    	68997402    	68997096       	68997402       	0         	10        	10             	DEL       
chr7        	71746912    	71747970    	71746928       	71747970       	14        	1         	15             	DEL       
chr7        	73134523    	74943371    	74414165       	74416931       	38        	0         	38             	DEL       
chr7        	73134523    	74943371    	66728585       	73967789       	4         	3         	7              	DUP       
chr7        	73134523    	74943371    	66729471       	73967920       	6         	0         	6              	DEL       
chr7        	73134523    	74943371    	74135474       	74136634       	32        	0         	32             	DEL       
chr7        	73134523    	74943371    	73134523       	74943378       	0         	7         	7              	DUP       
chr7        	74135427    	74136636    	74135474       	74136634       	32        	0         	32             	DEL       
chr7        	74414164    	74416985    	74414165       	74416931       	38        	0         	38             	DEL       
chr7        	75022480    	75022538    	75022484       	75022538       	1         	10        	11             	DEL       
chr7        	77011629    	77039978    	77011630       	77039978       	4         	0         	4              	DEL       
chr7        	78234552    	78234644    	78234553       	78234644       	0         	11        	11             	DEL       
chr7        	78330318    	78330643    	78330335       	78330643       	2         	8         	10             	DEL       
chr7        	80112759    	80113092    	80112774       	80113092       	1         	19        	20             	DEL       
chr7        	81729020    	81729295    	81729022       	81729295       	1         	9         	10             	DEL       
chr7        	81812142    	81813366    	81812249       	81813147       	23        	0         	23             	DEL       
chr7        	82099410    	82099748    	82099424       	82099748       	1         	5         	6              	DEL       
chr7        	82145517    	82145685    	82145532       	82145685       	1         	11        	12             	DEL       
chr7        	83281578    	83281642    	83281580       	83281642       	0         	8         	8              	DEL       
chr7        	83317145    	83317464    	83317161       	83317464       	0         	13        	13             	DEL       
chr7        	83389329    	83389532    	83389331       	83389532       	0         	12        	12             	DEL       
chr7        	83907151    	83907219    	83907156       	83907219       	0         	15        	15             	DEL       
chr7        	84080544    	84080871    	84080562       	84080871       	0         	18        	18             	DEL       
chr7        	84376309    	84376630    	84376320       	84376630       	1         	13        	14             	DEL       
chr7        	87207297    	87207607    	87207313       	87207607       	1         	16        	17             	DEL       
chr7        	87380244    	87380395    	87380245       	87380395       	0         	21        	21             	DUP       
chr7        	88039289    	88043279    	88039290       	88043374       	13        	0         	13             	DEL       
chr7        	88461983    	88462434    	88461992       	88462434       	6         	23        	29             	DEL       
chr7        	89969557    	89969874    	89969570       	89969874       	1         	5         	6              	DEL       
chr7        	90181092    	90183285    	90181095       	90183285       	45        	14        	59             	DEL       
chr7        	90954616    	90954924    	90954630       	90954924       	5         	22        	27             	DEL       
chr7        	93540674    	93540792    	93540696       	93540792       	0         	11        	11             	DEL       
chr7        	93912503    	93913227    	93912504       	93913227       	9         	9         	18             	DEL       
chr7        	95756940    	95757272    	95756956       	95757272       	0         	18        	18             	DEL       
chr7        	96133878    	96134101    	96133886       	96134101       	0         	4         	4              	DEL       
chr7        	96438199    	96438515    	96438209       	96438515       	3         	13        	16             	DEL       
chr7        	96846573    	96852682    	96846589       	96852682       	50        	15        	65             	DEL       
chr7        	97765894    	97773301    	97765714       	97773327       	10        	0         	10             	DEL       
chr7        	97765894    	97773301    	97773327       	97791171       	2         	2         	4              	DUP       
chr7        	97773326    	97791166    	97765714       	97773327       	10        	0         	10             	DEL       
chr7        	97773326    	97791166    	97773327       	97791171       	2         	2         	4              	DUP       
chr7        	99491927    	99492491    	99491928       	99492491       	5         	0         	5              	DEL       
chr7        	100729905   	100743042   	100729995      	100743064      	14        	0         	14             	DEL       
chr7        	100970205   	100971203   	100970206      	100971203      	6         	0         	6              	DEL       
chr7        	100995846   	101004432   	100991717      	101000261      	4         	0         	4              	DUP       
chr7        	100995846   	101004432   	100995788      	101004494      	7         	0         	7              	DEL       
chr7        	101690914   	101691235   	101690931      	101691235      	0         	11        	11             	DEL       
chr7        	103160141   	103160920   	103160142      	103160920      	10        	0         	10             	DEL       
chr7        	103822618   	103822941   	103822633      	103822941      	6         	28        	34             	DEL       
chr7        	104158965   	104159022   	104158966      	104159022      	0         	4         	4              	DEL       
chr7        	104489066   	104489348   	104489080      	104489348      	3         	24        	27             	DEL       
chr7        	104546936   	104547268   	104546954      	104547268      	1         	12        	13             	DEL       
chr7        	105349805   	105350340   	105349806      	105350340      	4         	0         	4              	DEL       
chr7        	106093543   	106093882   	106093547      	106093882      	3         	10        	13             	DEL       
chr7        	108177639   	108177734   	108177640      	108177721      	0         	7         	7              	DEL       
chr7        	108712401   	108712727   	108712413      	108712727      	3         	21        	24             	DEL       
chr7        	108860999   	108861101   	108861002      	108861101      	0         	9         	9              	DEL       
chr7        	108867829   	108868392   	108867830      	108868392      	4         	0         	4              	DEL       
chr7        	109244660   	109244790   	109244666      	109244790      	2         	19        	21             	DEL       
chr7        	109796631   	109813844   	109796632      	109813844      	38        	3         	41             	DEL       
chr7        	113776105   	113782152   	113776121      	113782152      	39        	18        	57             	DEL       
chr7        	114313445   	114313758   	114313463      	114313758      	1         	23        	24             	DEL       
chr7        	117201948   	117202260   	117201963      	117202260      	2         	7         	9              	DEL       
chr7        	118253895   	118254198   	118253913      	118254198      	0         	10        	10             	DEL       
chr7        	119191193   	119194700   	119191194      	119194700      	22        	11        	33             	DEL       
chr7        	120979511   	120979645   	120979523      	120979645      	1         	6         	7              	DEL       
chr7        	121241041   	121241380   	121241062      	121241380      	0         	10        	10             	DEL       
chr7        	121522360   	121522526   	121522361      	121522526      	17        	5         	22             	INV       
chr7        	121648827   	121650044   	121648828      	121650044      	4         	0         	4              	DEL       
chr7        	125071526   	125071619   	125071535      	125071619      	0         	5         	5              	DEL       
chr7        	127135555   	127135646   	127135569      	127135646      	0         	5         	5              	DEL       
chr7        	127980100   	127980419   	127980112      	127980419      	0         	8         	8              	DEL       
chr7        	128126361   	128126676   	128126376      	128126676      	0         	33        	33             	DEL       
chr7        	128669156   	128669475   	128669172      	128669475      	1         	22        	23             	DEL       
chr7        	129090834   	129090903   	129090835      	129090908      	0         	11        	11             	DEL       
chr7        	131654487   	131654752   	131654488      	131654752      	5         	0         	5              	DUP       
chr7        	133422917   	133423250   	133422936      	133423250      	0         	9         	9              	DEL       
chr7        	134100246   	134113576   	134100250      	134113576      	13        	7         	20             	DEL       
chr7        	137149701   	137150004   	137149719      	137150004      	2         	34        	36             	DEL       
chr7        	137166862   	137167174   	137166878      	137167174      	3         	15        	18             	DEL       
chr7        	137770524   	137770832   	137770538      	137770832      	0         	28        	28             	DEL       
chr7        	139057521   	139057839   	139057536      	139057839      	1         	21        	22             	DEL       
chr7        	139522400   	139522717   	139522415      	139522716      	1         	5         	6              	DEL       
chr7        	140481785   	140489420   	140481786      	140489423      	3         	9         	12             	DUP       
chr7        	140481785   	140489420   	140489422      	140489965      	13        	0         	13             	DEL       
chr7        	140481785   	140489420   	140481960      	140490608      	4         	0         	4              	DEL       
chr7        	140489467   	140490475   	140481786      	140489423      	3         	9         	12             	DUP       
chr7        	140489467   	140490475   	140489422      	140489965      	13        	0         	13             	DEL       
chr7        	140908785   	140909003   	140908789      	140909003      	1         	15        	16             	DEL       
chr7        	141414062   	141414382   	141414080      	141414382      	4         	20        	24             	DEL       
chr7        	141955198   	141955352   	141955212      	141955351      	0         	5         	5              	DEL       
chr7        	142060035   	142086488   	142060026      	142086480      	29        	0         	29             	DUP       
chr7        	142060035   	142086488   	142060780      	142087030      	33        	0         	33             	DEL       
chr7        	142060734   	142087179   	142060026      	142086480      	29        	0         	29             	DUP       
chr7        	142060734   	142087179   	142060780      	142087030      	33        	0         	33             	DEL       
chr7        	142560900   	142564072   	142560900      	142564070      	7         	0         	7              	DUP       
chr7        	142560900   	142564072   	142561829      	142564462      	5         	0         	5              	DEL       
chr7        	142653048   	142654516   	142653048      	142654516      	18        	0         	18             	DEL       
chr7        	142786220   	142796848   	142786221      	142796848      	17        	4         	21             	DEL       
chr7        	142893672   	142893990   	142893682      	142893990      	1         	10        	11             	DEL       
chr7        	143127748   	143196814   	143127754      	143196814      	24        	10        	34             	DEL       
chr7        	144685655   	144685805   	144685667      	144685804      	0         	19        	19             	DEL       
chr7        	145019384   	145020189   	145019385      	145020189      	5         	0         	5              	DEL       
chr7        	145772461   	145772537   	145772462      	145772537      	0         	12        	12             	DEL       
chr7        	147186863   	147187077   	147186867      	147187077      	0         	7         	7              	DEL       
chr7        	148375770   	148379231   	148375773      	148379230      	33        	0         	33             	DEL       
chr7        	149585069   	149608585   	149585069      	149608583      	9         	0         	9              	DUP       
chr7        	149878839   	149879005   	149878840      	149879005      	1         	8         	9              	DEL       
chr7        	150039083   	150041961   	150039016      	150041975      	9         	0         	9              	DUP       
chr7        	150150503   	150152039   	150150504      	150152039      	4         	0         	4              	DEL       
chr7        	150609891   	150682577   	150609891      	150682575      	6         	0         	6              	DUP       
chr7        	151360894   	151361039   	151360921      	151361033      	0         	6         	6              	DEL       
chr7        	152584606   	152587220   	152584618      	152587220      	24        	15        	39             	DEL       
chr7        	152622031   	152622097   	152622032      	152622097      	0         	7         	7              	DEL       
chr7        	152722313   	152722630   	152722332      	152722630      	2         	4         	6              	DEL       
chr7        	153505858   	153506534   	153505883      	153506578      	7         	0         	7              	DUP       
chr7        	153613041   	153613732   	153613053      	153613732      	37        	22        	59             	DEL       
chr7        	154600218   	154608073   	154600264      	154608020      	19        	0         	19             	DEL       
chr7        	154656897   	154657707   	154656898      	154657707      	4         	0         	4              	DEL       
chr7        	154662509   	154663975   	154662464      	154664009      	13        	0         	13             	DEL       
chr7        	155084841   	155088916   	155084842      	155088917      	27        	16        	43             	DUP       
chr7        	155084841   	155088916   	155085289      	155088917      	28        	16        	44             	DEL       
chr7        	155150204   	155150534   	155150222      	155150534      	1         	12        	13             	DEL       
chr7        	155933994   	155934291   	155934009      	155934582      	7         	2         	9              	DEL       
chr7        	156133496   	156133590   	156133498      	156133590      	0         	19        	19             	DEL       
chr7        	156976562   	156976631   	156976563      	156976631      	1         	4         	5              	DEL       
chr7        	158088196   	158090177   	158088043      	158089578      	5         	0         	5              	DEL       
chr7        	158236781   	158237756   	158236790      	158237756      	18        	5         	23             	DEL       
chr7        	158253949   	158254604   	158253950      	158254604      	25        	0         	25             	DEL       
chr7        	158337615   	158340816   	158337745      	158340815      	9         	0         	9              	DEL       
chr7        	159206224   	159206825   	159206225      	159206825      	15        	0         	15             	DEL       
chr8        	1097070     	1097994     	1097071        	1097994        	12        	0         	12             	DEL       
chr8        	1240777     	1241407     	1240778        	1241407        	4         	0         	4              	DEL       
chr8        	1247711     	1248652     	1247712        	1248652        	4         	0         	4              	DEL       
chr8        	1375172     	1376029     	1375173        	1376029        	12        	0         	12             	DEL       
chr8        	1888899     	1889834     	1888927        	1889761        	12        	0         	12             	DEL       
chr8        	2921040     	2921265     	2921045        	2921265        	0         	8         	8              	DEL       
chr8        	3723962     	3724157     	3723963        	3724157        	0         	12        	12             	DEL       
chr8        	4137357     	4137815     	4137359        	4137815        	2         	13        	15             	DEL       
chr8        	4265361     	4267450     	4265362        	4267450        	23        	6         	29             	DEL       
chr8        	4364526     	4364867     	4364542        	4364867        	1         	9         	10             	DEL       
chr8        	4486121     	4486258     	4486137        	4486258        	0         	20        	20             	DEL       
chr8        	5083700     	5083998     	5083713        	5083998        	1         	9         	10             	DEL       
chr8        	5122592     	5123456     	5122593        	5123456        	8         	1         	9              	DEL       
chr8        	5737993     	5748257     	5737994        	5748257        	27        	7         	34             	DEL       
chr8        	5887326     	5887401     	5887327        	5887401        	0         	6         	6              	DEL       
chr8        	5890653     	5890983     	5890665        	5890983        	2         	10        	12             	DEL       
chr8        	6372460     	6373212     	6372461        	6373212        	15        	0         	15             	DEL       
chr8        	6730307     	6730629     	6730322        	6730629        	1         	23        	24             	DEL       
chr8        	6933348     	6933671     	6933349        	6933671        	2         	9         	11             	DEL       
chr8        	7134139     	7137880     	7134139        	7137879        	28        	0         	28             	DEL       
chr8        	8387556     	8387633     	8387560        	8387633        	0         	12        	12             	DEL       
chr8        	8528519     	8529434     	8528543        	8529434        	17        	2         	19             	DEL       
chr8        	11388048    	11389698    	11388052       	11389698       	15        	5         	20             	DEL       
chr8        	11930778    	12035837    	12013095       	12664459       	4         	0         	4              	DUP       
chr8        	11930778    	12035837    	11930778       	12035835       	13        	0         	13             	DUP       
chr8        	12013094    	12664459    	12013095       	12664459       	4         	0         	4              	DUP       
chr8        	12013094    	12664459    	11930778       	12035835       	13        	0         	13             	DUP       
chr8        	12013094    	12664459    	12375974       	12378646       	4         	0         	4              	DEL       
chr8        	12013094    	12664459    	12206917       	12449058       	3         	2         	5              	DEL       
chr8        	12013094    	12664459    	12570300       	12575352       	7         	0         	7              	DEL       
chr8        	12375955    	12378615    	12375974       	12378646       	4         	0         	4              	DEL       
chr8        	13312062    	13312384    	13312080       	13312383       	0         	12        	12             	DEL       
chr8        	13736954    	13737120    	13736973       	13737119       	0         	9         	9              	DEL       
chr8        	13920549    	13920876    	13920564       	13920876       	0         	25        	25             	DEL       
chr8        	14101375    	14101563    	14101376       	14101564       	0         	18        	18             	DUP       
chr8        	15143756    	15144077    	15143770       	15144077       	2         	21        	23             	DEL       
chr8        	15195880    	15196196    	15195896       	15196196       	0         	13        	13             	DEL       
chr8        	16689238    	16689339    	16689254       	16689339       	0         	26        	26             	DEL       
chr8        	16964369    	16964740    	16964371       	16964740       	1         	6         	7              	DEL       
chr8        	17875481    	17875589    	17875510       	17875589       	0         	12        	12             	DEL       
chr8        	18001987    	18002913    	18001995       	18002913       	19        	10        	29             	DEL       
chr8        	18597100    	18598434    	18597110       	18598434       	23        	10        	33             	DEL       
chr8        	18793940    	18794915    	18793948       	18794915       	49        	22        	71             	DEL       
chr8        	23549705    	23550346    	23549710       	23550346       	11        	9         	20             	DEL       
chr8        	25114916    	25133428    	25114919       	25133428       	28        	10        	38             	DEL       
chr8        	25114916    	25133428    	25122070       	25122382       	0         	16        	16             	DEL       
chr8        	25122053    	25122382    	25122070       	25122382       	0         	16        	16             	DEL       
chr8        	25209161    	25213136    	25209169       	25213136       	35        	14        	49             	DEL       
chr8        	25346558    	25346784    	25346559       	25346784       	0         	7         	7              	DEL       
chr8        	25469704    	25469762    	25469705       	25469762       	0         	12        	12             	DEL       
chr8        	26054610    	26054928    	26054820       	26054927       	10        	3         	13             	INV       
chr8        	26998866    	27000496    	26998867       	27000505       	24        	11        	35             	DUP       
chr8        	27111407    	27111992    	27111502       	27111954       	11        	0         	11             	INV       
chr8        	29960767    	29960891    	29960772       	29960891       	0         	8         	8              	DEL       
chr8        	29980021    	29980769    	29980022       	29980769       	12        	4         	16             	DEL       
chr8        	30534759    	30535064    	30534774       	30535064       	1         	20        	21             	DEL       
chr8        	31713724    	31714079    	31713739       	31714078       	2         	15        	17             	DEL       
chr8        	32822486    	32833743    	32822491       	32833743       	41        	9         	50             	DEL       
chr8        	34165005    	34165287    	34165011       	34165287       	0         	13        	13             	DEL       
chr8        	35487190    	35487248    	35487193       	35487248       	0         	12        	12             	DEL       
chr8        	37193360    	37194335    	37193367       	37194335       	37        	20        	57             	DEL       
chr8        	38525869    	38525950    	38525890       	38525948       	0         	8         	8              	DEL       
chr8        	39096101    	39096362    	39096102       	39096362       	0         	6         	6              	DEL       
chr8        	39879760    	39879991    	39879761       	39879991       	1         	5         	6              	DEL       
chr8        	39907794    	39908127    	39907811       	39908127       	2         	11        	13             	DEL       
chr8        	40118541    	40118632    	40118544       	40118632       	0         	10        	10             	DEL       
chr8        	40612214    	40612864    	40612216       	40612864       	20        	8         	28             	DEL       
chr8        	40917102    	40922259    	40917113       	40922220       	19        	0         	19             	DEL       
chr8        	41421808    	41422132    	41421825       	41422132       	2         	18        	20             	DEL       
chr8        	42332805    	42336931    	42332950       	42336834       	43        	0         	43             	DEL       
chr8        	42520413    	42522789    	42520419       	42522789       	3         	10        	13             	DEL       
chr8        	42717086    	42717408    	42717090       	42717408       	0         	7         	7              	DEL       
chr8        	42730766    	42731113    	42730767       	42731095       	0         	17        	17             	DEL       
chr8        	43005329    	43006206    	43005242       	43006162       	22        	0         	22             	DUP       
chr8        	46361266    	46361342    	46361279       	46361341       	0         	6         	6              	DEL       
chr8        	46469684    	46470018    	46469698       	46470018       	2         	18        	20             	DEL       
chr8        	46968606    	46968729    	46968619       	46968728       	0         	8         	8              	DEL       
chr8        	50462152    	50462471    	50462157       	50462471       	0         	8         	8              	DEL       
chr8        	51111200    	51111475    	51111203       	51111475       	1         	6         	7              	DEL       
chr8        	51454941    	51455131    	51454957       	51455131       	0         	6         	6              	DEL       
chr8        	51825400    	51825724    	51825413       	51825724       	2         	8         	10             	DEL       
chr8        	52788403    	52789069    	52788404       	52789073       	10        	6         	16             	DEL       
chr8        	53209990    	53211087    	53209993       	53211087       	22        	10        	32             	DEL       
chr8        	53292321    	53292638    	53292336       	53292638       	1         	6         	7              	DEL       
chr8        	54494578    	54494654    	54494589       	54494653       	0         	7         	7              	DEL       
chr8        	55488641    	55488958    	55488657       	55488958       	4         	13        	17             	DEL       
chr8        	55746038    	55746175    	55746047       	55746175       	0         	9         	9              	DEL       
chr8        	55763717    	55763848    	55763719       	55763848       	1         	18        	19             	DEL       
chr8        	56054756    	56054910    	56054772       	56054910       	1         	19        	20             	DEL       
chr8        	56387641    	56387759    	56387642       	56387759       	0         	13        	13             	DEL       
chr8        	56867261    	56867369    	56867262       	56867369       	0         	15        	15             	DEL       
chr8        	57210487    	57214873    	57209763       	57214126       	7         	0         	7              	DUP       
chr8        	57210487    	57214873    	57210359       	57214973       	8         	0         	8              	DEL       
chr8        	58165892    	58166229    	58165905       	58166229       	1         	11        	12             	DEL       
chr8        	59267214    	59267267    	59267215       	59267267       	0         	17        	17             	DEL       
chr8        	61033312    	61033462    	61033317       	61033462       	1         	4         	5              	DEL       
chr8        	62017583    	62017896    	62017592       	62017896       	2         	7         	9              	DEL       
chr8        	62581816    	62581883    	62581817       	62581940       	0         	5         	5              	DEL       
chr8        	65399112    	65399234    	65399116       	65399234       	0         	8         	8              	DEL       
chr8        	67815084    	67815417    	67815098       	67815417       	0         	18        	18             	DEL       
chr8        	70671319    	70672408    	70671336       	70672408       	25        	12        	37             	DEL       
chr8        	71302509    	71305573    	71302517       	71305573       	24        	15        	39             	DEL       
chr8        	71639169    	71639504    	71639183       	71639504       	2         	8         	10             	DEL       
chr8        	72875529    	72881588    	72875540       	72881588       	18        	9         	27             	DEL       
chr8        	73149134    	73149935    	73149135       	73149935       	16        	0         	16             	DEL       
chr8        	73695360    	73695448    	73695361       	73695448       	0         	9         	9              	DEL       
chr8        	73720481    	73720811    	73720500       	73720811       	1         	5         	6              	DEL       
chr8        	73875525    	73875623    	73875526       	73875623       	1         	10        	11             	DEL       
chr8        	74450635    	74454727    	74450636       	74454727       	58        	16        	74             	DEL       
chr8        	74964702    	74965029    	74964713       	74965029       	1         	40        	41             	DEL       
chr8        	75214652    	75214977    	75214667       	75214977       	2         	12        	14             	DEL       
chr8        	75225898    	75225956    	75225899       	75225956       	1         	9         	10             	DEL       
chr8        	75501810    	75501916    	75501816       	75501916       	0         	5         	5              	DEL       
chr8        	76303619    	76303745    	76303639       	76303745       	0         	7         	7              	DEL       
chr8        	76425145    	76426191    	76425150       	76426191       	30        	11        	41             	DEL       
chr8        	78167101    	78167174    	78167104       	78167174       	0         	25        	25             	DEL       
chr8        	78771161    	78771252    	78771162       	78771252       	0         	6         	6              	DEL       
chr8        	85043419    	85043754    	85043433       	85043754       	1         	10        	11             	DEL       
chr8        	86176018    	86181514    	86176024       	86181514       	24        	9         	33             	DEL       
chr8        	88014561    	88014640    	88014563       	88014640       	0         	5         	5              	DEL       
chr8        	88339697    	88339794    	88339700       	88339794       	0         	9         	9              	DEL       
chr8        	88379977    	88380285    	88379989       	88380285       	0         	14        	14             	DEL       
chr8        	88538602    	88538701    	88538610       	88538701       	0         	10        	10             	DEL       
chr8        	89456030    	89456193    	89456040       	89456193       	0         	23        	23             	DEL       
chr8        	91140627    	91140952    	91140644       	91140952       	1         	27        	28             	DEL       
chr8        	94340900    	94340986    	94340907       	94340963       	0         	7         	7              	DEL       
chr8        	95333021    	95333165    	95333059       	95333148       	0         	7         	7              	DEL       
chr8        	95333021    	95333165    	95333022       	95333165       	0         	14        	14             	DEL       
chr8        	96085844    	96086198    	96085860       	96086197       	2         	22        	24             	DEL       
chr8        	96787834    	96787903    	96787835       	96787903       	0         	18        	18             	DEL       
chr8        	97187913    	97188236    	97187929       	97188236       	1         	10        	11             	DEL       
chr8        	97583163    	97583504    	97583181       	97583503       	0         	15        	15             	DEL       
chr8        	97771219    	97771553    	97771233       	97771552       	2         	17        	19             	DEL       
chr8        	99145580    	99146021    	99145584       	99146021       	26        	9         	35             	INV       
chr8        	100426708   	100426831   	100426709      	100426831      	0         	4         	4              	DUP       
chr8        	102423274   	102423780   	102423263      	102423778      	29        	2         	31             	INV       
chr8        	105169166   	105169495   	105169182      	105169495      	0         	30        	30             	DEL       
chr8        	105658289   	105658610   	105658306      	105658610      	4         	12        	16             	DEL       
chr8        	105691219   	105691546   	105691236      	105691546      	1         	3         	4              	DEL       
chr8        	106009348   	106009404   	106009345      	106009404      	0         	5         	5              	DEL       
chr8        	106498864   	106499190   	106498881      	106499190      	1         	20        	21             	DEL       
chr8        	106716326   	106716657   	106716342      	106716657      	6         	29        	35             	DEL       
chr8        	107108005   	107108335   	107108006      	107108309      	2         	10        	12             	DEL       
chr8        	107368449   	107368850   	107368492      	107369074      	6         	0         	6              	DEL       
chr8        	108717931   	108718257   	108717946      	108718257      	0         	10        	10             	DEL       
chr8        	109222489   	109222823   	109222490      	109222823      	1         	6         	7              	DEL       
chr8        	109498077   	109498400   	109498091      	109498400      	1         	3         	4              	DEL       
chr8        	111155995   	111156350   	111156009      	111156349      	2         	15        	17             	DEL       
chr8        	111281821   	111284910   	111281823      	111284910      	22        	1         	23             	DEL       
chr8        	112073193   	112073524   	112073207      	112073524      	1         	17        	18             	DEL       
chr8        	112213618   	112213963   	112213633      	112213962      	3         	18        	21             	DEL       
chr8        	113044262   	113046543   	113044266      	113046543      	20        	8         	28             	DEL       
chr8        	113922162   	113922453   	113922164      	113922453      	2         	12        	14             	DEL       
chr8        	114280773   	114281181   	114280774      	114281185      	0         	6         	6              	DEL       
chr8        	114985575   	114986137   	114985535      	114986137      	11        	0         	11             	DEL       
chr8        	115475988   	115476318   	115476006      	115476318      	0         	13        	13             	DEL       
chr8        	117700548   	117700880   	117700564      	117700880      	0         	16        	16             	DEL       
chr8        	117968517   	117968870   	117968533      	117968869      	2         	11        	13             	DEL       
chr8        	118434818   	118435116   	118434819      	118435116      	2         	2         	4              	DEL       
chr8        	119142302   	119148976   	119142305      	119148976      	14        	11        	25             	DEL       
chr8        	120669431   	120669751   	120669445      	120669751      	3         	13        	16             	DEL       
chr8        	120842502   	120842821   	120842519      	120842821      	3         	14        	17             	DEL       
chr8        	123642051   	123642116   	123642052      	123642119      	1         	11        	12             	DEL       
chr8        	124801200   	124801265   	124801204      	124801265      	0         	11        	11             	DEL       
chr8        	125324554   	125324872   	125324575      	125324872      	5         	9         	14             	DEL       
chr8        	125582876   	125588890   	125582885      	125588890      	38        	21        	59             	DEL       
chr8        	125669130   	125669462   	125669145      	125669462      	0         	10        	10             	DEL       
chr8        	126179960   	126182327   	126179961      	126182327      	36        	18        	54             	DEL       
chr8        	126236715   	126237038   	126236711      	126237038      	2         	11        	13             	DEL       
chr8        	127408008   	127408143   	127408035      	127408143      	0         	18        	18             	DEL       
chr8        	128452906   	128459021   	128452922      	128459020      	51        	20        	71             	DEL       
chr8        	128750272   	128753780   	128750153      	128753780      	6         	0         	6              	DEL       
chr8        	130049230   	130050258   	130049231      	130050258      	4         	0         	4              	DEL       
chr8        	131156035   	131156349   	131156054      	131156349      	0         	6         	6              	DEL       
chr8        	131265425   	131268378   	131265478      	131268289      	12        	0         	12             	DEL       
chr8        	133866073   	134670232   	134070686      	134076772      	41        	14        	55             	DEL       
chr8        	133866073   	134670232   	134464769      	134465856      	4         	0         	4              	DEL       
chr8        	133866073   	134670232   	133866067      	134670260      	19        	0         	19             	DEL       
chr8        	133866073   	134670232   	133866612      	134670848      	15        	0         	15             	DUP       
chr8        	133866631   	134670902   	134070686      	134076772      	41        	14        	55             	DEL       
chr8        	133866631   	134670902   	134464769      	134465856      	4         	0         	4              	DEL       
chr8        	133866631   	134670902   	133866067      	134670260      	19        	0         	19             	DEL       
chr8        	133866631   	134670902   	133866612      	134670848      	15        	0         	15             	DUP       
chr8        	134070669   	134076773   	134070686      	134076772      	41        	14        	55             	DEL       
chr8        	134464768   	134465856   	134464769      	134465856      	4         	0         	4              	DEL       
chr8        	135835170   	135835291   	135835202      	135835296      	0         	6         	6              	DEL       
chr8        	136704569   	136704896   	136704586      	136704896      	4         	13        	17             	DEL       
chr8        	137187918   	137188164   	137187934      	137188164      	0         	5         	5              	DEL       
chr8        	137730721   	137731618   	137730724      	137731618      	31        	15        	46             	DEL       
chr8        	138691455   	138692327   	138691505      	138692274      	3         	1         	4              	DUP       
chr8        	139149120   	139149314   	139149121      	139149314      	0         	9         	9              	DEL       
chr8        	139463014   	139463348   	139463026      	139463347      	1         	20        	21             	DEL       
chr8        	140419093   	141917651   	140419061      	141917523      	8         	0         	8              	DUP       
chr8        	140419093   	141917651   	140622293      	140623223      	5         	0         	5              	DEL       
chr8        	140419093   	141917651   	141347553      	141347610      	1         	5         	6              	DEL       
chr8        	140419093   	141917651   	140419282      	141917686      	14        	0         	14             	DEL       
chr8        	140419223   	141917646   	140419061      	141917523      	8         	0         	8              	DUP       
chr8        	140419223   	141917646   	140622293      	140623223      	5         	0         	5              	DEL       
chr8        	140419223   	141917646   	141347553      	141347610      	1         	5         	6              	DEL       
chr8        	140419223   	141917646   	140419282      	141917686      	14        	0         	14             	DEL       
chr8        	140622292   	140623223   	140622293      	140623223      	5         	0         	5              	DEL       
chr8        	141347543   	141347611   	141347553      	141347610      	1         	5         	6              	DEL       
chr8        	142300958   	142301050   	142300959      	142301050      	0         	4         	4              	DEL       
chr8        	142413420   	142414318   	142413421      	142414318      	24        	0         	24             	DEL       
chr8        	142877421   	142915279   	142877421      	142915277      	9         	0         	9              	DUP       
chr8        	142877421   	142915279   	142878585      	142915799      	11        	0         	11             	DEL       
chr8        	142877819   	142915800   	142877421      	142915277      	9         	0         	9              	DUP       
chr8        	142877819   	142915800   	142878585      	142915799      	11        	0         	11             	DEL       
chr8        	143431407   	143431511   	143431411      	143431511      	0         	7         	7              	DEL       
chr8        	143618313   	143632522   	143618316      	143632522      	18        	0         	18             	DEL       
chr8        	144021305   	144022363   	144021561      	144022575      	15        	0         	15             	DEL       
chr8        	144021305   	144022363   	144021284      	144023619      	4         	0         	4              	DUP       
chr8        	144021283   	144023619   	144021561      	144022575      	15        	0         	15             	DEL       
chr8        	144021283   	144023619   	144021284      	144023619      	4         	0         	4              	DUP       
chr8        	144021283   	144023619   	144023312      	144023937      	4         	0         	4              	DEL       
chr8        	144022712   	144023310   	144023312      	144023937      	4         	0         	4              	DEL       
chr8        	144279079   	144279162   	144279088      	144279143      	0         	9         	9              	DEL       
chr8        	144298152   	144298460   	144298157      	144298460      	0         	4         	4              	DEL       
chr8        	144817545   	144817681   	144817561      	144817681      	0         	6         	6              	DEL       
chr8        	144831582   	144832447   	144831583      	144832447      	15        	0         	15             	DEL       
chr8        	144967481   	144967788   	144967483      	144967788      	1         	18        	19             	DEL       
chr9        	320136      	322477      	320216         	322420         	24        	0         	24             	DEL       
chr9        	2814056     	2814257     	2814057        	2814259        	0         	4         	4              	DUP       
chr9        	3780615     	3780942     	3780632        	3780942        	2         	18        	20             	DEL       
chr9        	4346657     	4346969     	4346671        	4346969        	0         	24        	24             	DEL       
chr9        	4376416     	4377644     	4376421        	4377644        	25        	11        	36             	DEL       
chr9        	4537261     	4537605     	4537277        	4537605        	3         	10        	13             	DEL       
chr9        	4710197     	4909307     	4710196        	4909306        	5         	0         	5              	DEL       
chr9        	4710197     	4909307     	4710617        	4909480        	7         	0         	7              	DUP       
chr9        	4710467     	4909430     	4710196        	4909306        	5         	0         	5              	DEL       
chr9        	4710467     	4909430     	4710617        	4909480        	7         	0         	7              	DUP       
chr9        	6729118     	6730106     	6729122        	6730106        	35        	7         	42             	DEL       
chr9        	6888772     	6889087     	6888787        	6889087        	0         	7         	7              	DEL       
chr9        	6999376     	6999684     	6999384        	6999684        	2         	26        	28             	DEL       
chr9        	8848768     	8849002     	8848770        	8849002        	0         	7         	7              	DEL       
chr9        	9950427     	9950758     	9950442        	9950758        	1         	10        	11             	DEL       
chr9        	10404560    	10405091    	10404564       	10405091       	13        	19        	32             	DEL       
chr9        	10498739    	10499050    	10498752       	10499050       	4         	19        	23             	DEL       
chr9        	10828090    	10828426    	10828106       	10828426       	4         	17        	21             	DEL       
chr9        	12556832    	12559646    	12556849       	12559646       	13        	6         	19             	DEL       
chr9        	14632540    	14632695    	14632541       	14632695       	0         	5         	5              	DEL       
chr9        	15394881    	15395198    	15394898       	15395198       	1         	13        	14             	DEL       
chr9        	15602581    	15602669    	15602584       	15602668       	0         	12        	12             	DEL       
chr9        	15815307    	15821942    	15815311       	15821942       	14        	9         	23             	DEL       
chr9        	16664853    	16664972    	16664863       	16664972       	0         	6         	6              	DEL       
chr9        	16847394    	16847520    	16847397       	16847520       	0         	13        	13             	DEL       
chr9        	17925827    	17945762    	17925827       	17945760       	6         	0         	6              	DUP       
chr9        	18286561    	18286741    	18286562       	18286741       	1         	12        	13             	DEL       
chr9        	18751827    	18752118    	18751844       	18752118       	2         	11        	13             	DEL       
chr9        	22496527    	22504345    	22496528       	22504345       	26        	1         	27             	DEL       
chr9        	22999487    	22999821    	22999504       	22999820       	1         	20        	21             	DEL       
chr9        	23075120    	23075439    	23075121       	23075433       	0         	22        	22             	DEL       
chr9        	26512928    	26513244    	26512940       	26513244       	1         	8         	9              	DEL       
chr9        	27420862    	27420923    	27420864       	27420923       	0         	6         	6              	DEL       
chr9        	27670561    	27670627    	27670563       	27670627       	0         	7         	7              	DEL       
chr9        	28584920    	28585013    	28584937       	28585013       	0         	22        	22             	DEL       
chr9        	29624692    	29625014    	29624711       	29625014       	4         	21        	25             	DEL       
chr9        	30345777    	30346096    	30345791       	30346087       	2         	14        	16             	DEL       
chr9        	30491284    	30491596    	30491300       	30491596       	2         	25        	27             	DEL       
chr9        	31291356    	31292674    	31291358       	31292674       	30        	20        	50             	DEL       
chr9        	33213102    	33213906    	33213103       	33213906       	17        	0         	17             	DEL       
chr9        	33423362    	33424656    	33423378       	33424656       	41        	18        	59             	DEL       
chr9        	34681482    	34681979    	34681483       	34681980       	8         	7         	15             	DUP       
chr9        	36309281    	36309603    	36309297       	36309603       	1         	9         	10             	DEL       
chr9        	36362883    	36364082    	36362907       	36364098       	21        	0         	21             	DEL       
chr9        	36423656    	36423973    	36423667       	36423973       	1         	4         	5              	DEL       
chr9        	38750591    	38750817    	38750592       	38750817       	11        	0         	11             	INV       
chr9        	39589105    	42343567    	40910789       	40911114       	4         	0         	4              	DEL       
chr9        	39589105    	42343567    	40926518       	40927294       	5         	0         	5              	DEL       
chr9        	39589105    	42343567    	41237677       	41238541       	4         	0         	4              	DEL       
chr9        	39589105    	42343567    	40543755       	40901823       	6         	0         	6              	DUP       
chr9        	39589105    	42343567    	40902071       	40902638       	14        	0         	14             	DEL       
chr9        	39589105    	42343567    	40914597       	40914684       	1         	12        	13             	DEL       
chr9        	39589105    	42343567    	40923207       	40924334       	0         	20        	20             	DEL       
chr9        	39589105    	42343567    	40923673       	40923737       	4         	0         	4              	DEL       
chr9        	39589105    	42343567    	40930514       	40930786       	4         	0         	4              	DEL       
chr9        	39589105    	42343567    	39589104       	42343566       	10        	0         	10             	DEL       
chr9        	39589105    	42343567    	40543626       	43175401       	5         	0         	5              	DEL       
chr9        	39589105    	42343567    	40903621       	43206127       	9         	0         	9              	DEL       
chr9        	39589105    	42343567    	40903964       	43206406       	7         	0         	7              	DUP       
chr9        	40902070    	40902638    	40902071       	40902638       	14        	0         	14             	DEL       
chr9        	40910788    	40911114    	40910789       	40911114       	4         	0         	4              	DEL       
chr9        	40914595    	40914693    	40914597       	40914684       	1         	12        	13             	DEL       
chr9        	40923186    	40924335    	40923207       	40924334       	0         	20        	20             	DEL       
chr9        	40923186    	40924335    	40923673       	40923737       	4         	0         	4              	DEL       
chr9        	41237676    	41238541    	41237677       	41238541       	4         	0         	4              	DEL       
chr9        	42387012    	42387326    	42387022       	42387325       	1         	20        	21             	DEL       
chr9        	43198746    	43201076    	43198746       	43201074       	13        	0         	13             	DUP       
chr9        	43198746    	43201076    	43199811       	43200533       	6         	0         	6              	DEL       
chr9        	43199810    	43200533    	43199811       	43200533       	6         	0         	6              	DEL       
chr9        	43263239    	43263826    	43263240       	43263826       	5         	0         	5              	DEL       
chr9        	43383226    	45151921    	44072045       	44125993       	9         	0         	9              	DUP       
chr9        	43383226    	45151921    	43436893       	44600180       	6         	0         	6              	DEL       
chr9        	43383226    	45151921    	44366910       	44781189       	6         	0         	6              	DUP       
chr9        	43383226    	45151921    	44873485       	45150717       	4         	0         	4              	DUP       
chr9        	43383226    	45151921    	43383210       	45152057       	12        	0         	12             	DEL       
chr9        	43383226    	45151921    	44746298       	45305520       	4         	0         	4              	DEL       
chr9        	43437066    	44600021    	44072045       	44125993       	9         	0         	9              	DUP       
chr9        	43437066    	44600021    	44366910       	44781189       	6         	0         	6              	DUP       
chr9        	44071877    	44126182    	44072045       	44125993       	9         	0         	9              	DUP       
chr9        	44366743    	44781346    	43436893       	44600180       	6         	0         	6              	DEL       
chr9        	44366743    	44781346    	44366910       	44781189       	6         	0         	6              	DUP       
chr9        	44366743    	44781346    	44746298       	45305520       	4         	0         	4              	DEL       
chr9        	44746297    	45305520    	44366910       	44781189       	6         	0         	6              	DUP       
chr9        	44746297    	45305520    	44873485       	45150717       	4         	0         	4              	DUP       
chr9        	44746297    	45305520    	43383210       	45152057       	12        	0         	12             	DEL       
chr9        	44746297    	45305520    	44746298       	45305520       	4         	0         	4              	DEL       
chr9        	44873484    	45150717    	44873485       	45150717       	4         	0         	4              	DUP       
chr9        	62876603    	62877497    	62876604       	62877497       	30        	0         	30             	DEL       
chr9        	65071426    	65075510    	65071488       	65075492       	23        	0         	23             	DEL       
chr9        	69050406    	69050641    	69050423       	69050641       	0         	17        	17             	DEL       
chr9        	69123203    	69128438    	69123206       	69128438       	19        	11        	30             	DEL       
chr9        	69163009    	69163328    	69163025       	69163328       	1         	27        	28             	DEL       
chr9        	69280415    	69281606    	69280523       	69281601       	14        	0         	14             	DEL       
chr9        	71654468    	71654750    	71654480       	71654750       	1         	12        	13             	DEL       
chr9        	71739339    	71739421    	71739345       	71739421       	0         	7         	7              	DEL       
chr9        	73054600    	73054881    	73054614       	73054880       	0         	22        	22             	DEL       
chr9        	73321076    	73321146    	73321081       	73321146       	0         	6         	6              	DEL       
chr9        	75046241    	75046304    	75046243       	75046304       	0         	4         	4              	DEL       
chr9        	79110844    	79111166    	79110862       	79111166       	6         	16        	22             	DEL       
chr9        	80230254    	80230582    	80230263       	80230576       	1         	4         	5              	DEL       
chr9        	80740843    	80740924    	80740865       	80740924       	0         	7         	7              	DEL       
chr9        	80758047    	80758318    	80758078       	80758318       	2         	8         	10             	DEL       
chr9        	81015521    	81015835    	81015537       	81015835       	0         	19        	19             	DEL       
chr9        	81353001    	81355768    	81353010       	81355768       	23        	4         	27             	DEL       
chr9        	81709448    	81712018    	81709448       	81712011       	18        	6         	24             	DEL       
chr9        	81862156    	81862489    	81862171       	81862489       	3         	14        	17             	DEL       
chr9        	82418929    	82419273    	82418944       	82419272       	1         	9         	10             	DEL       
chr9        	82931955    	82932092    	82931956       	82932092       	0         	10        	10             	DEL       
chr9        	85286489    	85286797    	85286501       	85286797       	1         	10        	11             	DEL       
chr9        	85383161    	85383251    	85383171       	85383251       	0         	10        	10             	DEL       
chr9        	86052964    	86053699    	86052964       	86053697       	4         	0         	4              	DUP       
chr9        	86539637    	86541012    	86539641       	86541031       	39        	0         	39             	DEL       
chr9        	87184177    	87184492    	87184187       	87184492       	0         	24        	24             	DEL       
chr9        	88244067    	88246049    	88244081       	88246048       	47        	14        	61             	DEL       
chr9        	88887078    	88887143    	88887086       	88887143       	0         	11        	11             	DEL       
chr9        	91121079    	91121402    	91121092       	91121402       	1         	12        	13             	DEL       
chr9        	93708071    	93709182    	93708073       	93709182       	21        	9         	30             	DEL       
chr9        	93968062    	93968315    	93968076       	93968315       	0         	9         	9              	DEL       
chr9        	94452696    	94452747    	94452690       	94452747       	0         	8         	8              	DEL       
chr9        	94530623    	94530949    	94530641       	94530949       	0         	7         	7              	DEL       
chr9        	97998775    	97999106    	97998793       	97999106       	2         	19        	21             	DEL       
chr9        	98546760    	98549382    	98546766       	98549382       	47        	18        	65             	DEL       
chr9        	98585702    	98586034    	98585704       	98586034       	2         	25        	27             	DEL       
chr9        	101457412   	101458096   	101457417      	101458096      	28        	20        	48             	DEL       
chr9        	101681678   	101682445   	101681697      	101682445      	44        	25        	69             	DEL       
chr9        	101807412   	101808200   	101807413      	101808200      	16        	0         	16             	DEL       
chr9        	102400202   	102400386   	102400210      	102400386      	0         	10        	10             	DEL       
chr9        	102457433   	102457772   	102457434      	102457772      	17        	0         	17             	INV       
chr9        	103015077   	103015203   	103015088      	103015203      	0         	5         	5              	DEL       
chr9        	104295785   	104296459   	104295786      	104296460      	15        	12        	27             	DUP       
chr9        	104600644   	104606725   	104600631      	104606768      	11        	0         	11             	DEL       
chr9        	104600644   	104606725   	104600954      	104607196      	15        	0         	15             	DUP       
chr9        	104600958   	104607142   	104600631      	104606768      	11        	0         	11             	DEL       
chr9        	104600958   	104607142   	104600954      	104607196      	15        	0         	15             	DUP       
chr9        	104638691   	104639006   	104638707      	104639006      	1         	10        	11             	DEL       
chr9        	104833905   	104834822   	104833909      	104834822      	15        	11        	26             	DEL       
chr9        	104862637   	104862744   	104862639      	104862743      	0         	7         	7              	DEL       
chr9        	105054708   	105055060   	105054355      	105055066      	8         	8         	16             	INV       
chr9        	107255995   	107258568   	107256005      	107258567      	52        	32        	84             	DEL       
chr9        	107271162   	107273167   	107271173      	107273167      	43        	7         	50             	DEL       
chr9        	107775253   	107778330   	107775254      	107778314      	38        	14        	52             	DEL       
chr9        	109523564   	109524282   	109523565      	109524282      	9         	10        	19             	DUP       
chr9        	109523564   	109524282   	109523765      	109524406      	4         	1         	5              	DEL       
chr9        	109523764   	109524406   	109523565      	109524282      	9         	10        	19             	DUP       
chr9        	109523764   	109524406   	109523765      	109524406      	4         	1         	5              	DEL       
chr9        	109667919   	109668235   	109667932      	109668235      	1         	24        	25             	DEL       
chr9        	112502364   	112502456   	112502365      	112502456      	0         	24        	24             	DEL       
chr9        	113174803   	113175099   	113174817      	113175099      	1         	21        	22             	DEL       
chr9        	115248367   	115248476   	115248368      	115248476      	4         	3         	7              	INV       
chr9        	115347362   	115347708   	115347377      	115347708      	0         	11        	11             	DEL       
chr9        	119769555   	119769874   	119769567      	119769874      	2         	21        	23             	DEL       
chr9        	120494745   	120497453   	120494757      	120497452      	29        	11        	40             	DEL       
chr9        	121464624   	121465540   	121464630      	121465541      	15        	8         	23             	DUP       
chr9        	121879721   	121879855   	121879742      	121879855      	0         	6         	6              	DEL       
chr9        	128139150   	128139689   	128139151      	128139689      	19        	2         	21             	DEL       
chr9        	128649776   	128651697   	128649709      	128651666      	11        	0         	11             	DEL       
chr9        	128932618   	128932752   	128932655      	128932752      	0         	8         	8              	DEL       
chr9        	128938645   	128939878   	128938687      	128939859      	16        	0         	16             	DEL       
chr9        	129264405   	129265790   	129264421      	129265790      	48        	17        	65             	DEL       
chr9        	129396438   	129396902   	129396438      	129396896      	9         	0         	9              	DUP       
chr9        	131586372   	131587252   	131586373      	131587252      	6         	0         	6              	DEL       
chr9        	131798518   	131798608   	131798521      	131798608      	0         	7         	7              	DEL       
chr9        	132421609   	132421686   	132421626      	132421686      	0         	13        	13             	DEL       
chr9        	133185327   	133185645   	133185341      	133185645      	2         	11        	13             	DEL       
chr9        	133514087   	133514431   	133514100      	133514430      	2         	18        	20             	DEL       
chr9        	133548978   	133549303   	133548994      	133549303      	1         	18        	19             	DEL       
chr9        	133827266   	133828404   	133827267      	133828404      	7         	0         	7              	DEL       
chr9        	134792851   	134792923   	134792852      	134792910      	1         	6         	7              	DEL       
chr9        	134798568   	134798653   	134798569      	134798653      	0         	8         	8              	DEL       
chr9        	135322216   	135325757   	135322220      	135325757      	22        	11        	33             	DEL       
chr9        	135578112   	135578930   	135578113      	135578930      	5         	0         	5              	DEL       
chr9        	135587253   	135588353   	135587257      	135588353      	34        	20        	54             	DEL       
chr9        	136533071   	136533343   	136533072      	136533343      	0         	17        	17             	DEL       
chr9        	136632528   	136633084   	136632528      	136633082      	11        	0         	11             	DUP       
chr9        	137328628   	137329773   	137328629      	137329773      	5         	0         	5              	DEL       
chr9        	137359056   	137361508   	137359056      	137361521      	16        	0         	16             	DEL       
chr9        	137841099   	137842244   	137841100      	137842244      	11        	0         	11             	DEL       
chr9        	138125044   	138139231   	138125045      	138139231      	21        	2         	23             	DEL       
chrX        	358385      	358445      	358391         	358445         	0         	5         	5              	DEL       
chrX        	429031      	429105      	429039         	429105         	0         	17        	17             	DEL       
chrX        	438522      	439151      	438523         	439151         	6         	0         	6              	DEL       
chrX        	442481      	442582      	442482         	442582         	0         	12        	12             	DEL       
chrX        	498051      	499001      	498051         	498999         	6         	0         	6              	DUP       
chrX        	498051      	499001      	498418         	499087         	8         	0         	8              	DEL       
chrX        	498417      	499087      	498051         	498999         	6         	0         	6              	DUP       
chrX        	498417      	499087      	498418         	499087         	8         	0         	8              	DEL       
chrX        	505362      	505727      	505363         	505727         	4         	0         	4              	DEL       
chrX        	779045      	780493      	779183         	779912         	4         	1         	5              	DUP       
chrX        	779045      	780493      	779911         	780701         	4         	0         	4              	DEL       
chrX        	833016      	833112      	833019         	833112         	1         	4         	5              	DEL       
chrX        	917884      	919070      	917885         	919070         	8         	0         	8              	DEL       
chrX        	942384      	943176      	942385         	943176         	12        	0         	12             	DEL       
chrX        	949398      	950113      	949397         	950115         	19        	7         	26             	DEL       
chrX        	977362      	978251      	977363         	978251         	26        	10        	36             	DEL       
chrX        	1083737     	1084663     	1083738        	1084663        	5         	0         	5              	DEL       
chrX        	1085890     	1086754     	1085977        	1086696        	6         	0         	6              	DUP       
chrX        	1124086     	1124193     	1124087        	1124193        	0         	6         	6              	DEL       
chrX        	1328238     	1328822     	1328238        	1328820        	7         	0         	7              	DUP       
chrX        	1406374     	1406943     	1406375        	1406943        	4         	0         	4              	DEL       
chrX        	1408124     	1410290     	1408203        	1410247        	27        	0         	27             	DEL       
chrX        	1637242     	1641570     	1637534        	1641347        	17        	0         	17             	DEL       
chrX        	1637242     	1641570     	1640656        	1641744        	4         	0         	4              	DEL       
chrX        	1701617     	1702541     	1701762        	1702573        	26        	0         	26             	DEL       
chrX        	1773167     	1773390     	1773168        	1773367        	0         	9         	9              	DEL       
chrX        	1791968     	1795826     	1791969        	1795826        	30        	9         	39             	DEL       
chrX        	1887602     	1888361     	1887603        	1888361        	11        	0         	11             	DEL       
chrX        	2776268     	2890590     	2776268        	2890588        	7         	0         	7              	DUP       
chrX        	4986665     	4986981     	4986682        	4986981        	1         	4         	5              	DEL       
chrX        	5137301     	5139458     	5137306        	5139458        	18        	8         	26             	DEL       
chrX        	5241430     	5246164     	5241433        	5246164        	29        	4         	33             	DEL       
chrX        	5652294     	5652639     	5652310        	5652639        	2         	11        	13             	DEL       
chrX        	6219007     	6220353     	6219008        	6220343        	29        	6         	35             	INV       
chrX        	12744293    	12744393    	12744294       	12744393       	0         	5         	5              	DEL       
chrX        	26936816    	26936888    	26936811       	26936887       	0         	6         	6              	DEL       
chrX        	27013073    	27013701    	27013074       	27013701       	4         	0         	4              	INV       
chrX        	32969204    	32970962    	32969205       	32970962       	7         	4         	11             	DEL       
chrX        	33190461    	33190786    	33190476       	33190786       	2         	8         	10             	DEL       
chrX        	33691717    	33691918    	33691720       	33691918       	0         	13        	13             	DEL       
chrX        	40542244    	40542313    	40542247       	40542313       	0         	7         	7              	DEL       
chrX        	48232276    	48233589    	48232277       	48233589       	12        	0         	12             	DEL       
chrX        	49017555    	49018633    	49017551       	49018695       	14        	0         	14             	DUP       
chrX        	52862835    	55652458    	55077621       	55091355       	8         	0         	8              	DUP       
chrX        	52862835    	55652458    	52862887       	55652521       	11        	0         	11             	DEL       
chrX        	55077621    	55091357    	55077621       	55091355       	8         	0         	8              	DUP       
chrX        	62600755    	62601355    	62600755       	62601332       	6         	0         	6              	DUP       
chrX        	66883934    	66884059    	66883937       	66884059       	0         	7         	7              	DEL       
chrX        	67113956    	67114130    	67113965       	67114130       	0         	6         	6              	DEL       
chrX        	70083210    	70083423    	70083212       	70083423       	0         	6         	6              	DEL       
chrX        	71903369    	71903687    	71903381       	71903687       	0         	6         	6              	DEL       
chrX        	75379901    	75379965    	75379902       	75379965       	0         	9         	9              	DEL       
chrX        	77865962    	77868357    	77865961       	77868356       	10        	0         	10             	DEL       
chrX        	78441354    	78441953    	78441360       	78441953       	15        	15        	30             	DEL       
chrX        	79690950    	79693339    	79690951       	79693339       	10        	5         	15             	DEL       
chrX        	79966617    	79966791    	79966620       	79966791       	0         	7         	7              	DEL       
chrX        	84191622    	84198032    	84191621       	84198031       	6         	0         	6              	DEL       
chrX        	86350167    	86354860    	86350180       	86354860       	16        	5         	21             	DEL       
chrX        	89204458    	89205886    	89204458       	89205884       	9         	0         	9              	DUP       
chrX        	89204458    	89205886    	89204926       	89206982       	7         	0         	7              	DEL       
chrX        	89204458    	89205886    	89205053       	89207481       	9         	4         	13             	DUP       
chrX        	89204927    	89206983    	89204458       	89205884       	9         	0         	9              	DUP       
chrX        	89204927    	89206983    	89204926       	89206982       	7         	0         	7              	DEL       
chrX        	89204927    	89206983    	89205053       	89207481       	9         	4         	13             	DUP       
chrX        	89205049    	89207487    	89204458       	89205884       	9         	0         	9              	DUP       
chrX        	89205049    	89207487    	89204926       	89206982       	7         	0         	7              	DEL       
chrX        	89205049    	89207487    	89205053       	89207481       	9         	4         	13             	DUP       
chrX        	91028359    	91029089    	91028360       	91029089       	9         	1         	10             	DEL       
chrX        	93541296    	93546505    	93541300       	93546505       	23        	8         	31             	DEL       
chrX        	95795847    	95796481    	95795848       	95796481       	11        	7         	18             	DEL       
chrX        	101836459   	101836548   	101836460      	101836548      	0         	9         	9              	DEL       
chrX        	103911635   	103911961   	103911651      	103911961      	1         	7         	8              	DEL       
chrX        	113545265   	113545394   	113545267      	113545394      	0         	9         	9              	DEL       
chrX        	113633727   	113634060   	113633742      	113634059      	0         	7         	7              	DEL       
chrX        	115307940   	115309948   	115307939      	115309947      	20        	0         	20             	DEL       
chrX        	115474387   	115474735   	115474403      	115474734      	0         	9         	9              	DEL       
chrX        	119740051   	119742718   	119740111      	119742738      	13        	0         	13             	DEL       
chrX        	120509455   	120509769   	120509470      	120509769      	0         	14        	14             	DEL       
chrX        	128168241   	128168464   	128168242      	128168464      	0         	4         	4              	DEL       
chrX        	129366459   	129368462   	129366460      	129368462      	16        	10        	26             	DEL       
chrX        	136075822   	136076155   	136075840      	136076154      	1         	11        	12             	DEL       
chrX        	138189023   	138189247   	138189024      	138189247      	0         	5         	5              	DEL       
chrX        	139302733   	139303060   	139302751      	139303060      	0         	6         	6              	DEL       
chrX        	139504399   	139504470   	139504409      	139504470      	0         	7         	7              	DEL       
chrX        	140075609   	140138933   	140075574      	140138849      	9         	0         	9              	DUP       
chrX        	143110156   	143110276   	143110160      	143110276      	0         	4         	4              	DEL       
chrX        	144323855   	144326855   	144323863      	144326855      	23        	10        	33             	DEL       
chrX        	144327143   	144327257   	144327144      	144327261      	0         	6         	6              	DEL       
chrX        	145340555   	145342987   	145340559      	145342987      	18        	7         	25             	DEL       
chrX        	146248380   	146248692   	146248394      	146248692      	0         	14        	14             	DEL       
chrX        	147477720   	147477827   	147477735      	147477827      	0         	13        	13             	DEL       
chrX        	148428176   	148429716   	148428177      	148429716      	20        	13        	33             	DEL       
chrX        	150382867   	150383205   	150382880      	150383204      	1         	13        	14             	DEL       
chrX        	151099690   	151102316   	151099695      	151102316      	22        	12        	34             	DEL       
chrX        	153211151   	153211236   	153211154      	153211236      	0         	9         	9              	DEL       
chrX        	153382551   	153383304   	153382551      	153383302      	8         	0         	8              	DUP       
chrX        	154598647   	155803790   	155057017      	155057121      	0         	7         	7              	DEL       
chrX        	154598647   	155803790   	155560527      	155573833      	9         	0         	9              	DEL       
chrX        	154598647   	155803790   	154598646      	155803789      	5         	0         	5              	DEL       
chrX        	154598647   	155803790   	155641410      	155958233      	19        	0         	19             	DUP       
chrX        	154598647   	155803790   	155641810      	155958696      	11        	0         	11             	DEL       
chrX        	154598647   	155803790   	155803597      	155984259      	10        	0         	10             	DEL       
chrX        	154598647   	155803790   	155803599      	155987114      	21        	0         	21             	DUP       
chrX        	155057011   	155057121   	155057017      	155057121      	0         	7         	7              	DEL       
chrX        	155560528   	155573834   	155560527      	155573833      	9         	0         	9              	DEL       
chrX        	155641410   	155958235   	154598646      	155803789      	5         	0         	5              	DEL       
chrX        	155641410   	155958235   	155641410      	155958233      	19        	0         	19             	DUP       
chrX        	155641410   	155958235   	155641810      	155958696      	11        	0         	11             	DEL       
chrX        	155641410   	155958235   	155803597      	155984259      	10        	0         	10             	DEL       
chrX        	155641410   	155958235   	155803599      	155987114      	21        	0         	21             	DUP       
chrX        	155641811   	155958697   	154598646      	155803789      	5         	0         	5              	DEL       
chrX        	155641811   	155958697   	155641410      	155958233      	19        	0         	19             	DUP       
chrX        	155641811   	155958697   	155641810      	155958696      	11        	0         	11             	DEL       
chrX        	155641811   	155958697   	155803597      	155984259      	10        	0         	10             	DEL       
chrX        	155641811   	155958697   	155803599      	155987114      	21        	0         	21             	DUP       
chrX        	155803598   	155984260   	154598646      	155803789      	5         	0         	5              	DEL       
chrX        	155803598   	155984260   	155641410      	155958233      	19        	0         	19             	DUP       
chrX        	155803598   	155984260   	155641810      	155958696      	11        	0         	11             	DEL       
chrX        	155803598   	155984260   	155803597      	155984259      	10        	0         	10             	DEL       
chrX        	155803598   	155984260   	155803599      	155987114      	21        	0         	21             	DUP       
chrX        	155803599   	155987116   	154598646      	155803789      	5         	0         	5              	DEL       
chrX        	155803599   	155987116   	155641410      	155958233      	19        	0         	19             	DUP       
chrX        	155803599   	155987116   	155641810      	155958696      	11        	0         	11             	DEL       
chrX        	155803599   	155987116   	155803597      	155984259      	10        	0         	10             	DEL       
chrX        	155803599   	155987116   	155803599      	155987114      	21        	0         	21             	DUP       
chrY        	12660813    	12661154    	12660814       	12661154       	6         	0         	6              	INV       
chrY        	20068762    	20073276    	20068761       	20073275       	6         	0         	6              	DEL       
chrY        	20068762    	20073276    	20068919       	20079477       	7         	0         	7              	DUP       
chrY        	20068879    	20079686    	20068761       	20073275       	6         	0         	6              	DEL       
chrY        	20068879    	20079686    	20068919       	20079477       	7         	0         	7              	DUP       
chrY        	20094034    	20154589    	20100780       	20111623       	7         	0         	7              	DUP       
chrY        	20094034    	20154589    	20131535       	20136598       	4         	0         	4              	DUP       
chrY        	20094034    	20154589    	20138598       	20141330       	4         	0         	4              	DEL       
chrY        	20094034    	20154589    	20136682       	20141592       	4         	0         	4              	DUP       
chrY        	20094034    	20154589    	20094033       	20154588       	7         	0         	7              	DEL       
chrY        	20100786    	20111760    	20100780       	20111623       	7         	0         	7              	DUP       
chrY        	20131535    	20136600    	20131535       	20136598       	4         	0         	4              	DUP       
chrY        	20131535    	20136600    	20136682       	20141592       	4         	0         	4              	DUP       
chrY        	20136681    	20141592    	20131535       	20136598       	4         	0         	4              	DUP       
chrY        	20136681    	20141592    	20138598       	20141330       	4         	0         	4              	DEL       
chrY        	20136681    	20141592    	20136682       	20141592       	4         	0         	4              	DUP       
chrY        	20138597    	20141330    	20138598       	20141330       	4         	0         	4              	DEL       
chrY        	20179011    	20183222    	20179097       	20183136       	19        	0         	19             	DEL       
chrY        	20284058    	20295569    	20284018       	20295577       	11        	0         	11             	DEL       
chrY        	20298081    	20301254    	20298122       	20301238       	14        	0         	14             	DEL       
